F рџе:A рџе:fA рџа:Fe рЏЊ:B! рџА:Vi!	 рџЕ vOs рџф vAc рџФ AESC--
A рџб:U рџц:Y рџБ:YR рџЦ:Wr
B рЏњ:B рЏѕ:Pc/Both рЏъ:D!  рџ┐:buN рЏЊ:B! see рџа:FРђд
C рџ▓:C рЏѕ:Pc/Ps рџ│:K рџ┤:K	рџх:G ENG:рџХ GER:рЏё GAR:рџИ рЏЃ:J
D рџд:TH рџД:ETH рЏъ:D!
E рџГ:O рЏќ:mE рЏѓ:Eh/He
F рџе fA рџа Fe  рџА Vi	 рџЕ vOs рџф vAc рџФ AESC--
G рџх:G ENG:рџХ GAR:рџИ GER:рЏё crc:рЏц рЏЮ:xING! рЏЃ:J
H рџ║:H рџ╗:H рџй:Hi/He/Eh
I рЏЂ:I рЏЄ:J рџй:Hi рЏЎ:Mi рЏД:IR рЏе:YR рЏа:iEAR рЏА:xIOR
J рЏЄ:J рЏЃ:J рЏЂ:I рџй:Hj
K рџ│:K рџ┤:K рџ▓:caun рЏЋ:kP! ╬║
l рЏџ:L  РЅа рџ│ cen
M рЏЌ:Ma рЏќ mE  рЏЌрЏЂmi  рЏЌрЏЪ mo рЏЌрџб mu рЏЎ:Mi рЏў:M! MADR
N рџЙ:No рџ┐:buN рЏђ:No рЏЁ:A┬г рЏє:A┬г рЏЁ:un рЏє:un рЏЮ:xING!
O рЏЪ:O рЏю:oINGWAZ	 рџг:O рџГ:fO рџ«:bO рџ»:fOE рЏЁ:A┬г рЏє:A┬г рџ░:ON рџЙ:No! рЏЂ:oI рЏЄ:J 
P рџ╣:ph=W рџА:PH/V рЏѕ:Pth! рЏЋ:Pk! рЏЕ:Qv
Q рЏЕ:Q рЏё:GER/quer/kur рЏЪ:O  рЏ░:*zhong
R рџ▒:R рЏе:YR рЏА:xIOR рЏд:YR vs ­љђЕ:L/R! РЅа рЏЅ
S рЏі:S рЏІ:Z aS:рЏї aC:рЏЇ aZ:рЏј рЏю:sINGWAZ
T	рЏЈ T  рЏљ D	рЏЉ Z	рЏј
U рџб:U рџц:Y рџБ:YR рџЦ:Wr
V рџб:U рџА:Vi! рџе:Fa рџ╣:ph=V
W рџЦ:Wr рџ╣:ph=W 
X рџи:Gs рЏЮ:xING! рџ╝:xH рџ╝:cHi рЏф:Xz рЏъ:D! рЏА:xIOR
Y ­љђЕ~рЏд:YR рЏе:YR рЏД:IR рЏЄ:Jahr/рЏЃ:year рЏа:yEAR рЏЅ?
Z рЏІ:Z рЏі:S ­љђЕРЅарЏЅ:­ЊІ╣@­љђћ


a 	рџе 	a 	/a(╦љ)/ 	*ansuz 	"one of the ├єsir (gods) An*Zeus vs ­љї░ AHSA	God"
b 	рЏњ 	b 	/b/ 	*berkanan 	"birch"
c 	рџ▓ 	c/k	/k/ 	*kaunan 	"ulcer" *kenaz "torch" књкњ
├Й   рџд 	├Й 	/╬И/, /├░/ 	*├Йurisaz 	"the god Thor, giant 
d 	рЏъ 	d 	/d/ 	*dagaz 	"day", "D├цcher?"
e 	рЏќ 	e 	/e(╦љ)/ 	*ehwaz 	"horse" Рєћ рЏќ├цrez ehwaz equus / hewaz рЏќhorse
f 	рџа 	f 	/f/ 	*fehu 	"wealth, cattle" Рєћ Viech,viel Vieh РЅа рџЕ Os РЅа рџф Ac
g 	рџи 	g 	/╔А/ 	*geb┼Ї 	"gift" Gabe
h 	рџ║рџ╗ 	h 	/h/ 	*hagalaz "hail"  vs рЏќ ehwaz equus / hewaz horse
i		рЏЂ,рЏЄ 	i,├д,e─Ф 	 	/i(╦љ)//├д╦љ/	*─Фsaz 	"ice", *e─Ф(h)waz 	"yew-tree"
j 	рЏЃ,рЏЄ 	j 	/j/ 	 *j─Њra- 	"year,harvest"
k 	рџ▓ 	k (c) 	/k/ 	*kaunan 	"ulcer" *kenaz "torch"
l 	рЏџ 	l 	/l/ 	*laguz 	"water, lake" *laukaz "leek" РЅа рџ│ cen
m 	рЏЌ 	m 	/m/ 	*mannaz 	"Man" vs рЏќ├цre (horse)
n 	рџЙ 	n 	/n/ 	*naudiz 	"need","Not" Naut knot?
o 	рЏЪ 	o 	/o(╦љ)/ 	*┼Ї├Йila-/*┼Ї├Йala- 	"heritage, estate, possession"
p 	рЏѕ 	p 	/p/ 	*per├Й- 	meaning unclear, perhaps "pear-tree".
o 	рЏЪ 	o 	/o(╦љ)/ 	*┼Ї├Йila-/*┼Ї├Йala- 	"heritage, estate, possession"
r 	рџ▒ 	r 	/r/ 	*raid┼Ї 	"ride, journey"
s 	рЏірЏІ 	s 	/s/ 	*s┼Їwil┼Ї 	"Sun"
t 	рЏЈ 	t 	/t/ 	*t─Фwaz/*teiwaz 	"the god Tiwaz"
u 	рџб 	u 	/u(╦љ)/ 	*┼Фruz 	"aurochs"  *├╗ram "water/slag"
w 	рџ╣,рџа 	w 	/w/ 	*wunj┼Ї 	"joy"
x 	рџи 	g 	/╔А/ 	*geb┼Ї 	"gift"
y 	рЏЃ,рЏЄ,рЏЅ? 	y 	/j/ 	*j─Њra- 	"year,harvest"
z 	рЏІ 	z 	/z/ 	*algiz 	unclear, possibly "elk"
sh 	рЏірЏІ 	sh 	/s/ 	*s┼Їwil┼Ї 	"Sun" soleil Solveig

┼І ┼І ┼І 	рЏю рЏЮ 	┼І 	/┼І/ 	*ingwaz 	"the god Ingwaz"

small letters are *conjectures

 SINGLE PUNCTUATION	рЏФ
 MULTIPLE PUNCTUATION	рЏг
 CROSS PUNCTUATION	рЏГ
 ARLAUG SYMBOL	рЏ«
 TVIMADUR SYMBOL	рЏ»
 BELGTHOR SYMBOL	рЏ░  ZHONG!


 FEHU FEOH FE F	рџа
 V	рџА
 URUZ UR ├џr U	рџб
 YR	рџБ
 Y	рџц
 W	рџЦ
 THURISAZ THURS THORN	рџд
 ETH	рџД
 ANSUZ A	рџе
 OS O	рџЕ
 AC A	рџф
 AESC	рџФ
 LONG-BRANCH-OSS O	рџг
 SHORT-TWIG-OSS O	рџГ
 O	рџ«
 OE	рџ»
 ON	рџ░
 RAIDO RAD REID R	рџ▒
 KAUNA	рџ▓
 CEN	рџ│
 KAUN K	рџ┤
 G	рџх
 ENG	рџХ
 GEBO GYFU G	рџи
 GAR	рџИ
 WUNJO WYNN W	рџ╣
 HAGLAZ H	рџ║
 HAEGL H	рџ╗
 LONG-BRANCH-HAGALL H	рџ╝
 SHORT-TWIG-HAGALL H	рџй
 NAUDIZ NYD NAUD N	  рџЙ
 SHORT-TWIG-NAUD N  	рџ┐
 DOTTED-N      				рЏђ
 ISAZ IS ISS I	рЏЂ
 E	рЏѓ
 JERAN J	рЏЃ
 GER	рЏё
 LONG-BRANCH-AR AE	рЏЁ
 SHORT-TWIG-AR A		рЏє
 IWAZ EOH	рЏЄ
 PERTHO PEORTH P	рЏѕ
 ALGIZ EOLHX	рЏЅ Zan:Live
 SOWILO S	рЏі
 SIGEL LONG-BRANCH-SOL S	рЏІ
 SHORT-TWIG-SOL S	рЏї
 C	рЏЇ
 Z	рЏј
 TIWAZ TIR TYR T	рЏЈ
 SHORT-TWIG-TYR T	рЏљ
 D	рЏЉ
 BERKANAN BEORC BJARKAN B	рЏњ
 SHORT-TWIG-BJARKAN B	рЏЊ
 DOTTED-P	рЏћ
 OPEN-P	рЏЋ
 EHWAZ EH E	рЏќ
 MANNAZ MAN M	рЏЌ
 LONG-BRANCH-MADR M	рЏў
 SHORT-TWIG-MADR M	рЏЎ
 LAUKAZ LAGU LOGR L	рЏџ
 DOTTED-L	рЏЏ
 INGWAZ	рЏю
 ING	рЏЮ
 DAGAZ DAEG D	рЏъ
 OTHALAN ETHEL O	рЏЪ
 EAR	рЏа
 IOR	рЏА
 CWEORTH	рЏб
 CALC	рЏБ
 CEALC	рЏц
 STAN	рЏЦ
 LONG-BRANCH-YR	рЏд
 SHORT-TWIG-YR	рЏД
 ICELANDIC-YR	рЏе
 Q	рЏЕ