ABC 		abc alfabetas abėcėlė 
abandon 		laisvumas nesivaržymas 
abandoned 		paliktas pamestas 
abandonment 		palikimas pametimas (šeimos ir pan.) atsisakymas 
abase 		(pa)žeminti žemintis (before) 
abasement 		(pa)žeminimas 
abashed 		sugėdintas sukonfūzytas 
abashment 		sumišimas susigėdimas 
abate 		(su)mažėti (su)silpnėti, (nu)rimti, (nu)sekti (nu)slūgti (apie vandenį) 
abatement 		(su)mažėjimas, (nu)slūgimas, (vėjo ir pan.) (nu)rimimas 
abbacy 		abatija, abatystė 
abbatial 		abatijos, abatiškas 
abbey 		abatija, vienuolynas 
abbot 		abatas 
abbreviate 		(su)trumpinti (apsakymą, kalbą, žodį ir pan.) 
abbreviation 		(su)trumpinimas 
abidance 		laikymasis 
abide 		likti ištikimam, tvirtai laikytis (įstatymo, susitarimo ir pan., by) 
abiding 		tvirtas, patvarus, nuolatinis 
ability 		galėjimas sugebėjimas gabumai 
abject 		nusižeminęs, žemas 
abjection 		žemumas niekingumas nusižeminimas 
abjuration 		išsižadėjimas, atsisakymas 
abjure 		išsižadėti, atsisakyti 
aboard 		laive, vagone, lėktuve, į laivą, į vagoną, į lėktuvą 
abolish 		panaikinti (įstatymą, mokesčius ir pan.) 
abolishment 		panaikinimas 
abolition 		panaikinimas 
abominable 		šlykštus, pasibjaurėtinas, atstumiantis 
abominate 		bjaurėtis, šlykštėtis, neapkęsti 
abomination 		bjaurėjimasis, šlykštumas, šlykštybė, bjaurastis 
aboriginal 		vietinis, senasis 
aborigine 		aborigenas (ypač Australijos), čiabuvis, vietinis 
abort 		nutraukti sustabdyti 
aborted 		prieš laiką gimęs, neišnešiotas 
abortion 		abortas, persileidimas, (nėštumo) nutraukimas 
abortive 		priešlaikinis (apie gimdymą) 
about 		apie maždaug arti 
above 		virš ant viršuje 
above all 		daugiausia svarbiausia pirmiausia ypač 
abracadabra 		burtažodis, užkeikimas 
abradant 		(tech.) abrazyvai, šlifuojamosios medžiagos 
abrade 		nutrinti, nubrūžinti (odą) 
Abraham 		(bibl.) Abraomas 
abrasion 		(odos) nutrynimas, nubrėžimas, įbrėžimas 
abrasive 		kandus, dygus, įžūlus 
abridge 		(su)trumpinti, (su)traukti 
abroad 		užsienyje, į užsienį 
abrogate 		panaikinti, anuliuoti (įstatymą), išnaikinti (paprotį) 
abrogation 		panaikinimas, anuliavimas (įstatymo ir pan.) 
abrupt 		staigus, netikėtas 
abruption 		(ati)trūkimas, atplėšimas 
abruptness 		staigumas 
abscess 		(med.) abscesas, pūlinys 
abscission 		(med.) nupjovimas, amputavimas 
abscond 		pabėgti, pasislėpti (nuo teismo, bausmės ir pan., from, with) 
absence 		nebuvimas, neatvykimas 
absent 		nesantis, nedalyvaujantis, neatvykęs 
absent-minded 		išsiblaškęs 
absent-mindedness 		išsiblaškymas, neatidumas 
absentee 		nesantysis 
absently 		neatidžiai, išsiblaškius 
absolute 		absoliutus(is) absoliuti visiškas 
absolutely 		visiškai, absoliučiai, neabejotinai 
absolution 		atleidimas, dovanojimas 
absolve 		atleisti (nuo bausmės, įpareigojimų ir pan., t.p. rel.), išteisinti 
absorb 		sugerti, absorbuoti 
absorbable 		absorbuojamas, sugeriamas 
absorbed 		įnikęs, atsidėjęs 
absorbedly 		įnikusiai, atsidėjus, sutelkus dėmesį 
absorbent 		sugeriantis 
absorber 		(tech.) sugėriklis, absorberis 
absorption 		absorbcija, absorbavimas, sugėrimas 
absorptive 		absorbuojamasis, sugeriamasis 
abstain 		susilaikyti (t.p. balsuojant) 
abstainer 		abstinentas, blaivininkas 
abstemious 		saikingas (apie valgytoją, gėrėją) 
abstention 		susilaikymas (from), nedalyvavimas (balsavime) 
abstergent 		valomasis, valymo 
abstersion 		valymas, plovimas 
abstinence 		susilaikymas 
abstinent 		susilaikantis 
abstract 		abstraktus 
abstracted 		užsisvajojęs, išsiblaškęs 
abstractedly 		išsiblaškius, užsisvajojus 
abstractedness 		išsiblaškymas 
abstraction 		abstrakcija 
abstractiveness 		abstraktumas 
abstruse 		sunkiai suprantamas, neaiškus 
absurd 		absurdiškas, beprasmiškas 
absurdity 		absurdas, nesąmonė 
Achilles 		Achilas 
Achilles' heel 		Achilo kulnas 
Achilles' tendon 		Achilo sausgyslė 
adage 		patarlė, priežodis, posakis 
Adam 		Adomas 
adamant 		kietas metalas/mineralas, deimantas 
adamantine 		kietas, tvirtas 
adapt 		pri(si)taikyti 
adaptability 		pri(si)taikomumas, pri(si)taikymas 
adaptable 		mokantis prisitaikyti 
adaptation 		adaptacija 
adapter 		tas, kuris pritaiko, adaptuotojas 
Addis Ababa 		Adis‐Abeba 
Aden 		Adenas 
Adonis 		Adonis 
Adriatic 		Adrijos jūra 
Adriatic Sea 		Adrijos jūra 
Aegean 		Egėjo jūra 
Aegean Sea 		Egėjo jūra 
Aeneas 		Enėjas 
Aeolus 		Eolas 
Afghan 		afganas afganų afganiškas 
Afghanistan 		Afganistanas 
Afghan woman 		afganė 
Africa 		Afrika 
African 		afrikietiškas afrikiečių afrikietis 
Afrikaans 		afrikansas 
Afrikaner 		būras 
again 		vėl dar kartą 
against 		prieš į ant priešais 
Agamemnon 		Agamemnonas 
agate 		agatas 
Agatha 		Agata Agota 
age 		amžius 
aged 		nugyvenęs pasiekęs (tam tikrą amžių) 
ageless 		nesenstąs amžinas 
agency 		agentūra biuras 
agenda 		darbotvarkė dienotvarkė 
agent 		agentas atstovas 
agile 		vikrus judrus mitrus 
Ajax 		Ajakas 
Albania 		Albanija 
Albanian 		albanų albaniškas albanas 
Albert 		Albertas 
Alexander 		Aleksandras 
Alexandria 		Aleksandrija 
Algeria 		Alžyras 
Algerian 		alžyrietiškas alžyriečių alžyrietis 
Algiers 		Alžyras 
All Saints' Day 		Visų šventųjų diena 
alphabet 		abėcėlė raidynas alfabetas 
Alpinist 		alpinistas 
Alps 		Alpės 
Alsatian 		elzasiečių elzasietis 
Amazon 		amazonė 
America 		Amerika 
American 		amerikietiškas amerikiečių amerikietis 
Americanize 		amerikietinti vartoti amerikanizmus 
American Indian 		indėnas 
Amsterdam 		Amsterdamas 
analyse 		analizuoti tirti nagrinėti (t.p. gram.) 
analysis 		analizė tyrimas nagrinėjimas 
analyst 		analitikas 
Anglican 		anglikonų anglikonas 
Anglicism 		anglicizmas 
Antarctic 		antarktinis 
Antarctic Ocean 		Antarkties vandenynas 
Antichrist 		Antikristas 
Antilles 		Antilų salos 
angry 		supykęs piktas susierzinęs suerzintas 
anticipation 		numatymas nujautimas priešlaikumas 
anthropoid 		žmoginė beždžionė antropoidas beždžionžmogis 
anthropology 		antropologija 
Antwerp 		Antverpenas 
Apennines 		Apeninai 
Aphrodite 		Afroditė 
Apocalypse 		apokalipsė 
Apollo 		Apolonas 
Appalachian Mountains 		Apalačių kalnai 
April 		balandis (mėnuo) 
apt 		linkęs 
aptitude 		gabumas mokslumas (for) 
Aquarius 		Vandenis 
Arab 		arabas 
Arabia 		Arabija 
Arabian 		arabų arabiškas arabas 
Arabian woman 		arabė 
Arabic 		arabų arabiškas 
Arcadia 		Arkadija 
Archimedes 		Archimedas 
Arctic 		arktinis šiaurės 
Arctic Ocean 		Arkties vandenynas 
Ardennes 		Ardėnai 
Argentina 		Argentina 
Argentine 		argentinietiškas argentinietis Argentinos 
Argentinean 		argentinietiškas argentinietis Argentinos 
Argus 		Argas 
Ariadne 		Ariadnė 
arithmetic expression 		aritmetinis reiškinys 
Aristotle 		Aristotelis 
Armenia 		Armėnija 
Armenian 		armėnų armėniškas armėnas 
Armenian woman 		armėnė 
Aryan 		arijas arijų ariškas 
Asia 		Azija 
Asian 		Azijos azijiečių azijietiškas azijietis 
Asian woman 		azijietė 
assume 		tarti manyti 
assumed 		tariamas išgalvotas fiktyvus 
assumption 		prielaida manymas pri(si)ėmimas 
Assyria 		Asirija 
Assyrian 		Asirijos asirų asiriškas asiras 
Athena 		Atėnė 
Athene 		Atėnė 
Athenian 		Atėnų atėniečių atėnietis 
Athens 		Atėnai 
Atlantic 		Atlantas Atlanto atlantinis Atlanto vandenynas 
Atlantic Ocean 		Atlanto vandenynas 
atlas 		atlasas 
attention 		dėmesys 
Attica 		Atikos 
Augeas 		Augijo 
August 		rugpjūtis 
Augustus 		Augustas 
Australia 		Australija 
Australian 		Australijos australų australiškas australas australietis 
Australian woman 		australė 
Austria 		Austrija 
Austrian 		Austrijos astrų austriškas austras 
ax 		kirvis 
axe 		kirvis 
axiom 		aksioma 
axiomatic 		aiškus be įrodymų aksiominis 
axiomatical 		aiškus be įrodymų aksiominis 
axis 		ašis geometrinė ašis 
axes 		ašys 
axle 		(tech.) ašis velenas 
Aztec 		actekas actekų kalba 
abdicate 		atsisakyti, atsižadėti (teisių, pareigų ir pan.) 
abdication 		atsisakymas 
abdomen 		pilvas 
aberrant 		neįprastas, nenormalus, pasikeitęs, nukrypęs (nuo kurso) 
aberration 		nenormalumas, nukrypimas nuo normos 
abet 		kurstyti, raginti, padėti (bloga darant) 
abetment 		kurstymas, raginimas 
abetter 		kurstytojas, bendrininkas 
abettor 		kurstytojas, bendrininkas 
abeyance 		(įstatymo, teisės) laikinas sustabdymas/panaikinimas 
abhor 		bjaurėtis, neapkęsti 
abhorrence 		bjaurėjimasis, neapkentimas 
abhorrent 		bjaurus, nepakenčiamas, atstumiantis (to) 
ablate 		(med.) amputuoti 
ablation 		(med.) pašalinimas, amputacija 
able 		galintis pajėgus sugebąs 
able-bodied 		tvirtas, stiprus, tinkamas (karo tarnybai) 
abled 		tvirtas, stiprus, tinkamas (karo tarnybai) 
abloom 		žydintis, sužydęs 
ablush 		sumišęs, paraudęs 
ably 		sumaniai, gerai 
abnegate 		atsisakyti (teisių, patogumų ir pan.), neleisti sau (ko) 
abnegation 		atsisakymas, pasiaukojimas 
abnormal 		nenormalus, anomalus 
abnormality 		nenormalumas 
abnormity 		nenormalumas 
abundance 		gausa, gausybė, perteklius 
abundant 		gausus, apstus 
abundantly 		gausiai 
abuse 		piktnaudžiauti 
abusive 		plūstamas, užgaulus, įžeidžiamas 
abut 		šlieti(s), liesti(s), ribotis (apie pastatą, žemę, on) remtis (on, against) 
abutment 		(stat.) ramstis, atrama, atramos vieta, pėda 
abuttal 		(pastato, žemės) prisišliejimas, buvimas greta 
abutter 		(teis.) gretimo žemės sklypo savininkas 
abuzz 		sujudęs, sukrutęs 
abysm 		bedugnė, praraja 
abysmal 		bedugnis, gilus 
abyss 		bedugnė, pragarmė, praraja, giluma, gelmė 
abyssal 		neišmatuojamas 
acacia 		(bot.) akacija 
academe 		akademinė aplinka 
academia 		universiteto/koledžo gyvenimas ir aplinka 
academic 		akademinis, universitetinis 
academical 		akademinis, universiteto 
academician 		akademikas 
academy 		akademija 
accede 		pradėti eiti pareigas, įžengti (į sostą) 
accelerate 		(pa)greitinti, (pa)spartinti 
acceleration 		(pa)greitinimas, greitėjimas, akceleracija 
accelerator 		(tech.) akceleratorius 
accent 		kirtis akcentas kirčio ženklas 
accentuate 		kirčiuoti 
accentuation 		kirčiavimas 
accept 		priimti 
acceptability 		priimtinumas 
acceptable 		priimtinas 
acceptance 		priėmimas 
accepted 		priimtinas, (visų) pripažintas 
access 		praėjimas 
access control 		prieigos kontrolė 
access denied 		kreiptis nepriimta 
access path 		kreipties kelias 
access token 		(komp.) prieigos ženklas prieigos raktas 
access violation 		(komp.) prieigos pažeidimas adresavimo klaida 
accessible 		prieinamas, pasiekiamas, gaunamas 
accessibility 		prieinamumas 
accession 		(pa)didėjimas, (pa)daugėjimas, (kolekcijos, knygų fondo) pa(si)pildymas 
accessory 		papildomas, pridėtinis 
accidence 		(gram.) žodžių kaityba 
accident 		atsitikimas, atvejis 
accident-prone 		patiriantis nesėkmių, kuriam nesiseka 
accidental 		atsitiktinis 
acclaim 		audringai sveikinti, ploti 
acclamation 		audringas pritarimas 
acclamatory 		pritariamas, pritarimo 
acclimatization 		aklimatizacija 
acclimatize 		aklimatizuoti(s), pri(si)taikyti prie sąlygų/aplinkybių 
acclivous 		kylantis 
accolade 		pagerbimas, apdovanojimas 
accommodate 		apgyvendinti, duoti patalpą, (su)talpinti 
accommodating 		paslaugus, malonus 
accommodation 		patalpa, būstas, prieglobstis 
accompaniment 		lydėjimas 
accompanist 		akompaniatorius 
accompany 		(pa)lydėti 
accomplice 		(nusikaltimo) bendrininkas, (blogų darbų) bendras 
accomplish 		įvykdyti, atlikti, nuveikti 
accomplished 		atliktas, užbaigtas 
accomplishment 		atlikimas, įvykdymas 
accord 		sutarimas, sutikimas, bendra nuomonė 
accordance 		sutarimas, atitikimas 
accordant 		darnus 
according 		atitinkamai 
according as 		pagal tai, kaip/kiek; remiantis tuo, kad… 
according to 		pagal 
accordingly 		atitinkamai 
accordion 		(muz.) akordeonas, armonika 
accost 		užkabin(ėj)imas, užkalbinimas 
accouchement 		gimdymas 
accoucheur 		akušeris 
accoucheuse 		akušerė 
account 		sąskaita 
account-book 		buhalterinė knyga 
accounting 		apskaita apskaičiavimas 
account lockout 		paskyros blokavimas sąskaitos blokavimas 
accountability 		atsakingumas 
accountable 		atsakingas (to – kam, for – už ką) 
accountancy 		sąskaityba buhalterija 
accountant 		buhalteris finansininkas sąskaitininkas apskaitininkas 
accredit 		įgalioti, akredituoti 
accreditation 		akreditavimas 
accredited 		įgaliotas, akredituotas 
accumulate 		kaupti(s), su(si)kaupti, rinkti(s), akumuliuoti 
accumulation 		kaupimas(is), su(si)kaupimas, (su)rinkimas, akumuliavimas, akumuliacija 
accumulative 		sukauptas 
accumulator 		(tech.) akumuliatorius 
accuracy 		tikslumas 
accurate 		tikslus 
accurateness 		tikslumas 
accursed 		neapkenčiamas, bjaurus 
accusation 		(ap)kaltinimas 
accusatory 		kaltinamasis, smerkiamas (apie žvilgsnį, pastabą) 
accuse 		(ap)kaltinti (of – kuo) 
accused 		kaltinamas, apkaltintas 
accuser 		kaltintojas 
ace 		(kortų, žaidimo kauliukų) akis, taškas 
acerbic 		aitrus, aštrus, rūgštus 
acerbity 		aitrumas, rūgštumas 
acetate 		(chem.) acetatas, acto rūgšties druska 
acetic 		(chem.) acto 
acetify 		(chem.) (pa)rūgštinti, virsti actu 
acetone 		(chem.) acetonas 
acetous 		acto, rūgštus 
acetylene 		(chem.) acetilenas 
ache 		(ilgai trunkantis) skausmas, gėla 
acheless 		neskausmingas 
achievable 		pasiekiamas 
achieve 		pasiekti, įgyti 
achievement 		pasiekimas, laimėjimas 
achiever 		pirmūnas, pirmaujantysis 
achy 		(šnek.) skausmingas, skaudus 
acid 		rūgštis 
acid-proof 		atsparus rūgštims 
acid-resistant 		atsparus rūgštims 
acidic 		labai rūgštus 
acidify 		(chem.) (pa)rūgštinti, rūgštėti 
acidity 		rūgštingumas, rūgštumas 
acidize 		(chem.) (pa)rūgštinti 
acidulated 		parūgštintas 
acidulous 		rūgštokas 
acknowledge 		pripažinti 
acknowledgement 		padėka 
acorn 		gilė 
acoustic 		garso, akustinis 
acoustics 		akustika 
acquire 		į(si)gyti iš(si)ugdyti išmokti 
acquired 		į(si)gytas iš(si)ugdytas 
acquirement 		į(si)gijimas 
acquisition 		į(si)gijimas įgijinys 
acre 		akras (» 0,4 ha) 
acreage 		akrai, žemės plotas akrais 
acrid 		aštrus, aitrus, erzinantis 
acridity 		aštrumas 
acrimonious 		piktas, kandus, dygus, pašaipus, sarkastiškas 
acrimony 		piktumas, kandumas, dygumas 
acrobat 		akrobatas 
acrobatic 		akrobatinis, akrobatiškas 
acrobatics 		akrobatika 
acronym 		(kalb.) akronimas 
acropolis 		akropolis 
across 		skersai 
across from 		priešais 
act 		veiksmas, veikimas, aktas 
actable 		įvykdomas 
acting 		(teatr.) vaidinimas, atlikimas, vaidyba 
action 		veiksmas, poelgis, pasielgimas, žygis 
action on click 		(komp.) veiksmas spustelėjus (komp.) veiksmas spragtelėjus 
actionable 		(teis.) teistinas, baustinas 
activate 		aktyvinti, darytį veiklesnį 
active 		aktyvus, veiklus 
active cell 		(komp.) veikiamasis langelis (narvelis) 
active window 		(komp.) veikiamasis langas 
activism 		agitavimas, agitacija 
activist 		aktyvistas, agitatorius 
activity 		aktyvumas, veiklumas, gyvumas, energija 
actor 		aktorius, (dramos, kino) artistas 
actress 		aktorė, (dramos, kino) artistė 
actual 		faktinis, tikras(is) 
actuality 		tikrovė, realybė 
actualize 		realizuoti, įgyvendinti, įvykdyti 
actually 		iš tikrųjų, tikrai, faktiškai 
actuate 		įjungti, paleisti (mechanizmą) 
actuation 		įjungimas, paleidimas 
actuator 		(tech.) pavara, pavaros rankena 
acumen 		įžvalgumas, sumanumas 
acute 		aštrus 
acuteness 		aštrumas 
add 		pridėti sudėti 
add-in 		(komp.) papildinys 
add-on 		(ypač komp.) priedas, papildomas įrenginys 
add to 		pridėti 
addendum 		(knygos) priedas, papildymas, adendas 
addict 		narkomanas (t.p. drug addict) didelis mėgėjas, entuziastas 
addiction 		polinkis, žalingas įprotis 
addictive 		įprantamas (apie narkotikus), tampantis nenugalimu įpročiu 
addition 		pridėjimas, papildymas, priedas 
additional 		papildomas, pridėtinis 
additional settings 		(komp.)papildomos nuostatos 
additionally 		papildomai, dar (labiau) 
additive 		priedas, priemaiša 
addle 		painioti(s) 
addle-brained 		susipainiojęs, puskvailis 
addle-head 		pakvaišęs žmogus, pusgalvis 
addle-pate 		pakvaišęs žmogus, pusgalvis 
addled 		supuvęs, sugedęs 
addlement 		painiava 
address 		adresas 
address book 		adresų knyga 
addressee 		adresatas 
adduce 		pateikti, duoti (įrodymų, pavyzdį ir pan.) 
adducent 		(anat.) pritraukiamasis (apie raumenį) 
Adelaide 		Adelaidė (vardas, miestas) 
adept 		mokovas, ekspertas 
adequacy 		adekvatumas, atitikimas, proporcingumas 
adequate 		adekvatus, atitinkantis, atitinkamas 
adequation 		sulyginimas 
adhere 		prikibti, prilipti 
adherence 		ištikimybė, atsidavimas 
adherent 		šalininkas, sekėjas 
adherer 		šalininkas, sekėjas 
adhesion 		prilipimas, sulipimas 
adhesive 		lipnus, rišlus 
adhesiveness 		lipnumas 
adhibit 		pritaisyti, pritvirtinti 
adipose 		gyvuliniai riebalai 
adiposity 		riebumas, nutukimas 
adit 		įėjimas, prieiga 
adjacency 		gretimumas, gretimybė, kaimynystė 
adjacent 		gretimas 
adjective 		(gram.) būdvardis 
adjoin 		šlietis, liestis, prieiti, ribotis 
adjoinment 		(gram.) (pri)šliejimas 
adjourn 		atidėti (posėdį ir pan.) 
adjournment 		atidėjimas 
adjudgement 		teismo nuosprendis 
adjudge 		nuteisti, pripažinti 
adjudgment 		teismo nuosprendis 
adjudicate 		(nu)spręsti, nutarti, būti (konkurso, varžybų) teisėju 
adjudicator 		(teis.) arbitras 
adjunct 		padėjėjas 
adjuration 		maldavimas 
adjure 		maldauti 
adjust 		pri(si)taikyti 
adjust to 		priderinti 
adjustable 		reguliuojamas, pritaikomas, stumdomas, kilnojamas 
adjuster 		montuotojas, rinkėjas, reguliuotojas 
adjusting 		reguliuojamas, nustatomas 
adjustment 		(su)reguliavimas, pataisymas, pakeitimas 
adjutant 		adjutantas 
adjuvant 		padėjėjas 
admeasure 		(at)matuoti, nustatyti ribas 
admin 		(komp.) administratorius 
administer 		valdyti, tvarkyti (reikalus) 
administrate 		(amer.) valdyti, kontroliuoti 
administration 		valdymas, tvarkymas 
administrative 		administracinis, valdymo 
administrator 		valdytojas, administratorius 
admirable 		pasigėrėtinas, puikus, žavus 
admiral 		admirolas 
admiration 		susižavėjimas, žavėjimasis, grožėjimasis, gėrėjimasis 
admire 		žavėtis, su(si)žavėti, grožėtis, gėrėtis 
admirer 		garbintojas, gerbėjas 
admissibility 		(teis.) leistinumas 
admissible 		(ypač teis.) priimtinas, leistinas(is) 
admission 		priėmimas 
admit 		priimti, prileisti 
admittance 		įėjimas, leidimas įeiti 
admittedly 		visų sutikimu/pripažinimu 
admix 		įmaišyti, pri(si)maišyti, su(si)maišyti (with) 
admixture 		įmaišymas, mišinys 
admonish 		įspėti, perspėti, priminti (of) 
admonishment 		perspėjimas 
admonition 		perspėjimas 
admonitory 		perspėjamasis 
ado 		subruzdimas, triukšmas, bėgiojimas, rūpesčiai 
adolescence 		paauglystė 
adolescent 		paaugliškas, paaugęs 
Adolphus 		Adolfas (vardas) 
adopt 		įvaikinti, įsūnyti, įdukrinti 
adoptee 		įvaikis, augintinis 
adoption 		įvaikinimas, įsūnijimas, įdukrinimas 
adoptive 		įvaikintas, įsūnytas, įdukrinta 
adorable 		garbintinas 
advance 		stumti priekin 
adoration 		garbinimas, dievinimas 
adore 		garbinti, dievinti 
adorn 		(pa)puošti, (pa)gražinti, būti (ko) papuošimu/puošmena 
adornment 		puošimas 
adrenalin 		adrenalinas 
adrift 		pasroviui, dreifuojantis, nevaldomas, vėjo ir bangų nešamas 
adroit 		gudrus, sumanus, mitrus 
adroitness 		sumanumas, mitrumas 
adscititious 		papildomas 
advanced 		esantis priešakyje priešakinis 
advanced search 		(komp.) patikslintoji paieška 
advancement 		progresas 
advantage 		nauda 
advantaged 		pranašesnis privilegijuotas 
advantageous 		palankus naudingas 
Advent 		(rel.) adventas (bažn.) advento pasninkas 
advent 		atėjimas atvykimas pasirodymas (of) 
adventure 		nuotykis 
adventurous 		drąsus linkęs rizikuoti 
adverb 		(gram.) prieveiksmis 
adversarial 		(polit., teis.) priešiškas 
adversary 		priešininkas konkurentas varžovas 
adversative 		priešingas 
adverse 		nepalankus neigiamas 
adversity 		nelaimė bėda nepalanki padėtis 
advertise 		reklamuoti 
advertisement 		reklama reklamavimas(is) 
advertiser 		reklamuotojas skelbėjas 
advice 		patarimas patarimai, (gydytojo, teisininko ir pan.) konsultacija 
advise 		patarti tartis pasitarti (with smb – su kuo, on/about smth – dėl ko) 
advisable 		patartinas rekomenduotinas tikslingas 
advised 		informuotas 
advisedly 		apgalvotai sąmoningai 
adviser 		patarėjas 
advisor 		(amer.) patarėjas 
advisory 		patariamasis konsultacinis (apie įstaigą, organizaciją) 
advocacy 		gynimas palaikymas 
advocate 		gynėjas šalininkas propaguotojas 
adult 		suaugęs pilnametis 
aeroplane 		lėktuvas 
aim 		tikslas 
aimless 		betikslis 
ain't 		am not is not are not has not have not 
airplane 		lėktuvas 
airport 		aerouostas 
affable 		malonus meilus 
afraid 		išsigandęs išsigandus 
affair 		reikalas dalykas 
affection 		meilė švelnumas prisirišimas meilės jausmai 
affectionate 		mylįs meilus mylintis švelnus 
affiliation 		įsūnijimas 
affirm 		(pa)tvirtinti teigti 
affirmation 		(pa)tvirtinimas 
affix 		pritvirtinti (to,on, upon) 
affluent 		intakas 
after 		po to kai 
after all 		pagaliau galiausiai šiaip ar taip 
afterward 		ilgainiui 
afterwards 		po to vėliau ilgainiui paskui 
agglomerate 		su(si)rinkti su(si)kaupti 
agglomeration 		su(si)kaupimas 
aggregate 		agreguoti (su)rinkti jungti 
agriculture 		žemės ūkis žemdirbystė 
ago 		prieš (tai) 
agree 		sutikti sutarti pritarti 
agreement 		sutikimas sutarimas 
aid 		padėti 
air 		oras dvelkimas dvelksmas kvėpavimas 
air-hostess 		palydovė stiuardesė 
aircraft 		aviacija 
airman 		lakūnas 
album 		albumas 
albumen 		baltymas albuminas 
ale 		alus 
alert 		įspėjimas pavojus 
alias 		alternatyvusis vardas pravardė pseudonimas 
alien 		svetimas 
align 		lygiuoti 
align bottom 		apatinė lygiuotė 
align center 		centrinė lygiuotė 
align left 		kairinė lygiuotė 
align middle 		lygiuoti centrus 
align right 		dešininė lygiuotė 
align top 		viršutinė lygiuotė 
alignment 		lygiuotė 
alive 		gyvas 
all 		visas visa visiškas viskas visi 
all but 		beveik vos ne 
all caps 		(komp.) visos didžiosios 
all in all 		apskritai 
all one 		vis tiek 
all over 		išvien 
allow 		leisti 
almost 		beveik 
along 		palei išilgai 
already 		jau 
already exists 		jau yra 
alt key 		(komp.) alternatyvos klavišas 
although 		nors nežiūrint net jeigu 
altitude 		aukštis aukštis virš jūros lygio altitudė 
always 		visada visuomet 
amaze 		(nu)stebinti 
amazement 		nustebimas nuostaba 
amazing 		nuostabus stebinantis nepaprastas 
amiable 		malonus draugiškas 
among 		tarp (daugelio) iš 
amongst 		tarp (daugelio) iš 
amount 		kiekis suma mastas skaičius 
ampersand 		ampersendas 
amusement 		pasilinksminimas 
and 		ir bei 
ancestor 		protėvis prosenelis 
ancestral 		protėvių paveldimas 
ancestry 		protėviai proseneliai 
ancestress 		pramotė prosenelė 
anchor 		inkaras 
animate 		pagyvinti atgaivinti 
animated text 		(komp.) animuotasis tekstas 
animation 		gyvumas (dvasios) pakilimas 
animosity 		priešiškumas pyktis piktumas 
answer 		atsakyti atsiliepti 
any 		kas nors koks nors kiek nors 
anybody 		bet kas kiekvienas 
anyone 		bet kas 
anything 		kas nors (klaus. sakinyje) niekas nieko 
anyway 		kiekvienu atveju 
anywhere 		kur nors (klausiamuosiuose ir neigiamuosiuose sakiniuose) bet kur 
announce 		paskelbti 
announcement 		(pa)skelbimas 
annoy 		(su)erzinti pykinti pristoti neduoti ramybės 
annoyance 		apmaudas suerzinimas nemalonumas 
annoying 		apmaudus 
annunciation 		apreiškimas pranešimas paskelbimas 
anonym 		anonimas slapyvardis 
anonymous 		anoniminis 
another 		kitas antras 
anxiety 		susirūpinimas rūpestis 
apart 		išskyrus neskaitant 
apart from 		išskyrus neskaitant nekalbant apie... 
apartment 		kambarys 
ape 		beždžionė 
apiculture 		bitininkystė 
apology 		atsiprašymas pasiteisinimas 
apologize 		atsiprašyti pasiteisinti 
apparent 		matomas aiškus tikrasis akivaizdus 
apparently 		aiškiai akivaizdžiai 
appeal 		apeliuoti šauktis kreiptis 
appealing 		žavus patrauklus 
appear 		rodytis atrodyti 
appearance 		pasirodymas 
append 		pridurti pridėti 
appendix 		priedas (prie knygos, dokumento) 
apple 		obuolys 
applet 		(komp.) programėlė 
appliance 		(pa)vartojimas (pa)naudojimas 
applicable 		pritaikomas tinkamas 
applicant 		prašytojas pretendentas 
application 		vartojimas (pri)taikymas 
application software 		(taikomoji) programinė įranga 
application title bar 		(komp.) programos pavadinimo juosta 
application title 		(komp.) programos pavadinimas 
apply 		(pa)vartoti panaudoti pritaikyti 
apply filter 		filtruoti taikyti filtrą 
appoint 		(pa)skirti (kuo) 
appointed 		nustatytas sutartas paskirtas 
appointee 		paskirtas asmuo (į tarnybą, postą) 
appointive 		(amer.) skiriamas, ne renkamas (apie pareigybę) 
appointment 		paskyrimas (į postą, tarnybą) 
appreciable 		pastebimas juntamas žymus 
appreciate 		vertinti 
appreciation 		(į)vertinimas išskyrimas 
approach 		artintis prisiartinti 
appropriate 		įprastas būdingas 
approximately 		maždaug arti (ko) 
arc 		lankas arka skliautas 
arch 		arka 
archangel 		arkangelas 
archbishop 		arkivyskupas 
archeology 		archeologija 
archaeology 		archeologija 
archipelago 		salynas archipelagas 
architect 		architektas 
architecture 		architektūra 
archive 		archyvas 
archive file 		archyvo failas 
archiving 		archyvavimas 
are 		yra 
area 		plotas aikštelė 
area chart 		(komp.) sritinė diagrama 
arguable 		diskutuojamas ginčytinas 
arguably 		be abejonės tikriausiai 
argue 		ginčytis (with, against – su, about, over – dėl) 
argument 		argumentas įrodymas 
argumentation 		argumentacija 
arm 		ranka (nuo plaštakos iki peties) 
aroma 		kvapas 
around 		apie aplink 
arouse 		sukelti (su)žadinti (su)jaudinti (su)erzinti 
arrange 		išdėstyti 
arrangement 		(su)tvarkytymas iš(si)dėstymas klasifikavimas 
arrive 		atvykti 
arrow keys 		(komp.) rodyklių klavišai 
arrow 		strėlė 
art 		menas meistriškumas dailė 
artery 		arterija 
artful 		gudrus suktas apsukrus 
article 		straipsnis 
articulate 		ryškus aiškus (apie kalbą) 
artificial 		dirbtinis 
artillerist 		artileristas 
artillery 		artilerija 
artist 		menininkas artistas aktorius 
artiste 		profesionalas dainininkas šokėjas aktorius 
artistic 		artistiškas meniškas 
artistical 		artistiškas meniškas 
as 		kaip kaip antai pavyzdžiui 
as ... as 		toks pat ... kaip 
as against 		palyginti su 
as if 		lyg tartum tarytum 
as per 		pagal 
as though 		lyg tarytum tartum 
as to 		dėl 
ascending 		didėjančiai 
ash 		pelenai 
ashamed 		susigėdęs sugėdintas 
ashcan 		(amer.) šiukšlių/sąšlavų kibiras/dėžė 
ashen 		peleninis pelenų 
ashery 		(tech.) peleninė 
ashpot 		pelenė (t.p. tech.) 
ashtray 		peleninė 
ashy 		peleniškas peleninis pelenų 
aside 		šalia šalin 
aside from 		(amer.) be to išskyrus 
asynchronous 		asinchroninis 
aspect 		aspektas 
aspect ratio 		proporcija 
ask 		klausti teirautis 
aspiration 		troškimas siekimas aspiracija 
assign 		(pa)skirti 
assist 		padėti pagelbėti dalyvauti asistuoti 
assistant 		padėjėjas asistentas pavaduotojas 
associate 		susieti 
asterisk 		žvaigždutė asteriskas 
at a time 		tuo pačiu metu 
at least 		mažiausiai bent 
athlete 		atletas 
athletic 		atletiškas atletinis 
athletics 		atletika sportas 
atmosphere 		atmosfera aplinka 
atmospheric 		atmosferinis 
atonement 		apmokėjimas kompensacija 
atrocious 		žiaurus žvėriškas brutalus 
attachment 		(komp.) priedas 
attach 		pridėti pritvirtinti prijungti pri(si)rišti 
attain 		pasiekti gauti 
attendant 		lindįs 
attitude 		nusistatymas nuostata pozicija pažiūra požiūris (towards – į) 
attract 		(pa)traukti (pri)traukti (apie magnetą ir pan.) 
attraction 		traukimas trauka (t.p. fiz.) potraukis (to – į) 
attractive 		patrauklus masinantis viliojantis 
attribute 		savybė 
audit 		auditas patikrinimas revizija 
aunt 		teta 
auntie 		tetulė 
aunty 		tetulė 
autocaption 		(komp.) automatinis pavadinimas 
autocomplete 		(komp.) automatinis baigimas 
autocorrect 		(komp.) automatinis keitinys 
autofill 		(komp.) automatinis užpildymas 
autofit 		(komp.) automatiškai pritaikyti 
autofit to window 		(komp.) (pri)derinti prie lango matmenų 
autoformat 		(komp.) automatinis formatavimas 
autocar 		autokaras automobilis 
autocracy 		autokratija vienvaldystė 
autocrat 		autokratas vienvaldys 
autocratic 		autokratinis autokratiškas vienvaldis 
autograph 		autografas 
autographic 		autografinis savo ranka rašytas 
automat 		(amer.) automatinė kavinė automatinis restoranas 
automate 		automatizuoti (gamybos procesą) mechanizuoti 
automatic 		automatinis automatiškas 
automatically 		automatiškai 
automation 		automatizacija automatika 
automatism 		automatizmas nesąmoningas veiksmas/judesys 
automobile 		(amer.) automobilis 
automotive 		savaeigis 
autopreview 		(komp.) automatinė peržiūra 
autorecover 		(komp.) automatinis atkūrimas 
autoshape 		(komp.) automatinė figūra 
autotext 		(komp.) autotekstas 
author 		autorius rašytojas kūrėjas 
authoritative 		autoritetingas 
authority 		autoritetas svoris įtaka 
authorization 		įgaliojimas 
authentication 		tapatumo nustatymas 
available 		esantis turimas esamas 
average 		vidurkis 
average per day 		dienos vidurkis 
aviator 		lakūnas 
await 		laukti 
away 		toli toliau atokiai esąs tam tikrame nuotolyje 
aware 		žinantis informuotas suprantantis 
awareness 		supratimas įsisąmoninimas 
awesome 		bauginantis 
awkward 		nerangus nemiklus 
awkwardness 		nerangumas nemiklumas 
Babel 		Babelio bokštas 
Babylon 		Babilonas 
Babylonia 		Babilonija 
Babylonian 		Babilonijos babiloniškas babilonietis 
Bacchus 		Bachas 
Balearic Islands 		Balearų salos 
Balkans 		Balkanai 
Baltic 		Baltijos baltų baltiškas 
babe 		kūdikis 
baby 		kūdikis 
babyish 		kūdikiškas vaikiškas 
bag 		maišas krepšys lagaminas portfelis 
baggage 		bagažas 
ball 		kamuolys sviedinys 
ballad 		baladė 
ballade 		baladė 
ballet 		baletas 
ballet-dancer 		balerina 
Baltic Sea 		Baltijos jūra 
Barbados 		Barbadosas 
Barcelona 		Barselona 
Basque 		baskas baskų baskiškas 
Bavaria 		Bavarija 
Bavarian 		Bavarijos bavariškas bavarų 
bed 		lova guolis 
bedroom 		miegamasis kambarys 
Bedouin 		beduinas 
bee 		bitė 
beef 		jautiena 
beehive 		avilys 
beekeeping 		bitininkystė 
beer 		alus 
beery 		alaus kvapo 
beeswax 		vaškas 
beetle 		vabalas 
Belgian 		Belgijos belgų belgiškas belgas 
Belgian woman 		belgė 
Belgium 		Belgija 
Belgrade 		Belgradas 
Ben 		Benas 
Benedict 		Benediktas 
Benelux 		Beniliuksas 
Bengal 		Bengalija bengalų bengališkas 
Berlin 		Berlynas 
Berliner 		berlynietis 
Bermudas 		Bermudų salos 
Berne 		Bernas 
Bethlehem 		Betliejus 
beyond 		anapus už 
Bible 		Biblija parankinė knyga 
Bluebeard 		Mėlynbarzdis 
Boer 		būras būrų 
Bohemia 		Bohemija bohema 
Bohemian 		Bohemijos bohemietis bohemiškas 
Bolivia 		Bolivija 
Bolivian 		Bolivijos boliviečių boliviškas bolivietis 
Bosnia 		Bosnija 
Bosporus 		Bosforas 
Brazil 		Brazilija 
Brazilian 		Brazilijos brazilų braziliškas brazilas 
Breton 		Bretanės bretonų bretoniškas bretonas 
Britain 		Britanija 
British 		Britanijos britų britiškas angliškas 
Briton 		britas anglas 
Brittany 		Bretanė 
Brussels 		Briuselis 
Buddha 		Buda 
Buddhism 		budizmas 
Buddhist 		budistas budistų budizmo 
Bulgar 		Bulgarija 
Bulgarian 		Bulgarijos bulgarų bulgariškas bulgaras 
bulk 		didumas dydis apimtis 
bulky 		didelis stambus didelės apimties 
bull 		jautis bulius 
bullet 		kulka 
bullshit 		šūdas (t.p. load of bullshit) nesąmonė niekai melas 
Burma 		Birma 
Burmese 		Birmos birmiečių birmietiškas birmietis 
Burmese woman 		birmietė 
Bushman 		bušmėnas 
Byzantine 		Bizantijos bizantinis bizantietis 
Byzantium 		Bizantijas 
back 		atgal 
back down 		atsitraukti 
back out 		pasitraukti 
back out of 		atsisakyti 
back to front 		atbulai atžagariai 
back up 		paremti palaikyti remti 
backbone 		(anat.) stuburas 
background 		fonas 
background job 		(komp.) foninė užduotis 
background printing 		(komp.) foninis spausdinimas 
backspace 		(komp.) grįžimas (per vieną poziciją) 
backspace key 		(komp.) naikinimo klavišas 
backup 		parama (kar.) pastiprinimas 
backup copy 		(komp.) atsarginė kopija 
backup file 		(komp.) atsarginės kopijos failas 
back up memory 		(komp.) atsarginė atmintinė 
backward 		atbulias atgalinis (judėjimas) 
bacon 		bekonas kiauliena 
bad 		blogas negeras piktas 
bamboo 		bambukas bambuko lazdelė 
ban 		(už)draudimas (on) 
banana 		bananas 
band 		kaspinas raištis 
bandit 		banditas plėšikas 
bandwidth 		juostos plotis 
bank 		bankas 
bankrupt 		subankrutavęs asmuo bankrotas (asmuo) 
bankruptcy 		bankrotas (su)bankrutavimas 
banner 		transparantas plakatas 
banter 		geraširdiškas pajuokavimas 
bantering 		mėgstantis juokauti žaismingas 
balance 		pusiausvyra 
baptism 		krikštas krikštijimas 
baptize 		krikštyti pakrikštyti 
bar 		juosta 
bar chart 		(komp.) histograma 
bar code 		brūkšninis kodas 
barbecue 		rėmas, ant kurio kepama skerdiena (virš atviros ugnies lauke) 
barber 		(vyrų) kirpėjas barzdaskutys 
bare 		nuogas plikas 
barely 		nuogai 
base 		žemas niekšiškas nekilnus 
baseball 		beisbolas 
baseless 		be pagrindo be pamatų nepagrįstas 
basement 		rūsys pusrūsis 
basic 		pagrindinis 
basically 		iš esmės 
basics 		svarbiausi/pagrindiniai dalykai pagrindai 
basin 		dubuo 
basket 		krepšys pintinė 
basketball 		krepšinis krepšinio kamuolys 
bat 		šikšnosparnis 
batch 		grupė partija siunta krūva pluoštas 
batch file 		(komp.) komandų failas 
(komp.) batch program 		paketinė programa 
bath 		pirtis 
bath-room 		vonia (kambarys) 
bathe 		maudyti(s) 
bather 		besimaudąs 
bathing 		maudymas(is) 
baton 		lazda lazdelė dirigento lazdelė batuta 
battery 		baterija 
battle 		mūšis kova 
bay 		įlanka užutėkis 
beach 		paplūdimys pliažas pajūris 
beacon 		švyturys 
beak 		snapas (paukščio) 
beaked 		su snapu turintis snapą 
beaker 		laboratorinė stiklinė menzūra 
beam 		rąstas sija 
bean 		pupa 
bear 		meška lokys 
beard 		barzda 
beaver 		bebras 
because 		kadangi kad nes todėl 
become 		tapti pavirsti 
beat 		mušti(s) daužyti plakti 
beautiful 		gražus 
beauty 		grožis 
beggar 		elgeta 
begin 		pra(si)dėti 
beginner 		pradedantysis naujokas 
beginning 		pradžia 
behaviour 		elgesys elgsena elgimasis manieros 
behind 		už po paskui 
belie 		nuslėpti neatskleisti neteisingai nušviesti 
belief 		tikėjimas 
believable 		patikimas įtikimas tikėtinas tikroviškas 
believe 		tikėti 
believer 		(rel.) tikintysis 
bell 		varpas varpelis skambutis 
belly 		pilvas 
beloved 		pamėgtas mylimas 
below 		žemiau po žemai apačioj 
bench 		suolas teisėjų suolas vieta teismas kėdė 
bend 		lenkti(s) riesti(s) 
beneficence 		labdara labdarystė 
beneficent 		geradariškas geraširdiškas 
beneficial 		palankus naudingas 
beneficiary 		pasipelnytojas 
benefit 		nauda pelnas privilegija 
berry 		uoga 
besom 		šluota 
bespeak 		užsakyti iš anksto susitarti 
bet 		lažybos susilažinta suma 
betray 		išduoti (žmogu, tėvynę ir pan.) 
betrayal 		išdavystė išdavimas 
betrayer 		išdavikas 
better 		geresnis sveikesnis aukštesnis didesnis 
between 		tarp 
betwixt 		tarp 
bias 		nuožulnumas nuolydis 
bicycle 		dviratis 
big 		didelis stambus 
bike 		(šnek.) dviratis 
bile 		tulžis 
bill 		sąskaita 
binary 		dvejetainis 
bind 		(ap)rišti surišti pririšti (to) įrišti (knygą) 
binding 		saistymas 
birch 		beržas 
bird 		paukštis 
birth 		gimdymas 
birthday 		gimimo diena 
birthplace 		gimimo vieta gimtinė 
bishop 		vyskupas 
bit 		gabaliukas kąsnelis 
bit image 		(komp.) taškinis atvaizdis 
bit map 		(komp.) taškinė grafika 
bitch 		kalė 
bite 		(į)kandimas (į)gėlimas kandžiojimas kąsnis užkandis randas 
bitter 		kartus aitrus 
black 		juodas 
blade 		(augalo) lapelis laiškelis 
blank 		tuščias švarus neprirašytas neužpildytas 
blank database 		tuščia duomenų bazė 
blank space 		tuščia vieta 
blanks 		(komp.) tušti langeliai 
blanket 		vilnonė antklodė antklodė apklotas 
blink 		mirkčiojimas mirksnis akimirka 
blinking 		mirksėjimas 
blinking cursor 		(komp.) mirksintysis žymeklis 
bloat 		iš(si)pūsti (iš)pampti (iš)brinkti (iš)tinti 
bloated 		išsipūtęs išpampęs išpurtęs 
bloater 		rūkyta žuvis (džn.) silkė 
block 		blokas 
block arrow 		figūrinė rodyklė 
block diagram 		blokinė schema 
bloke 		(šnek.) vaikinas 
blond 		šviesiaplaukis 
blood 		kraujas 
bloom 		žiedas žydėjimas 
blossom 		žiedas žydėjimas 
blue 		mėlynas žydras 
bluish 		melsvas 
byte 		baitas 
boar 		šernas kuilys 
board 		lenta stalas 
boarder 		valgytojas 
boat 		valtis laivas 
bob 		trumpai pakirpti plaukai 
bobbin 		ritė šeiva 
bobby 		policininkas 
body 		kūnas 
bog 		pelkė liūnas raistas bala 
boggy 		pelkėtas balotas 
bog-berry 		spanguolė 
bogus 		netikras fiktyvus tariamas 
bogy 		vaiduoklis baidyklė šmėkla 
boil 		virti virinti 
bold 		drąsus 
bomb 		bomba 
bomber 		bombonešis 
bone 		kaulas 
bonus 		premija priedas tantjema 
bony 		kaulėtas, kauluotas 
book 		knyga tomas sąsiuvinis tekstas 
book-keeper 		buhalteris 
bookbinder 		knygrišys 
bookmark 		(komp.) adresyno įrašas 
boost 		(kainų, populiarumo, pasitikėjimo ir pan.) augimas didėjimas 
booster 		kas nors skatinantis 
boot 		nauda patogumas 
boot loader 		(komp.) pradinis įkėliklis 
boot partition 		(komp.) paleidimo skirsnis 
border 		siena kraštas riba pakraštys 
borderland 		pasienio sritis/ruožas 
borderless 		beribis begalinis 
borderline 		(valstybės) siena demarkacijos linija 
bore 		gręžti tekinti 
boredom 		nuobodulys (darbo ir pan.) monotoniškumas 
borer 		gręžtuvas grąžtas 
boring 		gręžimas 
born 		pp iš bear 
borne 		pp iš bear 
borough 		miestelis (turintis miesto teises) 
borrow 		skolintis pasiskolinti imti į skolą (from, off – iš) 
bosom 		krūtinė 
both 		abu abi 
bother 		varginti 
bothersome 		įkyrus nuobodus varginąs 
bottle 		butelis 
bottom 		dugnas 
bottom-line 		suinteresuotas tik pelnu 
bought 		pt ir pp iš buy 
bounce 		šuolis atšokimas pasišok(in)ėjimas 
bow 		lankas (šaudyti strėlėmis) 
bowel 		žarna žarnos viduriai 
bowery 		apsodintas medžiais ūksmingas pavėsingas 
bowl 		taurė 
bowling 		boulingas (žaidimas, panašus į kėglius) 
bowman 		šaulys (iš lanko) lankininkas 
bowstring 		(lanko) timpa styga 
boy 		berniukas vaikinas 
boycott 		boikotas 
box 		dėžė 
boxing 		boksas 
bracelet 		apyrankė antrankis 
brain 		smegenys 
branch 		šaka 
brand 		nuodėgulys 
brandy 		brendis konjakas 
brass 		žalvaris bronza 
brave 		drąsus narsus šaunus 
bread 		duona 
breadstuff 		grūdai miltai duona duonos gaminiai 
breadth 		platumas plotis 
break 		(su)laužyti 
breakable 		trapus lūžus dūžtamas 
breakage 		sulaužymas avarija 
breakfast 		pusryčiai 
breast 		krūtinė krūtis 
breath 		kvapas kvėpavimas 
breathe 		kvėpuoti 
breathing 		kvėpavimas 
breathing-space 		atokvėpis atsikvėpimas pertrauka 
breathless 		uždusęs dūstantis 
breathtaking 		kvapą užimantis pagaunantis patraukiantis 
breezy 		vėsus 
brick 		plyta 
bridge 		tiltas 
brigand 		banditas plėšikas 
bright 		šviesus 
brightness 		ryškumas 
bring 		atnešti atvežti atvesti atgabenti pristatyti 
broad 		platus 
bronze 		bronza žalvaris 
brook 		upelis upokšnis 
broom 		šluota 
brother 		brolis 
brought 		past ir pII žr. bring 
brow 		antakis 
brown 		rudas rusvas tamsus įdegęs saulėje 
brownish 		rusvas 
browse 		jaunos atžalos 
browser 		(knygyno, parduotuvės) lankytojas žiūrinėjantis prekes/knygas 
brush 		šepetys teptukas 
bucket 		kibiras 
bug 		blakė 
build 		statyti 
building 		statymas statyba 
bud 		pumpuras 
budge 		(neig. sakiniuose) (pa)judėti pasislinkti (t.p. budge up/over) (pa)judinti (iš vietos) 
budget 		biudžetas finansinė sąmata 
budgetary 		biudžetinis 
buffer 		buferis 
bungalow 		vieno aukšto vasarnamis (su veranda) bungalas (Indijoje) 
burden 		priedainis refrenas 
burden oneself 		apsisunkinti užsikrauti 
burdensome 		apsunkinantis sunkus 
burial 		šermenys laidotuvės laidojimas 
burial-ground 		kapinės kapai 
burial-service 		gedulingos pamaldos 
bury 		laidoti palaidoti 
bus 		autobusas 
business 		reikalas dalykas 
busy 		užimtas stropus 
but 		be išskyrus 
butter 		sviestas 
butterfly 		drugelis peteliškė plaštakė 
button 		mygtukas 
buy 		pirkti 
buyer 		pirkėjas 
buying 		pirkimas 
Caesar 		Cezaris 
Cain 		Kainas brolžudys 
Cairo 		Kairas 
California 		Kalifornija 
Calvary 		Kavalerija kryžius su nukryžiuotuoju kančia 
Calvin 		Kalvinas 
Cambodia 		Kambodža 
cab 		taksi 
cabal 		politinė grupuotė/klika 
cabbage 		kopūstas 
cabbage-head 		kopūsto galva/gūžė 
cabinet 		kabinetas (ministrų ir pan.) 
cabinetmaker 		stalius baldžius 
cable 		stora tvirta virvė trosas lynas inkaro grandinė 
cable-cast 		transliuoti kabeline televizija 
cabling 		kabelio tiesimas/klojimas 
cabman 		(ist.) vežikas 
cache 		slėptuvė slaptavietė slaptas sandėlis 
cage 		narvas narvelis 
calculator 		kalkuliatorius 
calendar 		kalendorius 
calm 		ramus 
calm down 		nusiraminti nurimti aprimti atlyžti atslūgti 
calming 		raminamas raminantis 
calming down 		malšinimas 
calmly 		ramiai 
calmness 		ramybė tyla tyluma 
can 		galiu gali galime moku moki mokam 
cane 		nendrė 
cannot 		negalėti 
Canada 		Kanada 
Canadian 		Kanados kanadiečių kanadietiškas kanadietis 
Canadian woman 		kanadietė 
Canary Islands 		Kanarų salos 
Candlemas 		Grabnyčios 
Capitol 		Kapitolijus 
Capricorn 		Ožiaragis 
Carpathians 		Karpatai 
Carpathian mountains 		Karpatų kalnai 
Carthage 		Kartagina 
case 		atvejis atsitikimas 
casino 		kazino 
cask 		statinaitė boselis 
Caspian Sea 		Kaspijos jūra 
Cassandra 		Kasandra 
casual 		atsitiktinis nenumatytas 
casualty 		(nelaimingo atsitikimo) auka nukentėjėlis 
cat 		katė katinas 
Catalonia 		Katalonija 
Catalonian 		Katalonijos katalonų kataloniškas katalonas 
catch 		pagavimas sugavimas 
catcher 		gaudytojas 
Caucasian 		kaukazietiškas, kaukaziškas, kaukaziečių, Kaukazo 
Caucasus 		Kaukazas 
cave 		urvas ola 
caveat 		įspėjimas protestas 
cavern 		didelis urvas ola 
caviar(e) 		ikrai 
Celt 		keltas 
Celtic 		keltų keltiškas 
center 		centras 
centre 		centras 
Central America 		Centrinė Amerika 
Cerberus 		Cerberis 
Ceylon 		Ceilonas 
Ceylonese 		Ceilono ceiloniečių ceilonietiškas ceilonietis 
Chad 		Čadas 
Chile 		Čilė 
Chilean 		Čilės čiliečių čilietiškas čilietis 
China 		Kinija kiniškas 
Chinaman 		kinas 
Chinese 		Kinijos kiniškas kinų kininis kinas 
Christ 		Kristus mesijas 
Christian 		krikščionis krikščioniškas krikščionių 
Churchill 		Čerčilis 
Cicero 		Ciceronas 
Cinderella 		Pelenė 
Cleopatra 		Kleopatra 
Cologne 		Kelnas 
Colombia 		Kolumbija (valstybė) 
Colombian 		Kolumbijos kolumbietis 
Columbia 		Kolumbija (miestas, upė) 
Columbia River 		Kolumbija (upė) 
Columbus 		Kolumbas 
Congo 		Kongas 
Copenhagen 		Kopenhaga 
Cordova 		Kordoba 
Corinth 		Korintas 
Cornwall 		Kornvalis 
Corsica 		Korsika 
Corsican 		Korsikos korsikiečių korsikietis 
Corsican woman 		korsikietė 
Costa Rica 		Kosta Rika 
Cracow 		Krokuva 
Crete 		Kreta (sala) 
Crimea 		Krymas 
Croat 		kroatas chorvatas 
Croatia 		Kroatija 
Croatian 		Kroatijos kroatų 
Cuba 		Kuba 
Cuban 		Kubos, kubietiškas kubiečių kubietis 
Cupid 		Kupidonas 
Cyclades 		Kikladų salynas 
Cyprian woman 		kiprietė 
Cypriot 		Kipro kiprietiškas kipriečių kiprietis 
Cyprus 		Kipras 
Czech 		Čekijos čekiškas čekų čekas 
Czechoslovakia 		Čekoslovakija 
Czech language 		čekų kalba 
Czech woman 		čekė 
calf 		blauzda 
call 		(pa)šaukti skelbti vadinti kreiptis 
caller 		lankytojas skambinantis telefonu 
calling 		pašaukimas 
came 		būtasis l. iš come 
camel 		kupranugaris 
camera 		fotoaparatas kino kamera 
campaign 		žygis kompanija 
cancel 		atšaukti nutraukti anuliuoti panaikinti 
cancer-causing 		sukeliantis vėžį kancerogeninis 
cancerous 		vėžio vėžinis 
cancer 		vėžys (liga) yda blogis 
candidate 		kandidatas 
candle 		žvakė 
candy 		saldainiai ledinukas 
capon 		kastruotas gaidys, vištgaidis 
capote 		apsiaustas su gobtuvu, ilga milinė 
caprice 		kaprizas užgaida 
captive 		belaisvis 
capture 		pagrobti sugauti 
car 		automobilis 
carbon 		anglis (chem. elementas) anglinis elektrodas 
carbon-paper 		kalkė 
carbonblack 		suodžiai 
card 		korta vizitinė kortelė bilietas pakvietimas 
cardboard 		kartonas 
cardinal 		svarbiausias pagrindinis 
cardinal numeral 		kiekinis skaitvardis 
care 		rūpestis globa 
career 		profesija karjera 
careful 		rūpestingas 
carer 		slaugytojas globėjas (prižiūrintis namie invalidą, ligonį ir pan.) 
caress 		glamonėjimas 
carpus 		riešas 
carry 		gabenti nešti vežti 
cause 		priežastis 
celebrate 		švęsti atšvęsti iškilmingai minėt 
celebrated 		garsus žymus (for) 
celebrity 		garsi/įžymi asmenybė garsenybė 
cell 		ląstelė celė elementas narvelis kamera (kalėjimo) 
cement 		cementas rišamoji medžiaga glaistas 
cementation 		cementavimas (su)tvirtinimas 
cemetery 		kapinės kapai 
certain 		tikras 
certainly 		žinoma aišku būtinai neabejotinai 
chain 		grandinė grandinėlė 
chair 		kėdė 
champagne 		šampanas 
champion 		čempionas nugalėtojas 
championship 		čempionatas 
chance 		šansas proga galimybė 
change 		pa(si)keitimas keitimas(is) permaina (iš)keitimas grąža 
change again 		atsiversti 
change back 		atmainyti atsikeisti atversti 
changeable 		kintamas permainingas kintantis nepastovus 
changed 		pasikeitęs kitoks kitas (apie žmogų) 
changeless 		nekintamas nesikeičiantis 
changing-room 		persirengimo kambarys (ypač sportininkams) 
chap 		(šnek.) vaikinas vyrukas 
chapter 		skyrius 
character 		raidė rašmuo ženklas 
charge 		mokestis išlaidos rinkliava 
chat 		pasišnekėjimas pasikalbėjimas plepalai pasišnekučiavimas šneka 
chatty 		plepus šnekus 
cheat 		apgavystė apgaulė apgavimas 
cheek 		skruostas žandas 
check 		bagažo kvitas (rūbinės) numerėlis 
check-up 		(amer.) patikrinimas revizija 
check in 		registruoti 
check out 		išregistruoti 
checked 		languotas 
checker 		šaškė 
checking 		patikrinamasis 
checkmate 		matas 
checkout 		kontrolės punktas 
cheque 		čekis 
chest 		dėžė 
chestnut 		kaštonas 
chick 		viščiukas 
chicken 		višta, viščiukas 
chicken out 		(šnek.) pabijoti (ką daryti) pasitraukti (dėl gresiančių nemalonumų) 
chickenfeed 		naminių paukščių lesalas 
chickenshit 		(amer. sl.) niekingas bailys 
child 		vaikas atžala palikuonis kūdikis 
children 		vaikas palikuonis atžala 
childbirth 		gimdymas 
childhood 		vaikystė 
childish 		vaikiškas 
childishness 		vaikiškumas 
childless 		bevaikis 
chin 		smakras 
chin-chin 		(šnek.) sveikinti skelbti tostą 
chin-up 		(amer.) prisitraukimas (ant skersinio) 
chip 		drožlė 
chocolate 		šokoladas 
choice 		pasirinkimas 
choke 		(už)dusti 
cholera 		cholera dizenterija 
choose 		(pasi)rinkti 
chop 		(su)kapoti (pri)pjauti 
chord 		akordas (muz.) 
chorus 		choras 
chunk 		(ko) didelė dalis didelis kiekis 
church 		bažnyčia 
cincture 		juosta diržas 
cinema 		kinas kino teatras 
circle 		apskritimas 
circuit 		apytaka sukimasis aplink 
circular 		apvalus apskritas 
circulate 		cirkuliuoti 
circulation 		cirkuliacija apyvarta 
circumstance 		atvejis aplinkybė 
circumvent 		pergudrauti apgauti 
circus 		cirkas 
citizen 		pilietis miesto gyventojas civilis 
city 		didelis miestas didmiestis miestas 
claim 		tvirtinimas pretenzija 
claimant 		(teis.) ieškovas 
class 		kategorija klasė 
clause 		straipsnis 
clear 		švarus 
clog 		klumpė 
cloggy 		supuolęs į grumstus 
clock 		laikrodis (sieninis ar stalinis) 
close 		artimas esantis prie pat (ko) 
close to 		visai arti 
closely 		artimai glaudžiai 
closet 		(amer.) sandėliukas 
closing 		(už)baigiamasis 
closure 		uždarymas 
cloud 		debesis 
clown 		juokdarys klounas pokštininkas pajacas 
clowning 		vaipymasis 
club 		klubas 
cluster 		grupė, grupelė, būrelis 
co-author 		bendraautorius 
co-operate 		bendradarbiauti kooperuotis padėti sąveikauti 
co-operation 		bendradarbiavimas kooperacija parama 
co-opt 		kooptuoti 
co-optation 		kooptacija 
coach 		repetitorius 
coat 		apsiaustas 
coffee 		kava 
cold 		šaltas 
coldish 		šaltokas 
coldness 		šaltumas 
collaborate 		bendradarbiauti 
collaboration 		bendradarbiavimas 
collaborator 		bendradarbis 
collapse 		(namų) (su)griuvimas 
collate 		(su)gretint (su)lyginti 
colleage 		kolega darbo/mokslo/profesijos draugas 
colleague 		kolega darbo/mokslo/profesijos draugas 
collect 		su(si)rinkti 
collection 		(su)rinkimas 
collective 		kolektyvinis kolektyvus bendras 
collectively 		kolektyviai bendrai 
collector 		rinkėjas 
college 		(amer.) (nedidelis) universitetas koledžas 
collegian 		koledžo narys 
collegiate 		koledžo koledžų 
collision 		susidūrimas susikirtimas kolizija 
colon 		dvitaškis 
color 		spalva dažai 
colour 		spalva dažai 
come 		ateiti atvykti atvažiuoti 
come back 		sugrįžti pareiti 
come down 		apgriūti įgriūti nugriūti nusileisti 
come near 		priartėti prisiartinti 
coming 		artėjantis ateinantis būsimas 
coming down 		nusileidimas 
coming off 		atskilimas 
coming up 		atlėkimas 
command 		komanduoti įsakyti įsakinėti paliepti 
comment 		komentaras pastaba aiškinimas komentavimas atsiliepimas 
common 		bendras 
common sense 		sveikas protas 
commodity 		prekė plačiai vartojamas produktas 
company 		bendrovė kompanija įmonė firma 
compel 		priversti 
compelling 		įtikinamas (apie argumentą ir pan.) 
compete 		varžytis, konkuruoti (against, with – su, for – dėl) 
competence 		(su)gebėjimas, mokėjimas, kompetentingumas 
competency 		(su)gebėjimas, mokėjimas, kompetentingumas 
competent 		kompetentingas 
complaint 		skundas nepasitenkinimas 
complete 		pilnas užbaigtas visiškas 
completed 		pabaigtas 
completely 		visai visiškai ištisai 
completeness 		užbaigtumas 
complicate 		komplikuoti(s) 
complicated 		sudėtingas sunkus (suprasti) 
complication 		sudėtingumas komplikuotumas painumas 
comprehension 		supratimas supratingumas 
computer 		kompiuteris elektroninė skaičiavimo mašina skaičiuotojas skaičiuoklis skaičiuotuvas 
concern 		susirūpinimas rūpinimasis rūpestis nerimas 
concerned 		susijęs (with, in) 
concert 		koncertas 
conclusion 		išvada 
conclusive 		įtikinamas (apie įrodymus ir pan.) 
concur 		sutikti būti tokios pat nuomonės (with) 
concurrence 		sutikimas pritarimas (with) 
concurrent 		sutampantis vykstantis tuo pačiu metu 
coney 		triušis 
confabulate 		draugiškai šnekėtis, šnekučiuotis 
confabulation 		draugiškas šnekėjimasis, šnekučiavimas 
confer 		tartis pasitarti (with) 
conference 		pasitarimas posėdis 
conferment 		(laipsnio, titulo, vardo) suteikimas pripažinimas 
confide 		iš(si)pasakoti (paslaptis ir pan., to – kam) pasikliauti (in – kuo) 
confidence 		pa(si)tikėjimas pasikliovimas 
confident 		įsitikinęs tikras 
confidential 		konfidencialus slaptas 
confidentiality 		konfidencialumas slaptumas 
confidentially 		konfidencialiai slaptai 
confiding 		patiklus pasikliaunantis 
confirm 		patvirtinti ratifikuoti 
confront 		susidurti 
confrontation 		konfrontacija 
conjure 		rodyti fokusus/pokštus 
consequence 		padarinys rezultatas 
consequent 		einantis (po) (on, upon) išplaukiantis (iš) 
consequential 		logiškai išplaukiantis 
consequently 		todėl dėl tos priežasties taigi vadinasi 
conscience 		sąžinė 
conscienceless 		be sąžinės 
conscientious 		sąžiningas doras 
conscious 		suvokiantis suprantantis jaučiantis 
consciousness 		sąmonė 
consider 		laikyti būti nuomonės 
consist 		susidėti susidaryti (of – iš) 
consistence 		(spec.) konsistencija tankumas tirštumas 
consistency 		nuoseklumas logiškumas pastovumas 
consistent 		nuoseklus pastovus 
constrain 		(pri)versti (su)varžyti 
constrained 		priverstinis 
constraint 		spaudimas prievarta 
consume 		(su)valgyti, (su)ėsti, (su)lesti, (iš)gerti 
consumer 		vartotojas 
consuming 		dominuojantis, svarbiausias, nepasotinamas (apie troškimą ir pan.) 
consumption 		(su)naudojimas, (su)vartojimas 
content 		patenkintas norintis sutinkantis 
contest 		varžybos rungtynės konkursas 
contestable 		ginčijamas ginčytinas 
contestant 		varžovas varžybų/konkurso dalyvis 
contestation 		ginčas užginčijimas 
contradict 		prieštarauti 
contradiction 		prieštaravimas 
contradictor 		oponentas priešininkas 
contradictory 		prieštaringas nesuderinamas 
cony 		triušis 
convenience 		patogumas 
convenient 		patogus tinkamas 
conversation 		pasikalbėjimas kalba 
convince 		įtikinti (of) 
convincible 		įtikinamas 
convincing 		įtikinantis įtikinamas 
cook 		virti kepti 
cooker 		viryklė 
cookery 		virimo būdas kulinarija 
cookie 		sausainis biskvitas saldi bandelė 
cooky 		sausainis biskvitas 
cool 		vėsus 
cool-headed 		šaltakraujiškas ramus 
coolant 		(tech.) aušalas aušinamasis/šaldomasis skystis/mišinys 
cooler 		aušintuvas šaldytuvas 
coolness 		vėsa vėsuma 
cooperative 		kooperatinis linkęs bendradarbiauti 
copy 		kopijuoti nurašyti perrašyti 
coral 		koralas 
cord 		virvutė 
cordial 		širdies 
core 		šerdis 
cork 		kamštis 
corn 		grūdas 
cornflakes 		kukurūzų dribsniai 
corn-flower 		rugiagėlė 
corner 		kampas 
corner-stone 		kertinis akmuo 
corpuscle 		dalelė dalelytė 
correct 		tikras teisingas tikslus 
correlation 		santykiavimas, tarpusavio santykis/ryšys 
cost 		kaina 
cottage 		kotedžas pirkia namelis troba 
couch 		sofa kušetė kanapa 
couch-grass 		varputis 
cough 		kosulys 
counsel 		pasitarimas 
counselor 		patarėjas konsultantas 
count 		skaičiuoti 
counter 		prekystalis 
counterblow 		kontrsmūgis atsakomasis smūgis 
counterpart 		kolega, pareigūnas, einantis analogiškas pareigas (kitoje įstaigoje/šalyje ir pan.) 
countersign 		slaptažodis 
countless 		nesuskaičiuojamas 
country 		šalis 
county 		grafystė 
couple 		keletas pora dvejetas 
course 		kursas 
court 		kiemas 
courtyard 		kiemas 
cousin 		pusbrolis pusseserė 
cow 		karvė 
co-worker 		bendradarbis 
crack 		įtrūkimas įskilimas įlūžimas 
cram 		pri(si)kimšti (į)grūsti įbrukti 
crayfish 		(zool.) vėžys 
crayfishing 		vėžių gaudymas 
crazy 		beprotiškas pamišęs 
cream 		grietinė grietinėlė 
crease 		raukšlė klostė 
create 		kurti 
creation 		(su)kūrimas sudarymas 
creative 		kūrybingas kūrybiškas 
creator 		kūrėjas autorius 
crinkle 		vingis klostė raukšlė 
crock 		molinis puodas asotis 
crock up 		nusilpti palaužti 
crocks 		molinės šukės 
crockery 		indai 
crocodile 		krokodilas 
crook 		lazda (kerdžiaus, vyskupo) 
cross 		(bažn.) kryžius kryžiaus ženklas 
crowd 		minia 
crowd-pulling 		pritraukiantis daug publikos/žiūrovų turintis pasisekimą 
crowded 		perpildytas pilnutėlis 
crusade 		kryžiaus karas 
cry 		šaukti rėkti 
culture 		kultūra 
cultured 		kultūringas išsilavinęs 
cup 		puodelis puodas 
curds 		varškė 
curdle 		sutraukti sukrešėti stingti 
cure 		vaistai 
cureless 		nepagydomas neišgydomas 
curious 		smalsus norintis sužinoti 
curiously 		smalsiai 
curiosity 		smalsumas žinių troškimas noras sužinoti/pažinti 
current 		einamasis dabartinis 
cuss 		plūsti (pra)keikti 
cussed 		(šnek.) užsispyręs 
custom 		muitas muitinė 
customer 		pirkėjas klientas užsakovas 
customs 		muitas muitinė 
cut 		(per)pjauti įsipjauti 
cycle 		ciklas ratas 
cyclic 		ciklo ciklinis 
cyclical 		ciklo ciklinis 
cycling 		važiavimas/važinėjimas dviračiu 
cyclist 		dviratininkas 
cyclone 		(meteor.) ciklonas 
cyclonic 		(meteor.) cikloninis cikloniškas 
cyclopaedia 		(sutr. ret.) enciklopedija 
cyclopedia 		(sutr. ret.) enciklopedija 
cyclopaedic 		(sutr. ret.) enciklopedinis 
cyclopedic 		(sutr. ret.) enciklopedinis 
complain 		skųstis reikšti nepasitenkinimą guostis bėdoti 
complainant 		skundėjas 
cover 		dengti 
cover oneself 		apsidengti apsigaubti apsikloti 
cover up 		užpustyti 
coverage 		apimtis aprėpimas veikimo zona 
coveralls 		kombinezonas 
covering 		lydintis 
coverlet 		lovatiesė antklodė apklotas aptiesalas 
covert 		paslėptas slaptas 
cupboard 		spinta 
dainty 		skanėstas skanumynas gardumynas 
dairy 		pieninė (įmonė, parduotuvė) 
Dakar 		Dakaras 
damage 		sugadinti daryti nuostolius 
damn 		(pra)keikti 
damnable 		smerktinas 
Damocles 		Damoklas 
damp 		drėgnas 
dampish 		drėgnokas apydrėgnis 
dance 		šokti šokinėti 
dancer 		šokėjas 
dandle 		supti (vaiką) 
danger 		pavojus 
dangerous 		pavojingas 
dapper 		puošniai apsirengęs 
dark 		tamsus niūrus tamsiaveidis tamsiaplaukis 
darkness 		tamsa tamsybė tamsumas 
darling 		brangus(is) mielas(is) mylimas(is) 
dash 		staigus smarkus judesys/bėgimas staigus išvažiavimas veržimasis puolimas 
dashboard 		(lėktuvo, automobilio ir pan.) prietaisų skydas 
dashed 		nusiminęs nusivylęs 
dashing 		šaunus prašmatnus 
dashpot 		(tech.) buferis amortizatorius 
data 		duomenys faktai 
dative 		(gram.) naudininkas 
date 		data 
daub 		tinkas glaistas aptepas 
dauby 		prastai nutapytas 
daughter 		duktė dukra 
dawn 		aušra pradžia gimimas 
day 		diena dienos metas para 
daybreak 		aušra apyrytis 
dead 		miręs negyvas nejautrus nutirpęs visiškas nustojęs galioti 
deadline 		terminas kritinė riba 
deal 		išdalyti (pvz., kortas) paskirstyti 
dealer 		prekiautojas pirklys 
dealing 		elgesys 
dealings 		sandėriai 
dear 		brangus mielas mylimas 
death 		mirtis 
debt 		skola 
debtor 		skolininkas 
December 		gruodis 
decade 		dešimtmetis 
decease 		mirtis 
decide 		nuspręsti nutarti ryžtis 
decided 		aiškus, neabejotinas 
decidedly 		aiškiai, neabejotinai 
decider 		(sport.) lemiamas taškas/bėgimas/susitikimas 
deciding 		lemiamas 
decision 		sprendimas, nutarimas 
decisive 		lemiamas, sprendžiamasis 
decisively 		ryžtingai, tvirtai 
declaration 		pareiškimas paskelbimas deklaracija 
declare 		pareikšti paskelbti deklaruoti 
decline 		smukimas nuosmukis nykimas mažėjimas 
deed 		veiksmas poelgis faktas 
deep 		gilus žemas tamsus (apie spalvą) 
deer 		elnias 
defence 		apsauga gynyba gynimas 
defend 		(ap)ginti (ap)saugoti 
defender 		gynėjas 
defensive 		gynybos ginamasis 
deficiency 		stoka trūkumas deficitas 
define 		apibrėžti nusakyti nustatyti reikšmę 
definite 		aiškus apibrėžtas tikslus nustatytas 
definitely 		aiškiai apibrėžtai neabejotinai 
definition 		apibrėžimas definicija 
definitive 		galutinis (apie atsakymą, pasiūlymą, sprendimą ir pan.) 
degree 		laipsnis mastas 
deity 		dievybė dieviškumas 
delay 		užlaikymas vėlinimas(is) (už)delsimas (su)gaištis atidė(lio)jimas 
delete 		ištrinti panaikinti pašalinti 
delicious 		nepaprastai skanus (apie kvapa, skoni) 
deliver 		pristatyti atgabenti (iš)nešioti įteikti pagimdyti 
delivery 		pristatymas atgabenimas tiekimas įteikimas gimdymas 
demand 		(pa)reikalavimas paklausa poreikis 
demanding 		reiklus 
demented 		išprotėjęs beprotis 
Denmark 		Danija 
deny 		neigti paneigti nuneigti atmesti 
depart 		išvykti išeiti 
department 		skyrius departamentas žinyba katedra cechas (amer.) ministerija 
departure 		išvykimas išvažiavimas pasitraukimas 
depend 		priklausyti (on) 
dependant 		išlaikytinis pavaldinys 
dependence 		priklausomybė priklausomumas 
dependency 		priklausomybė 
dependent 		priklausąs priklausomas 
deplorable 		liūdnas apverktinas apgailėtinas 
deploy 		iš(si)dėstyti dislokuoti 
deployment 		iš(si)dėstymas dislokavimas 
depress 		(pri)slėgti liūdinti 
depressant 		raminamasis/slopinamasis vaistas 
depressed 		prislėgtas nusiminęs (about, at) 
depressing 		slegiantis liūdnas 
depression 		nusiminimas prislėgta nuotaika depresija 
depressive 		slegiantis liūdnas 
depth 		gylis gilumas gelmė 
derivable 		gaunamas išvedamas 
derivation 		kilmė šaltinis kilmės nustatymas 
derivative 		(gram.) išvestinis žodis vedinys 
derive 		gauti įgyti 
descend 		nu(si)leisti nulipti 
design 		projektuoti piešti eskizus sukurti apipavidalinti konstruoti modeliuoti sumanyti 
designed 		tyčinis 
designer 		projektuotojas konstruktorius dizaineris 
desire 		troškimas aistra noras 
desk 		rašomasis stalas mokyklos suolas viešbučio administratorius registratūra 
destroy 		(su)naikinti (su)griauti (su)ardyti 
destroyer 		griovėjas naikintojas 
destruct 		likvidavimas/su(si)naikinimas skridimo metu (raketos/sviedinio) 
destruction 		griovimas (su)naikinimas (su)ardymas 
destructive 		griaunamasis naikinamasis ardomasis 
destructor 		(ret.) griovėjas 
detest 		ne(ap)kęsti bjaurėtis 
develop 		(išsi)vystyti lavinti(s) 
development 		išsivystymas augimas 
devil 		velnias nelabasis 
devote 		atsiduoti atsidėti 
devoted 		atsidėjęs atsidavęs ištikimas 
devotion 		atsidavimas prisirišimas 
diabetes 		diabetas cukraligė 
diary 		dienynas dienoraštis 
Diana 		Diana 
dice 		(žaidžiamasis) kauliukas kauliukai 
dictate 		diktatas įsakymas paliepimas 
dictionary 		žodynas 
difference 		skirtumas nesutarimas skirtingumas skiriamasis požymis 
different 		skirtingas kitoks įvairus 
differently 		antraip kitaip 
difficult 		sunkus varginantis keblus 
difficulty 		kebli padėtis sunkumas kliūtis apsunkinimas kliuvinys 
digit 		skaitmuo vienaženklis skaičius 
digital 		skaitmeninis 
dinner 		pietūs 
direct 		tiesus 
direction 		kryptis 
directive 		direktyva 
directly 		tiesiai tiesiog betarpiškai 
director 		direktorius 
directory 		adresų ar telefonų knyga 
dirty 		purvinas blogas nešvarus 
disc 		diskas skritulys 
discard 		išmesti atmesti 
disclaim 		(pa)neigti atsisakyti išsižadėti 
disclaimer 		paneigimas atsisakymas išsižadėjimas 
disclose 		atskleisti atidengti demaskuoti 
disclosure 		atskleidimas atidengimas demaskavimas 
discovery 		atradimas 
discuss 		(ap)svarstyti aptarti diskutuoti (with) 
discussion 		(ap)svarstymas aptarimas diskusija debatai pokalbis 
disease 		liga 
dish 		dubuo lėkštė 
disk 		diskas skritulys 
discriminate 		aiškus 
discriminating 		skiriantis mokantis (at)skirti 
discrimination 		diskriminacija atskyrimas 
displace 		perkelti perstatyti į kitą vietą 
displacement 		perkėlimas 
disqualification 		diskvalifikacija 
disregard 		nepaisymas ignoravimas niekinimas 
disreputable 		turintis prastą vardą/reputaciją 
dissent 		nesutarimas nesutikimas atskira nuomonė skilimas 
dissenter 		disidentas atskalūnas atskilėlis 
dissention 		nesantaika 
distinct 		skirtingas 
distinction 		skirtumas skirtingumas 
distinctive 		savitas charakteringas skiriamasis 
distinctly 		aiškiai ryškiai (kalbėti, girdėti, matyti) 
distinctness 		aiškumas ryškumas 
district 		sritis apygarda rajonas 
Diogenes 		Diogenas 
divide 		dalyti dalytis 
divided 		atidalytas padalytas į dalis 
dividend 		(mat.) dalijamasis dalinys 
divinity 		dievybė 
division 		dalyba padalijimas 
divorce 		skyrybos ištuoka 
divorcement 		at(si)skyrimas 
Don Quixote 		Don Kichotas 
doctor 		daktaras gydytojas 
dog 		šuo 
doggery 		šunybė šuniškas elgesys 
doggie 		šuniukas šunytis 
doggish 		šuniškas 
doggy 		šuniukas šunytis 
dollar 		doleris 
dome 		kupolas 
domestic 		namų naminis šeimyninis 
domestic servant 		namų darbininkė 
domestics 		vietinės gamybos prekės 
domesticate 		prijaukinti (gyvulius) 
door 		durys 
doormat 		patiesalas prie durų (kojoms valyti) 
dot 		taškas 
double 		dvigubas dvejopas sudvejintas 
doubt 		abejonė 
doubtful 		abejotinas įtartinas 
down 		žemyn žemai apačioje 
downcast 		nusiminęs nuleidęs akis 
downfall 		smarkus lietus liūtis 
downright 		tiesus sąžiningas atviras 
downstairs 		žemyn (laiptais) 
downstrem 		pasroviui 
downtown 		komercinė/prekybinė miesto dalis miesto centras 
downward 		žemėjantis einantis žemyn smunkantis žemėjimo (apie tendenciją ir pan.) 
downwards 		žemyn 
drag 		vilkimas tempimas 
drain 		sausinti drenuoti 
drainage 		nusausinimas drenažas 
draw 		(iš)traukimas 
drawback 		trūkumas 
drawer 		stalčius 
drawers 		(pl.) apatinės kelnės 
drawing 		piešinys brėžinys 
drawn 		pp iš draw 
dress 		suknelė 
dressage 		(arklių) dresavimas išjodinėjimas 
dressing 		ap(si)rengimas 
drew 		past iš draw 
dribble 		varvėti 
drink 		gerti girtauti girtuokliauti nusigerti (into, to) 
drink away 		pragerti 
drinkable 		geriamas tinkamas gerti 
drinker 		gėrėjas 
drinking-bout 		išgertuvės girtavimas 
drinking-song 		užstalės daina 
drive 		vairuoti važiuoti (automobiliu ir pan.) 
driven 		pp iš drive 
driver 		vežikas vairuotojas mašinistas šoferis 
droll 		juokingas keistas komiškas 
drollery 		humoras 
drop 		lašas 
droppings 		gyvulių mėšlas 
drove 		pt iš drive 
drown 		(nu)skęsti skandinti skandintis nusiskandinti paskęsti prigerti 
drowned 		nuskendęs paskandintas 
drug 		vaistas 
drum 		būgnas 
drummer 		būgnininkas 
drumstick 		būgnininko lazdelė 
dual 		dvilypis dvejopas dvigubas 
dubious 		abejotinas 
Dublin 		Dublinas 
duck 		(zool.) antis 
ducking 		pa(si)nėrimas (į vandenį) 
duckling 		ančiukas 
ducky 		(šnek.) brangusis mylimasis 
due 		priklausąs skolingas reikiamas laukiamas 
due to 		dėl 
dues 		rinkliava mokesčiai 
duel 		dvikova rungtynės 
duet 		duetas 
duly 		reikiamai prideramai 
dumb 		nebylus 
dung 		mėšlas išmatos 
dunk 		(krepšinyje) dėjimas kamuolio dėjimas į krepšį iš viršaus 
duplex 		dvilypis dvigubas 
duration 		trukmė laikas 
during 		per metu 
dust 		dulkės 
Dutch 		olandiškas olandų 
Dutchman 		olandas 
each 		kiekvienas 
eager 		labai trokštąs siekiąs 
ear 		ausis klausa 
earn 		už(si)dirbti (pragyvenimui) 
earnings 		uždarbis atlyginimas 
early 		anksti 
ease 		ramybė 
East 		rytai 
east 		rytai 
Easter 		Velykos 
easy 		lengvas 
eat 		valgyti maitintis 
edgy 		kampuotas aštrus 
educate 		auklėti mokyti šviesti 
education 		auklėjimas švietimas 
effect 		veiksmas 
effects 		daiktai turtas 
effective 		efektyvus 
effectively 		veiksmingai efektyviai įspūdingai 
effectiveness 		veiksmingumas efektyvumas įspūdingumas 
effectless 		neveiksmingas neefektyvus be rezultatų 
effectual 		efektyvus pasiekiąs tikslą 
effort 		pastanga stengimasis 
effortless 		pasyvus nesistengiąs 
egg 		kiaušinis kiaušinėlis 
Egypt 		Egiptas 
Egyptian 		egiptietis 
eel 		ungurys 
eight 		aštuoni 
eighteen 		aštuoniolika 
eightieth 		aštuoniasdešimtas 
eighty 		aštuoniasdešimt 
elaborate 		kruopščiai paruoštas 
elbow 		alkūnė 
elder 		vyresnis 
elect 		(iš)rinkti (balsuojant) 
election 		rinkimai 
elective 		renkamas 
elector 		rinkėjas 
electoral 		rinkiminis rinkimų 
electorate 		rinkėjų kontingentas elektoratas 
electric 		elektrinis 
electrical 		elektrinis 
electrical engineering 		elektrotechnika 
electrician 		elektrotechnikas 
electricity 		elektra 
electrics 		elektros įranga 
electrification 		elektrifikacija 
electrify 		elektrifikuoti 
electrocute 		užmušti elektra 
electrode 		elektrodas 
electrolysis 		elektrolizė 
electron 		elektronas 
electronics 		elektronika 
electroplate 		galvanizuoti 
element 		elementas sudėtinė dalis 
elephant 		dramblys 
elephantine 		dramblio drambliškas 
elevator 		elevatorius keltuvas liftas (amer.) 
eleven 		vienuolika 
eleventh 		vienuoliktas 
eliminate 		(pa)šalinti (iš)mesti atmesti 
elimination 		pašalinimas šalinimas 
elk 		briedis 
else 		kitaip priešingu atveju 
encounter 		susidurti susiremti netikėtai susitikti 
encourage 		(pa)raginti padrąsinti paremti 
encyclopaedia 		enciklopedija enciklopedinis žodynas 
encyclopedia 		enciklopedija enciklopedinis žodynas 
encyclopaedic 		enciklopedinis 
cyclopedic 		enciklopedinis 
encyclopaedist 		enciklopedistas 
encyclopedist 		enciklopedistas 
end 		galas pabaiga riba 
endanger 		statyti į pavojų kelti grėsmę 
ending 		pabaiga galūnė 
end up 		pasibaigti nustoti 
enemy 		priešas, priešininkas 
enjoy 		gėrėtis 
enjoyable 		malonus 
enjoyment 		malonumas pomėgis 
endorse 		patvirtinti pasirašyti žiruoti 
engage 		patraukti (dėmesį) sudominti 
engagement 		įsipareigojimas 
engaging 		patrauklus žavus 
engine 		motoras variklis 
engineer 		inžinierius 
engineering 		inžinerija technika 
England 		Anglija 
English 		angliškas anglų 
Englishman 		anglas 
Englishwoman 		anglė 
endeavor 		pastangos stengimasis 
endeavour 		pastangos stengimasis 
enough 		pakankamas 
enquire 		klausinėti teirautis (about) 
enter 		įeiti 
enterprise 		įmonė 
enthusiast 		entuziastas užsidegėlis 
enthusiastic 		pilnas entuziazmo/energijos entuziastingas entuziastiškas 
enthusiasm 		entuziazmas 
entrance 		įėjimas įvažiavimas 
entree 		įėjimo teisė 
entire 		visas pilnas ištisas 
entry 		įėjimas įvažiavimas įžengimas 
envelop 		apvynioti apgaubti apsiausti apsupti 
envelope 		vokas apvalkalas 
envelopment 		apvyniojimas apsiautimas apdanga 
enviable 		pavydėtinas keliantis pavydą 
envious 		pavydus 
environ 		apsupti 
environment 		aplinka terpė 
environs 		apylinkės kaimynystė 
envy 		pavydas 
embrace 		ap(si)kabinimas glėbys 
emerge 		iškilti pasirodyti atsirasti 
emergence 		pasirodymas 
emergency 		nenumatytas atvejis kritiška padėtis 
emigrant 		emigrantas išeivis 
emigrate 		emigruoti persikelti 
emigration 		emigracija emigravimas išeivystė 
emigratory 		emigracinis emigracijos 
emotion 		jausmas emocija 
emotional 		emocinis 
emotionalism 		(perdėtas) emocingumas sentimentalumas 
emotionality 		emocionalumas 
employ 		samdyti 
employee 		tarnautojas darbuotojas įdarbintasis 
empower 		įgalioti suteikti teisę 
empowered 		įgaliotas 
empowering 		įgaliojimas įgalinimas 
equal 		lygus tolygus vienodas 
equality 		lygybė lygiateisiškumas 
equalize 		(su)lyginti (su)vienodinti 
equalizer 		(sport.) išlyginamasis įvartis 
equally 		lygiai lygiomis vienodai 
equation 		išlyginimas 
equilibrium 		pusiausvyra 
equipment 		(tech.) įrengimai įrenginiai 
equitable 		teisingas bešališkas 
equivalence 		ekvivalentiškumas lygiavertiškumas atitikimas 
error 		klaida 
escape 		išsigelbėjimas išvengimas 
especially 		ypač specialiai ypatingai itin 
Esperanto 		esperanto (kalba) 
essence 		esmė 
estate 		dvaras 
esteem 		pagarba 
Estonia 		Estija 
Ethiopia 		Etiopija 
eve 		išvakarės 
even 		lygus vienodas panašus monotoniškas 
even a score 		išlyginti rezultatą 
even as 		kaip tik tada kai 
even so 		vis tiek 
even-handed 		nešališkas teisingas 
even-minded 		ramus lygus 
even-tempered 		ramus 
evening 		vakaras 
event 		įvykis atsitikimas renginys 
eventide 		vakaras 
eventual 		pagaliau įvykstantis 
eventually 		pagaliau ilgainiui 
evidence 		akivaizdumas įrodymas įkaltis 
evolution 		evoliucija vystymasis 
Europe 		Europa 
European 		europietiškas europinis 
exact 		tikslus griežtas tikras 
exacting 		reiklus griežtas 
exaction 		(pinigų ir pan.) išreikalavimas išieškojimas 
exactitude 		tikslumas 
exactly 		tikrai tiksliai kaip tik 
exactness 		tikslumas 
exactor 		reikalautojas prievartautojas 
example 		pavyzdys pamokymas paveikslas 
excellence 		meistriškumas tobulas mokėjimas 
Excellency 		ekscelencija 
excellent 		puikus labai geras aukštos kokybės 
except 		išskyrus be išskiriant 
excepting 		išskyrus išskiriant 
exception 		išimtis prieštaravimas 
exceptional 		nepaprastas išimtinis 
excess 		perteklius perviršis viršijimas 
excessive 		perdėtas pernelyg didelis besaikis 
excessively 		perdėtai per daug 
excite 		jaudinti jaudintis būti susijaudinusiam/sujaudintam 
excitement 		su(si)jaudinimas jaudinimasis 
excited 		sujaudintas susijaudinęs 
excuse 		atsiprašymas pa(si)teisinimas 
execrable 		bjaurus šlykštus 
exit 		išėjimas išvažiavimas 
exist 		egzistuoti būti gyventi gyvuoti 
existence 		būtis egzistavimas gyvenimas buvimas būvis egzistencija gyvavimas 
existent 		egzistuojantis esantis 
existing 		esamas esantis 
expedition 		ekspedicija 
expeditionary 		ekspedicinis ekspedicijos 
expect 		laukti 
expend 		išeikvoti išleisti 
expendable 		panaudojamas eikvojamas 
expenditure 		šlaidos sąnaudos 
expense 		išlaidos eikvojimas 
expensive 		brangus 
expensiveness 		brangumas 
experience 		patirtis patyrimas 
experiment 		bandymas eksperimentas (in, on, with) 
experimental 		eksperimentinis bandomasis pagrįstas bandymu 
experimentalize 		eksperimentuoti daryti bandymus 
experimentally 		eksperimentiškai bandymais eksperimento būdu 
experimentation 		eksperimentavimas bandymai 
experimenter 		eksperimentuotojas eksperimentatorius bandytojas 
expertise 		ekspertizė įvertinimas 
express 		ekspresas (greitasis traukinys, autobusas) 
expressible 		išreiškiamas 
expression 		posakis pasakymas 
expressionism 		(men.) ekspresionizmas 
expressionist 		(men.) ekspresionistas 
expressionless 		neraiškus neišraiškingas 
expressive 		(iš)raiškus išraiškingas ekspresyvus 
expressivity 		(stiliaus, paveikslo) išraiškingumas išraiškumas 
expressly 		specialiai 
expressway 		(amer., austral.) (miesto) autostrada greitkelis 
extent 		mastas apimtis laipsnis 
extern 		(amer.) studentas medikas ar gydytojas, dirbantis ligoninėje 
external 		išorinis išviršinis 
externally 		išoriškai iš išorės 
extra 		pridėtinis papildomas 
extract 		ištraukti (dantį, kamštį) 
extraction 		ištraukimas 
eye 		akis 
either 		vienas iš dviejų tas ar kitas 
either ... or 		arba ... arba 
either will do 		bet kuris tiks 
either-or 		neišvengiamas pasirinkimas 
ever so 		labai 
ever 		kada nors 
evermore 		amžinai visais laikais 
every 		visas 
every now and then 		kartkarčiais 
everybody 		kiekvienas visi 
everyday 		kasdieninis įprastas kasdieniškas 
everyone 		kiekvienas visi 
everything 		viskas 
everywhere 		visur 
face 		veidas veido išraiška grimasa fasadas 
facile 		paviršutiniškas skubotas 
facility 		lengvumas laisvumas sklandumas 
facilitate 		(pa)lengvinti padėti 
fight 		kovoti kautis grumtis 
fighter 		kovotojas karys 
fighting 		kova mūšis 
fact 		faktas tikrovė įvykis 
fail 		visiška nesėkmė 
fail-safe 		(veikiantis) be avarijų patikimas saugus automatiškai išsijungiantis (avarijos atveju) 
failed 		nepavykęs nesėkmingas 
failing 		trūkumas silpnybė 
failure 		nesėkmė triktis sutrikimas žlugimas 
fair 		neblogas 
faith 		tikėjimas patikėjimas 
faithful 		ištikimas patikimas atsidavęs 
faithfully 		ištikimai patikimai 
faithfulness 		ištikimybė patikimumas 
faithless 		neištikimas nepatikimas 
falcon 		sakalas 
false 		klaidingas melagingas neteisingas klastingas 
false pride 		puikybė pasipūtimas 
falsehood 		melas neteisybė 
falseness 		klaidingumas 
falsifification 		falsifikacija 
falsify 		padirbti 
falsity 		klaidingumas melagingumas 
family 		šeima šeimyna giminė 
far 		toli 
far between 		retai 
far-away 		svajingas 
far-distant 		tolimas 
far-off 		tolimas nutolęs 
far-seeing 		toliaregis įžvalgus 
fare 		mokestis už važiavimą (autobusu ir pan.) bilieto kaina 
farewell 		atsisveikinimas 
farm 		ūkis ferma kaimo namas 
farmer 		ūkininkas fermeris 
farming 		ūkininkavimas žemdirbystė 
farm out 		(iš)nuomoti žemę 
fascism 		fašizmas 
fascist 		fašistas 
fast 		greitas spartus 
fast-food 		greitai pateikiamas karštas patiekalas (kavinėje ir pan.) 
fast-moving 		greitaeigis greitas dinamiškas 
fast-setting 		greitai kietėjantis (apie cementą ir pan.) 
fast-track 		greitas paaukštinimas (tarnyboje) 
fasting 		pasninkaujantis 
fat 		riebus storas 
fatty 		riebus storas 
father 		tėvas 
fatherland 		tėvynė gimtinė 
fault 		klaida nepataikymas 
February 		vasaris 
feed 		maitinti šerti penėti 
feedback 		grįžtamasis ryšys atsakomoji reakcija 
feel 		jausti(s) pergyventi 
feeling 		jausmas jautimas emocija jutimas nuojauta 
felicity 		laimė pripažinimas pritarimas 
fellow 		draugas bičiulis 
fem 		lesbietė 
female 		moteris 
feminine 		moterų moteriškas 
femininity 		moteriškumas 
feminism 		feminizmas 
feminist 		feministų 
feminize 		moteriškėti 
femme fatale 		fatališka moteris 
fen 		pelkė bala 
fence 		tvora užtvara 
fenceless 		atviras neaptvertas 
fern 		papartis 
festival 		festivalis šventė iškilmės 
fetch 		atnešti atgabenti 
fetching 		patrauklus žavingas 
fever 		karštis karščiavimas 
few 		keletas nedaug šiek tiek 
fiddle 		smuikas 
fifteen 		penkiolika 
fiftieth 		penkiasdešimtas 
fifty 		penkiasdešimt 
fire 		ugnis 
fire-escape 		atsarginis išėjimas (gaisro atveju) 
fire-hose 		gaisrinė žarna 
fire-irons 		židinio įrankiai 
fire-raiser 		padegėjas 
fire-raising 		padegimas 
fireman 		gaisrininkas kūrikas 
firewood 		malkos 
firework 		fejerverkas 
firm 		firma 
firmly 		stipriai 
firmness 		nepajudinamumas tvirtybė stiprumas 
firmware 		mikroprograma 
first 		pirmas pirmasis 
firstly 		pirmiausia pirma 
first name 		vardas 
first of all 		visų pirma pirmiausia 
fish 		žuvis 
fisher 		žvejys 
fisherman 		žvejys 
fist 		kumštis (šnek.) ranka 
fisticuffs 		kumštynės 
fistful 		sauja 
fit 		priepuolis 
fitness 		tinkamumas tikimas 
fear 		baimė bijojimas būkštavimas nuogąstavimas 
fearful 		baisus 
fearless 		bebaimis drąsus 
feast 		puota balius pokylis 
feature 		ypatybė savybė bruožas požymis 
field 		laukas pieva dirva 
file 		failas byla 
film 		filmas kino juosta 
film-goer 		kino žiūrovas 
filmstrip 		diafilmas 
filmy 		plėvelinis permatomas 
filthy 		nešvarus bjaurus šlykštus nešvankus 
fine 		puikus gražus 
fine down 		patikslinti 
fine-cut 		susmulkintas 
fine-grained 		smulkiagrūdis 
fine-tooth 		tankus 
fine-tune 		tiksliai nustatyti reguliuoti 
fineness 		gražumas puikumas 
finery 		puošnūs drabužiai brangūs papuošalai 
finesse 		subtilumas taktiškumas 
finger 		pirštas 
finite 		ribotas 
Finland 		Suomija 
fission 		skilimas 
five 		penki 
fix 		pritvirtinti įrengti 
fixed 		fiksuotas nejudamas 
fixture 		numatyta data 
flag 		vėliava 
flake 		snaigės snieguolės dribsniai 
flame 		liepsna 
flame up 		įsidegti užsiliepsnoti 
flame-thrower 		liepsnosvaidis 
flameproof 		nedegus 
flare 		šviesos signalas signalinė raketa 
flared 		į apačią išplatėjęs (apie sijoną, kelnes) 
flash 		tvykstelėti blykstelėti šmėkštelėti 
flash about 		demonstruoti 
flash around 		švaistytis 
flash-flood 		staigus potvynis 
flash-light 		(amer.) kišeninis žibintuvėlis 
flashbulb 		blykstė 
flashcard 		kortelė su žodžiu kortelė su paveikslu 
flashing 		mirksintis 
flashlight 		(amer.) kišeninis žibintuvėlis 
flashy 		rėksmingas neskoningas rėžiantis 
flat 		butas 
flea 		blusa 
fleck 		dėmė 
flier 		lakūnas 
flirt 		koketė žmogus, mėgstantis flirtuoti 
flirtation 		flirtas flirtavimas 
flirtatious 		koketiškas mėgstantis flirtuoti 
flesh 		mėsa minkštimas 
flesh-colour 		kūno spalva 
flesh out 		išplėsti 
flesh-eating 		mėsėdis 
flesh-wound 		lengvas sužeidimas 
fleshly 		kūniškas 
fleshy 		mėsingas mėsiškas 
flight 		skridimas skraidymas 
float 		plaukti plūduriuoti 
float away 		nuplaukti 
float off 		nuplaukti nuo seklumos 
floatable 		plūduriuojantis plukdomasis 
floatage 		plūduriavimas 
floatation 		plūduriavimas 
floater 		plūdė 
floating 		plaukiojantis plūduriuojantis nepastovus laisvai kintantis 
floaty 		plaukiojantis lengvas 
floor 		grindys 
flooring 		grindys parketas 
flour 		miltai 
flower 		žiedas gėlė 
flu 		gripas 
fluency 		(kalbos) laisvumas sklandumas (stiliaus) lengvumas 
fluent 		sklandus (apie kalbą) 
fluently 		sklandžiai 
flush 		purptelėti 
flute 		fleita 
fly 		skristi lėkti skraidinti 
flyer 		lakūnas 
flying 		skrendąs 
fodder 		pašaras ėdesys 
folk 		žmonės liaudis 
folk-crafts 		liaudies amatai 
folklore 		folkloras 
folkways 		liaudies papročiai 
fond 		meilus švelnus mylįs 
food 		maistas 
foolish 		kvailas kvaišas 
foot 		koja pėda 
football 		futbolas 
footbrake 		(aut.) kojinis stabdys 
footbridge 		pėsčiųjų tiltas 
forbid 		(už)drausti užginti neleisti 
forbidden 		uždraustas draudžiamas 
forbidding 		atstumiantis atgrasus nepatrauklus grėsmingas 
force 		jėga 
force back 		sulaikyti 
force down 		užtrenkti 
force in 		įsprausti 
force majeure 		nenumatytos aplinkybės 
force through 		prakišti 
force up 		smarkiai padidinti 
force-pump 		slėgimo siurblys 
forecast 		nuspėjimas (orų ir pan.) prognozė 
forecaster 		oro prognozės sudarytojas 
forecasting 		spėjimas prognozavimas 
foreigner 		svetimšalis 
foremost 		priekinis 
forest 		miškas giria 
forget 		užmiršti neprisiminti 
forgetful 		užmaršus 
forgive 		atleisti dovanoti 
fork 		šakės šakutės 
form 		forma pavidalas išorinė išvaizda 
fortieth 		keturiasdešimtas 
forthwith 		tuojau nedelsiant 
fortunate 		laimingas sėkmingas 
fortune 		laimė 
forty 		keturiasdešimt 
forum 		forumas 
forward 		priešakinis 
foul 		dvokiąs 
four 		keturi 
fourth 		ketvirtas ketvirtadalis ketvirtis 
fourteen 		keturiolika 
fourteenth 		keturioliktas 
fowl 		naminis paukštis 
fox 		lapė 
France 		Prancūzija 
fragile 		trapus lūžus dūžtamas 
fragility 		trapumas lūžumas 
fragment 		nuolauža skeveldra šukė 
fragmentary 		fragmentinis nuotrupinis fragmentiškas ne pilnas ne visas 
fragmentation 		(su)irimas (su)skilimas 
fragrance 		aromatas kvepėjimas 
fragrant 		aromatiškas kvapus 
French 		prancūziškas prancūzų prancūzų kalba 
Friday 		penktadienis 
free 		laisvas išlaisvintas 
free-and-easy 		laisvas nesivaržantis nevaržomas 
free-liver 		pramogautojas 
free-living 		mėgstantis pramogauti mėgstantis lėbauti 
free-spoken 		tiesus atviras 
free-thinker 		laisvamanis 
freebooter 		piratas 
freedom 		laisvė 
freeze 		(už)šalti pašalti 
freezing 		užšalimas užšaldymas 
freeware 		nemokama programinė įranga 
fresh 		šviežias naujas neprityręs 
frequency 		dažnumas pasikartojimas dažnis 
frequent 		dažnas tankus 
frequenter 		dažnas lankytojas 
frequently 		dažnai tankiai 
friend 		draugas draugė bičiulis 
friendless 		vienišas be draugų 
friendly 		draugiškas 
friendship 		draugystė 
fries 		(ypač amer.) (kul.) bulvių šiaudeliai (t.p. French fries) 
frightful 		baisus 
frog 		varlė 
front 		fasadas priekis 
front-and-center 		labai svarbus 
front-rank 		garsus svarbus svarbiausias 
front-runner 		rimčiausias pretendentas lyderis 
frontage 		fasadas 
frontal 		priekinis 
frontbench 		priekinės suolų eilės 
frontier 		siena pasienis 
frontier-guard 		pasienietis 
frost 		šaltis speigas šerkšnas 
frown 		antakių suraukimas piktas žvilgsnis nepritarimo reiškimas 
frowning 		susiraukęs paniuręs 
fruit 		vaisiai 
fruitless 		nevaisingas 
fruit-tree 		vaismedis 
fruitage 		vaisių vedimas 
fruitcake 		vaisinis tortas 
fruitful 		vaisingas našus produktyvus 
fruitfulness 		derlumas vaisingumas 
fruition 		išsipildymas įgyvendinimas realizavimasis 
fruitlessness 		nevaisingumas bergždumas 
fruity 		vaisinis 
fruit-sugar 		gliukozė 
frustrate 		(su)gniuždyti (su)erzinti 
frustrated 		sužlugdytas sužlugęs susierzinęs nusivylęs 
frustration 		(planų) (su)ardymas 
fuck 		(šnek.) lytiškai santykiauti 
fuck! 		po velnių! 
fuck about 		(šnek.) kvailioti mulkinti 
fuck around 		(šnek.) kvailioti mulkinti už nosies vedžioti 
fuck off! 		(šnek.) nešdinkis! 
fuck up 		(šnek.) sugadinti 
fucker 		(šnek.) žioplys 
function 		funkcija 
fund 		atsarga fondas kapitalas lėšos 
funeral 		laidotuvės šermenys 
fungus 		grybas grybelis 
fulfill 		atlikti 
fulfilling 		teikiantis daug pasitenkinimo (apie darbą ir pan.) 
full 		pilnas visas 
fun 		juokas pokštas 
functional 		funkcinis veikiantis 
funny 		juokingas 
fur 		kailis vilnos kailiai 
furnace 		krosnis žaizdras 
furrow 		vaga 
further 		tolimesnis tolesnis 
fury 		siutimas šėlimas įniršimas 
futile 		nenaudingas bergždžias 
future 		ateitis perspektyva rytdiena 
Gaelic 		Škotijos/Airijos keltų kalba 
Gaelic language 		Škotijos/Airijos keltų kalba 
gain 		uždirbti 
gainful 		pelningas naudingas (gerai) apmokamas 
gait 		eisena 
galaxy 		galaktika 
gale 		audra štormas stiprus vėjas 
gallery 		galerija 
game 		žaidimas 
garage 		garažas 
garden 		sodas parkas daržas 
gardener 		sodininkas 
gardening 		sodininkystė 
garlic 		česnakas 
gas 		dujos 
gasolene 		gazolinas (amer.) benzinas 
gasoline 		gazolinas (amer.) benzinas 
gaunt 		sulysęs išbadėjęs nusikamavęs 
gave 		pt iš give 
gay 		linksmas 
gear 		(tech.) pavara 
gearbox 		(tech.) greičių dėžė 
gem 		brangakmenis 
gemma 		pumpuras 
gene 		genas 
general 		bendras paprastas vyriausias visuotinis 
generalization 		apibendrinimas 
generation 		karta generacija 
generous 		dosnus 
genesis 		kilmė genezė 
genetic 		(biol.) genetinis 
genetically 		genetiškai, pagal kilmę 
genetics 		genetika 
Geneva 		Ženeva 
genial 		linksmas geraširdis nuoširdus malonus 
gentle 		švelnus romus 
genuine 		tikras nesuklastotas autentiškas 
genuinely 		nuoširdžiai 
genus 		(biol.) gentis 
geography 		geografija 
geology 		geologija 
geometry 		geometrija 
Georgia 		Gruzija 
germ 		gemalas embrionas 
German 		vokiškas 
Germany 		Vokietija 
gift 		dovana dovanojimas 
gifted 		gabus talentingas 
giftedness 		talentingumas 
gigantic 		gigantiškas, milžiniškas, didžiuli 
giraffe 		žirafa 
girdle 		diržas 
girl 		mergaitė mergina duktė 
give 		(ati)duoti paduoti (pa)dovanoti paskirti 
given 		pp iš give 
glacier 		ledynas 
glad 		patenkintas linksmas 
glade 		(miško) aikštė trakas kirtavietė kirtimas laukymė 
gladly 		linksmai džiaugsmingai 
gland 		(anat.) liauka 
glass 		stiklas 
global 		pasaulinis pasaulio globalinis 
globally 		pasauliniu mastu visame pasaulyje 
globe 		Žemės rutulys 
glove box 		daiktadėžė 
glory 		garbė šlovė triumfas didybė puikybė 
glory be! 		ačiū dievui! 
glove 		pirštinė 
glucose 		gliukozė 
glue 		klijai 
glue over 		apklijuoti aplipdyti 
glue up 		užklijuoti 
gluey 		lipnus klijingas 
go 		eiti vaikščioti 
goal 		tikslas uždavinys 
goat 		ožys ožka 
God 		dievas 
god 		stabas dievaitis dievybė 
goddess 		deivė 
godless 		bedievis 
god-child 		krikštavaikis 
godchild 		krikštavaikis 
god-daughter 		krikštaduktė 
goddaughter 		krikštaduktė 
godfather 		krikštatėvis 
godmother 		krikštamotė 
godson 		krikštasūnis 
going 		einantis esamas veikiantis 
going out 		išėjimas 
going round 		apvažiavimas 
gold 		auksas 
gonna 		(amer. šnek.) going to reiškiant būsimąjį laiką 
good 		geras geros kokybės 
goods 		(pl.) prekės 
goodness 		gerumas 
goose 		žąsis 
gooseberry 		agrastas 
gorilla 		gorila 
gorgeous 		(šnek.) žavus puikus 
gown 		mantija 
grade 		laipsnis 
gram 		gramas 
grammar 		gramatika 
gramme 		gramas 
grandad 		(šnek.) senelis 
granddad 		(šnek.) senelis 
grandfather 		senelis 
grandpa 		(šnek.) senelis 
grandma 		(šnek.) močiutė senelė 
grandmamma 		(šnek.) močiutė senelė 
grandmother 		močiutė senelė 
granite 		granitas 
grannie 		(šnek.) močiutė senelė 
granny 		(šnek.) močiutė senelė 
grandson 		anūkas vaikaitis 
grape 		vynuogė 
grape-sugar 		gliukozė 
grapefruit 		greipfrutas 
grapevine 		tikrasis vynmedis 
graph 		diagrama grafikas kreivė 
graphic 		grafinis grafiškas vaizdus vaizdinis 
graphic arts 		grafika 
graphically 		grafiškai vaizdingai 
graphics 		grafika 
graphite 		grafitas 
grass 		žolė 
grave 		rimtas svarus 
gravel 		žvyras žvirgždas 
gravelled 		žvirgždėtas Žvyruotas 
gravely 		rimtai sunkiai 
graveyard 		kapinės 
gray 		pilkas 
gray-haired 		žilaplaukis 
gray-headed 		žilagalvis senas 
grayish 		pilkšvas žilsvas 
grease 		taukai riebalai 
great 		didelis didysis didžiulis 
Great Britain 		Didžioji Britanija 
Greece 		Graikija 
Greek 		graikas 
green 		žalias 
greenness 		žalumas 
Greenland 		Grenlandija 
grey 		pilkas 
grey-haired 		žilaplaukis 
grey-headed 		žilagalvis senas 
greyish 		pilkšvas žilsvas 
grieve 		nuliūdinti sukelti sielvartą 
grin 		vaipymasis išsišiepimas 
grippe 		gripas 
group 		grupė grupuotė frakcija 
grow 		augti didėti (iš)auginti 
grubby 		nešvarus purvinas 
guard 		apsauga sargyba sargybinis 
guardian 		saugotojas globėjas 
Guatemala 		Gvatemala 
guess 		(at)spėti manyti 
guest 		svečias 
guide 		vadovas vadovėlis 
guidebook 		turisto vadovas 
guillotine 		giljotina 
guilt 		kaltė kaltumas 
guiltiness 		kaltumas 
guiltless 		nekaltas nenusikaltęs 
guiltlessness 		nekaltumas 
guilty 		kaltas nusikaltęs nuodėmingas 
guitar 		gitara 
guitarist 		gitaristas 
gulp 		(didelis) gurkšnis, gurkštelėjimas 
gun 		šautuvas 
gut 		(anat.) žarna virškinimo traktas žarnos viduriai 
guy 		vaikinas vyrukas 
gym 		(šnek.) mankšta gimnastika 
gymnast 		gimnastas 
gymnastic 		gimnastikos 
gymnastics 		gimnastika 
gypsum 		gipsas 
habit 		įprotis įpratimas papratimas pripratimas 
hacker 		kompiuterių aistruolis programišius 
hail 		šūktelėti (pa)šaukti 
hair 		plaukas plaukai 
hairy 		plaukuotas gauruotas 
half 		pusė 
halt 		sustojimas pertrauka poilsis 
hamlet 		kaimelis 
hammer 		plaktukas kūjis 
hand 		ranka plaštaka 
hand-crafted 		rankų darbo (ne mašina gamintas) 
hand-held 		rankinis portatyvinis 
handbag 		rankinukas rankinė 
handball 		(sport.) rankinis 
handbook 		vadovas (knyga) vadovėlis 
handbrake 		(aut.) rankinis stabdys 
handclap 		plojimai aplodismentai 
handicraft 		amatas rankų darbas 
handshake 		rankos paspaudimas 
handspring 		(sport.) persivertimas per galvą ore salto 
handsome 		gražus stuomeningas dailus 
handstand 		(sport.) stovėsena/atsistojimas ant plaštakų 
handwriting 		rašysena 
hap 		įvykis 
hapless 		nelaimingas nelemtas 
happen 		įvykti atsitikti pasitaikyti nutikti 
happening 		įvykis atsitikimas 
happiness 		laimė 
happy 		laimingas 
harbour 		uostas 
hard 		kietas tvirtas 
harden 		kietėti kietinti 
hardening 		užgrūdinimas 
hardily 		drąsiai 
hardly 		vos sunkiai 
hardware 		metalo dirbiniai (smulkieji) 
hardy 		stiprus patvarus atsparus 
haven 		uostas 
harm 		žala (pa)kenkimas sužalojimas skriauda 
harmful 		žalingas kenksmingas 
harmless 		nežalingas nekenksmingas 
harsh 		šiurkštus grubus 
harvest 		pjūtis derlius 
hat 		skrybėlė 
hate 		neapykanta 
hatred 		neapykanta 
hawk 		vanagas 
hay 		šienas 
hazard 		azartinis lošimas 
head 		galva viršūnė (medžio) viršus (puslapio) 
heal 		(iš)gydyti 
healing 		gydymas (už)gijimas 
health 		sveikata 
healthful 		gydomasis gydantis 
healthy 		sveikas sveikatingas 
heap 		krūva 
hear 		girdėti 
heard 		pt ir pp iš hear 
hearing 		girdėjimas girdimumas 
hearing-aid 		klausomasis aparatas 
heart 		širdis 
Hebrew 		žydas hebrajų hebrajų kalba 
heave 		(pa)kilimas 
heaven 		dangus 
heavily 		sunkiai 
heavy 		sunkus 
hedgehog 		ežys 
heel 		kulnis kulnas 
height 		aukštis ūgis 
hell 		pragaras 
helmet 		šalmas 
hello! 		sveikas! 
help 		padėti pagelbėti 
helper 		padėjėjas pagalbininkas 
Helsinki 		Helsinkis 
hen 		višta 
hen-coop 		vištų narvelis, vištidė 
her 		jos jai ją 
here 		čia šiuo momentu 
herb 		žolė augalas 
hero 		didvyris herojus 
heroin 		heroinas 
heroine 		didvyrė 
heron 		garnys 
herpes 		dedervinė 
herring 		silkė 
herself 		pati save 
hesitance 		svyravimas neryžtingumas 
hesitancy 		svyravimas neryžtingumas 
hesitant 		svyruojantis neryžtingas 
hesitate 		svyruoti dvejoti nesiryžti 
hesitatingly 		neryžtingai 
hesitation 		svyravimas dvejojimas neryžtingumas 
hesitative 		svyruojantis dvejojantis 
hexagon 		šešiakampis 
hiccup 		žagsėti 
high 		aukštas 
higher 		aukštesnis 
high and mighty 		išdidus 
high-capacity 		pajėgus 
high-grade 		aukštos rūšies 
high-handed 		savavalis savavališkas 
high-minded 		principingas didžiadvasis išdidus 
high-principled 		aukštos moralės idėjinis 
highroad 		plentas vieškelis magistralė prospektas 
highway 		plentas vieškelis magistralė autostrada 
him 		jam jį 
himself 		save pats save -si- (sangrąžos dalelytė) 
hind 		stirna briedžio patelė 
hinder 		trukdyti kliudyti neleisti sukliudyti sutrukdyti kliūti 
hill 		kalva įkalnis 
hilliness 		kalvotumas 
hillock 		kalvutė 
hillside 		kalnelio/kalvos šlaitas, įkalnė 
hilltop 		kalnelio/kalvos viršūnė 
hilly 		kalvotas 
hippo 		hipopotamas 
hippopotamus 		hipopotamas 
hire 		samdyti 
hired 		samdomas(is) (pa)samdytas 
hireling 		(niek.) parsidavėlis samdinys 
history 		istorija 
hit 		smūgis 
hit against 		susitrenkti 
hit it off with 		gerai sugyventi 
hitch 		staigus truktelėjimas 
hitched 		(šnek.) vedęs ištekėjusi 
hive 		avilys 
hoary 		žilas labai senas 
hog 		šernas meitėlis 
hold 		laikyti(s) išlaikyti 
hold back 		abejoti su(si)laikyti 
hold down 		priversti laikyti priespaudoje 
hold off 		atidėlioti 
hold over 		atidėlioti atidėti 
hold to 		laikytis (nuomones) 
hold together 		su(si)vienyti susijungti 
hold up 		palaikyti sulaikyti 
holding 		valdymas turėjimas nuosavybėje 
holiday 		šventė nedarbo diena 
hole 		skylė 
Holland 		Olandija 
home 		namas namai 
homeland 		gimtinė 
honest 		doras sąžiningas 
honestly 		dorai sąžiningai 
honesty 		dorumas sąžiningumas 
honey 		medus 
honeybee 		bitė 
honeymoon 		medaus mėnuo 
hooker 		žvejų laivas 
hoot 		šauksmas, šūkavimas, rėkavimas 
hooter 		sirena 
hooters 		papai (vulg.) 
hope 		viltis lūkestis tikėjimasis 
hopeful 		pilnas vilčių daug žadantis teikiantis vilčių 
hopefulness 		optimizmas viltys viltingumas 
hopeless 		beviltiškas netekęs vilties 
hopelessness 		beviltiškumas 
horizon 		horizontas akiratis 
horizontal 		(spec.) horizontalė (tiesė) 
horrible 		baisus bjaurus 
horn 		ragas ragelis 
hornet 		širšė 
horse 		arklys žirgas 
horticulture 		sodininkystė 
hospital 		ligoninė 
hospitality 		svetingumas vaišingumas 
host 		šeimininkas 
hostage 		įkaitas 
hostel 		bendrabutis turistų stovykla viešbutis smuklė 
hostile 		priešas 
hostility 		priešiškumas karo veiksmai 
hostess 		šeimininkė savininkė administratorė 
hot 		karštas 
hotel 		viešbutis 
how 		kaip kokiu būdu 
how many 		kiek? 
how much 		kiek? 
however 		vis dėlto tačiau betgi 
hour 		valanda 
hourly 		kasvalandinis valandinis nuolatinis 
house 		namas 
howl 		staugimas, kaukimas 
howler 		raudotojas (garbstant mirusijį) 
howling 		staugimas, kaukimas 
hub 		(rato) stebulė 
hug 		(stipriai) apkabinti suspausti glėbyje 
huge 		milžiniškas 
hundred 		šimtas šimtinė 
Hungary 		Vengrija 
hunger 		badas alkis troškimas išalkimas 
hunger-strike 		bado streikas 
hungrily 		kaip išbadėjęs godžiai trokštamai 
hungry 		alkanas badaująs išalkęs trokštantis ištroškęs 
hurt 		sukelti skausmą padaryti žalos 
hurtful 		žalingas 
husband 		vyras sutuoktinis 
husbandman 		žemdirbys 
husbandry 		žemės ūkis žemdirbystė 
hyaena 		hiena 
hyena 		hiena 
hydrophobia 		pasiutligė vandens baimė 
ice 		ledas ledai (valgomieji) 
icecream 		grietininiai ledai 
icon 		ikona 
ignitable 		degus, užsidegantis 
ignite 		už(si)degti 
igniter 		uždegiklis 
ignition 		už(si)degimas 
ignore 		ignoruoti nepaisyti neatsižvelgti atmesti niekinti 
island 		sala 
issue 		(iš)leidimas leidinys 
Iceland 		Islandija 
idea 		mintis idėja sąvoka 
ideal 		idealus nerealus 
identic 		tas pat toks pat 
identical 		tas pat toks pat 
identifiable 		atpažįstamas 
identification 		identifikacija sutapatinimas atpažinimas tapatybės nustatymas 
identify 		(su)tapatinti identifikuoti nustatyti tapatybę pripažinti tuo pačiu 
identity 		tapatingumas tapatumas identiškumas 
idiom 		idiomatinis posakis idioma 
idiot 		idiotas 
idiotic 		idiotiškas 
ill 		sergąs nesveikas 
illiterate 		neraštingas neapsišvietęs 
image 		atvaizdas paveikslas 
imitable 		imituojamas (pa)mėgdžiojamas 
imitate 		(pa)mėgdžioti imituoti sekti, 
imitation 		(pa)mėgdžiojimas imitavimas sekimas 
imitative 		(pa)mėgdžiojamas neoriginalus 
imitator 		(pa)mėgdžiotojas imitatorius 
immature 		nesubrendęs nepribrendęs nepakankamai išsivystęs 
immediately 		betarpiškai tiesiog 
immense 		didžiulis neaprėpiamas neišmatuojamas 
immigrant 		imigrantas ateivis persikėlėlis 
immigrate 		imigruoti 
immigration 		imigracija imigravimas 
impact 		smūgis susidūrimas (on, against) 
imperil 		statyti į pavojų 
impetus 		smarkumas (judėjimo) jėga 
important 		svarbus reikšmingas 
impose 		uždėti (mokestį, pareigas) primesti apmokestinti 
impossibility 		negalimumas negalėjimas 
impossible 		negalimas neįvykdomas neįmanomas nepakenčiamas 
impress 		spaudas atspaudas 
impression 		įspūdis 
improvable 		pataisomas galimas gerinti 
improve 		(pa)gerinti (pa)tobulinti (on) gerėti tobulėti 
improved 		pagerintas geresnis 
improvement 		pagerinimas pa(si)tobulinimas pagerėjimas 
inactive 		neveiklus 
incantation 		užkeikimas užkalbėjimas 
inch 		colis 
include 		turėti apimti įtraukti įskaityti 
included 		įskaitant 
including 		įskirtinai 
inconvenient 		nepatogus 
incorrect 		neteisingas netikslus netinkamas nekorektiškas netikras 
incorrectly 		neteisingai 
incorrectness 		neteisingumas netikrumas 
incredibility 		neįtikimumas 
incredible 		neįtikimas 
India 		Indija 
indeed 		iš tikrųjų tikrai išties 
indeed? 		nejaugi? 
individual 		asmeniškas individualus 
Indonesia 		Indonezija 
inevitable 		neišvengiamas 
inexpensive 		nebrangus 
infant 		kūdikis 
infernal 		pragaro 
inferno 		pragaras 
infidel 		netikintysis, bedievis 
infidelity 		neištikimybė 
infinite 		besaikis bekraštis beribis neribotas nesuskaičiuojamas begalinis 
infinitely 		neišmatuojamai 
infinitesimal 		be galo mažas 
infinitive 		bendraties 
infinity 		begalybė be galo didelis skaičius beribė daugybė 
infirmary 		ligoninė 
inflow 		įtekėjimas pritekėjimas 
influenza 		gripas 
influence 		įtaka poveikis (on, upon, over – kam) 
influent 		intakas 
influential 		įtakingas 
infringement 		(susitarimo ir pan.) sulaužymas (įstatymo) pažeidimas 
injure 		sužeisti sužaloti 
injured 		sužeistas 
injurious 		žalingas kenksmingas kenkiantis (to) 
injury 		sužalojimas sužeidimas trauma 
innocuous 		nekenksmingas nežalingas nepavojingas 
inquire 		klausinėti teirautis (about) 
insane 		psichiškai nesveikas pamišęs 
inside 		vidinė pusė vidus 
inspiration 		įkvėpimas užsidegimas 
inspire 		įkvėpti uždegti 
inspired 		įkvėptas 
instant 		staigus 
instantly 		momentaliai tučtuojau 
instead 		vietoj (ko nors) užuot 
instruction 		(ap)mokymas instruktavimas nurodymas 
instructor 		instruktorius dėstytojas 
insurrection 		sukilimas 
intellect 		intelektas protas 
intellectual 		intelektinis intelektualinis intelektualus protinis mąstymo 
intelligence 		protas intelektas protiniai gabumai 
intelligencer 		informatorius 
intelligent 		protingas 
intelligentsia 		(the intelligentsia) inteligentija 
intelligibility 		suprantamumas 
intelligible 		suprantamas aiškus 
intense 		smarkus stiprus didelis 
intensification 		(su)stiprėjimas (su)intensyvėjimas 
intensify 		(su)stiprėti (su)intensyvėti 
intension 		įtempimas įtampa 
intensity 		intensyvumas įtampumas įtempimas jėga stiprumas 
intensive 		intensyvus įtemptas 
interest 		susidomėjimas domėjimasis suinteresuotumas 
interests 		suinteresuoti asmenys 
interested 		suinteresuotas susidomėjęs 
interesting 		įdomus 
interface 		sąsaja 
interfere 		(su)trukdyti įsikišti įsiterpti interferuoti 
interference 		interferencinis 
interflow 		susiliejimas 
interfuse 		sunktis prasisunkti 
interment 		laidojimas palaidojimas 
intestine 		vidaus, vidinis 
intimacy 		artimumas draugystė intymumas 
intimate 		artimas draugas 
intimation 		davimas suprasti užuomina (ko) ženklas 
intimity 		(psn.) intymumas 
intoxicate 		apsvaiginti apnuodyti 
intuit 		nujausti žinoti/suvokti intuityviai 
intuition 		intuicija 
intuitional 		intuityvus 
intuitive 		intuityvus 
invade 		įsiveržti užgrobti 
invader 		įsiveržėlis grobikas okupantas 
invalid 		negaliojantis neturintis juridinės galios 
invalidate 		(pa)daryti negaliojantį pripažinti negaliojančiu anuliuoti 
invalidity 		negaliojimas nepagrįstumas 
invaluable 		neįkainojamas neįvertinamas 
invariability 		nekintamumas 
invariable 		nekintamas nekeičiamas 
invariant 		nekintamas pastovus invariantinis 
invasion 		įsiveržimas įsibrovimas 
invasive 		invazinis grobikiškas 
invent 		išrasti 
invention 		išradimas 
inventive 		išradingas pramanus 
inventor 		išradėjas 
inventory 		(turto) aprašas inventorius 
invest 		įdėti (daug jėgų/laiko, in) 
investigate 		(iš)tirti (iš)tyrinėti 
investigation 		(iš)tyrimas tyrinėjimas nagrinėjimas 
investigative 		tiriamasis tyrimo 
investigator 		tyrėjas tyrinėtojas 
investigatory 		tiriamasis tyrimo 
investiture 		(titulo, įgaliojimų ir pan.) suteikimas investitūra 
investment 		(darbo, laiko ir pan.) įdėjimas 
investor 		investuotojas investitorius 
invoice 		važtaraštis faktūra 
involve 		įtraukti įpainioti įvelti 
involved 		susietas įpainiotas dalyvaujantis 
involvement 		įpainiojimas 
iodin 		jodas 
iodine 		jodas 
Iran 		Iranas 
Iraq 		Irakas 
Ireland 		Airija 
iron 		geležis 
iron-bound 		apkaltas geležimi sukaustytas 
iron-foundry 		ketaus liejykla 
ironic 		ironiškas 
ironical 		ironiškas 
ironware 		geležies dirbiniai/prekės 
ironwork 		geležies dirbiniai 
irrelevant 		neliečiantis reikalo esantis ne vietoje neturintis ryšio 
Israel 		Izraelis 
Israelite 		Izraelio žydų 
Italian 		italas italų italų kalba 
Italy 		Italija 
itself 		pats pats save save patį sau pačiam 
ivory 		dramblio kaulas dramblio kaulo spalva 
jam 		suspausti 
Jamaica 		Jamaika 
January 		sausis 
Japan 		Japonija 
Japanese 		japonas japonai japonų japonų kalba 
jape 		juokas pokštas 
jealousy 		pavyduliavimas 
jeopardy 		pavojus rizika 
jest 		juokas pašaipa pajuokos objektas 
jester 		juokdarys išdaigininkas pajacas 
Jew 		žydas 
jewel 		brangenybė brangakmenis 
jeweller 		juvelyras 
jewellery 		brangenybės 
jewelry 		brangenybės 
Jewess 		žydė 
Jewish 		žydė 
job 		darbas tarnyba užduotis užsiėmimas 
jinn 		(mit.) džinas 
jinnee 		(mit.) džinas 
jobber 		makleris didmenininkas 
jobbery 		piktnaudžiavimas tarnybine padėtimi spekuliacija 
jobbing 		atsitiktinis nereguliarus 
jobless 		bedarbis neturintis darbo 
join 		sujungimas sujungimo vieta sujungimo taškas/linija 
joiner 		stalius 
joint 		sujungimo vieta sandūra 
jointly 		kartu drauge išvien 
joke 		juokas juokų objektas sąmojis pokštas anekdotas 
joker 		juokdarys pokštininkas išdaigininkas komikas 
Jordan 		žydų žydiškas 
journal 		žurnalas laikraštis 
journey 		kelionė išvyka pasivažinėjimas 
joy 		džiaugsmas pasitenkinimas malonumas džiugesys 
July 		liepa (mėnuo) 
June 		birželis 
judge 		teisėjas (t.p. sport.) (sport.) teisėjų kolegija 
judgement 		nuosprendis (teismo) sprendimas nutartis 
judgemental 		greitas kritikuoti 
judgematic 		(šnek.) protingai galvojantis protingas 
judgematical 		(šnek.) protingai galvojantis protingas 
judgment 		nuosprendis (teismo) sprendimas nutartis 
judgmental 		greitas kritikuoti 
judgmatic 		(šnek.) protingai galvojantis protingas 
judgmatical 		(šnek.) protingai galvojantis protingas 
jump 		šuolis 
jumper 		šuolininkas 
jumpy 		paniškas nervinąs 
just 		teisingas 
keen 		labai ko norintis entuziastingas 
keep 		(iš)laikyti saugoti 
kept 		pt ir pp iš keep 
kerb 		šaligatvio kraštas bordiūras kelkraštis 
kernel 		grūdo vidus branduolys 
kettle 		virdulys metalinis arbatinukas 
key 		raktas klavišas gruntas 
keyboard 		klaviatūra komutatorius 
kid 		ožiukas 
kiddy 		kūdikis vaikiukas 
kidney 		inkstas 
kill 		užmušti nužudyti 
killer 		žudikas 
kilometer 		(amer.) kilometras 
kilo 		kilogramas 
kilometre 		kilometras 
kind 		giminė 
king 		karalius 
kingdom 		karalystė 
kiss 		bučinys pa(si)bučiavimas 
kitchen 		virtuvė 
kite 		(popierinis) aitvaras 
kitten 		kačiukas 
knife 		peilis 
knock 		belsti mušti trenkti suduoti trankytis pabarbenti 
knot 		mazgas 
knotty 		mazguotas 
know 		(su)žinoti pažinti 
knowable 		pažįstamas pažinus 
know-how 		praktinis patyrimas patirtis mokėjimas 
know-all 		visažinis 
knowall 		visažinis 
knowing 		mokąs žinąs nusimanąs 
knowingly 		sąmoningai sumaniai 
knowledge 		žinios mokėjimas išmanymas pažinimas 
known 		žinomas garsus 
koala 		(zool.) koala 
Korea 		Korėja 
kudos 		(šnek.) šlovė pagarba 
Kuwait 		Kuveitas 
lacquer 		lakas politūra 
lad 		vaikinas 
laddie 		berniūkštis 
lady 		ponia dama 
lake 		ežeras 
lame 		raišas luošas 
lament 		skundas verksmas 
lamentable 		liūdnas apgailėtinas verksmingas 
lamp 		lempa 
land 		sausuma žemė 
landscape 		peizažas landšaftas 
lane 		keliukas takas 
language 		kalba 
lantern 		žibintas 
large 		didelis erdvus 
lark 		vieversys vyturys 
larky 		linksmas mėgstąs pokštus 
larva 		vikšras lerva 
laser 		lazeris 
lass 		mergaitė 
lassie 		mergaitė mergelė 
last 		paskutinis ankstesnis praėjęs 
late 		vėlus vėlyvas pavėlavęs 
late of 		pastaruoju metu pastaruoju laiku 
lately 		pastaruoju metu neseniai 
latent 		paslėptas latentinis 
later 		vėlesnis paskesnis 
later on 		vėliau po to paskiau paskui 
latest 		vėliausias 
Latin 		lotynų lotynų kalba 
latitude 		(geogr.) platuma 
laugh 		juokas kvatojimas pasijuokimas 
laugh off 		juokais priimti kritiką 
laughable 		juokingas komiškas 
laughableness 		juokingumas 
laughing 		besijuokiantis besišypsantis 
laughing-stock 		pajuokos objektas 
laughingly 		juokais 
laughter 		juokas kvatojimas 
lava 		lava 
law 		įstatymas 
lawful 		įstatyminis teisėtas 
lawless 		neteisėtas nusikalstamas 
lawsuit 		procesas byla ieškinys 
lawyer 		advokatas teisininkas 
laziness 		tinginystė tingumas 
lazy 		tingus 
lead 		vesti 
leaden 		švininis 
leader 		vadas vadovas 
leadership 		vadovavimas 
leading 		vadovaujantis pirmaujantis 
left 		kairys kairinis kairysis 
league 		sąjunga lyga 
learn 		mokytis sužinoti pamokyti 
learn by heart 		išmokti atmintinai iškalti 
learned 		mokytas mokslinis 
learner 		mokinys 
learning 		pažinimas žinojimas mokytumas 
leather 		(išdirbta) oda 
leave 		iškeliauti išeiti 
leg 		koja (nuo kelio iki pėdos, arba stalo ir pan.) 
legacy 		palikimas paveldas įpėdinystė 
legal 		įstatyminis teisėtas legalus 
legal adviser 		juriskonsultas 
legalise 		legalizuoti 
legality 		teisėtumas 
legalization 		įteisinimas 
legalize 		legalizuoti 
legend 		legenda padavimas sakmė 
legion 		legionas 
legionary 		legionierius legiono kareivis 
legionnaire 		legionierius legiono kareivis 
legitimacy 		teisėtumas 
legitimate 		įstatyminis paremtas įstatymais teisėtas 
legitimation 		įteisinimas 
legitimatize 		įteisinti 
legitimize 		įteisinti 
lemon 		citrina 
lemonade 		limonadas 
leopard 		leopardas 
leopardess 		leopardo patelė 
less 		mažesnis 
lessen 		(su)mažinti (su)mažėti 
lesser 		mažesnis mažesnysis mažasis 
lesson 		pamoka 
letter 		raidė 
level 		lygis 
lever 		svertas svirtis dalba buomas 
leverage 		keliančioji jėga sverto veikimas svertų sistema 
lexicon 		žodynas 
liability 		atsakomybė 
liable 		atsakingas (for) įpareigotas, privaląs (to) 
liberty 		laisvė 
Libya 		Libija 
lichen 		kerpės 
lick 		lyžtelėti laižyti (t.p. prk. apie liepsnas, bangas) aplaižyti 
licking 		(ap)laižymas 
lie 		melas apgavystė 
life 		gyvenimas 
lift 		liftas keltuvas pakėlimas 
light 		šviesa apšvietimas 
lighter 		žiebtuvėlis 
lighting 		apšvietimas 
lightning 		žaibas 
like 		panašus 
likelihood 		tikėtinumas galimumas 
likes 		polinkiai potraukiai 
likely 		galimas tinkamas 
likewise 		panašiai taip pat 
lilac 		alyva 
limit 		riba limitas 
limitary 		ribinis 
limitation 		apribojimas išlyga 
limitative 		apribojantis 
limited 		ribotas limitinis 
limiter 		(tech.) ribotuvas 
limiting 		apribojantis varžantis trukdantis 
linden-tree 		liepa 
line 		linija 
liner 		keleivinis laivas lėktuvas 
linger 		užtrukti užsibūti (už)gaišti uždelsti 
lingering 		lėtas gaišlus 
linguist 		kalbininkas lingvistas 
linguistic 		kalbinis kalbiškas 
linguistics 		kalbotyra lingvistika 
lion 		liūtas 
lioness 		liūtė 
lip 		lūpa 
liqueur 		likeris 
liquid 		skystis 
liquidate 		likviduoti pabaigti 
liquidation 		likvidacija 
liquidator 		likvidatorius 
Lisbon 		Lisabona 
list 		sąrašas registras žiniaraštis 
listen 		klausyti(s) (to) 
listening 		klausymas klausymasis išklausymas 
liter 		(amer.) litras 
literacy 		raštingumas 
literal 		pažodinis 
literally 		pažodžiui neperdedant 
literary 		literatūros rašytojų literatūrinis 
literate 		raštingas, mokantis (ką daryti) 
literature 		literatūra 
Lithuania 		Lietuva 
Lithuanian 		lietuviškas lietuvių lietuvis Lietuvos 
litre 		litras 
little 		mažas menkas nežymus 
live 		gyventi gyvuoti egzistuoti 
live high 		plačiai gyventi 
live in want 		badmiriauti 
live on 		gyventi kuo 
live out 		pergyventi 
live through 		pergyventi 
live up to 		gyventi pagal ką 
liveable 		pakenčiamas tinkamas gyventi sugyvenamas 
livelihood 		pragyvenimo priemonės gyvenimo šaltinis 
liveliness 		gyvumas judrumas linksmumas žvalumas 
lively 		gyvas stiprus gyvybingas linksmas smagus 
liver 		(anat.) kepenys 
Liverpool 		Liverpulis 
lizard 		driežas 
load 		krovinys krūvis 
loaf 		dykinėjimas 
loath 		nelinkęs nenorintis 
loathe 		jausti pasibjaurėjimą bjaurėtis pasibjaurėti 
loathing 		pasibjaurėjimas pasišlykštėjimas 
loathsome 		atstumiantis bjaurus šlykštus pasibjaurėtinas 
lobster 		(zool.) omaras 
local 		vietinis lokalinis 
location 		padėtis 
loch 		ežeras 
lofty 		išpuikęs 
logic 		logika 
logical 		logiškas 
London 		Londonas 
long 		ilgas tolimas 
long-ago 		tolima praeitis seni laikai 
long-awaited 		ilgai lauktas 
long-dated 		ilgalaikis 
long-lasting 		ilgai trunkantis ilgalaikis 
longest 		ilgiausias ilgiausiai 
longing 		didelis noras troškimas geismas ilgėjimasis ilgesys (for) 
longish 		ilgokas 
longspun 		ištęstas nuobodus 
longstanding 		senas užsitęsęs (apie ginčą, ryšius ir pan.) 
longitude 		(geogr.) ilguma 
longwearing 		(amer.) ilgai dėvimas nenudėvimas 
look 		žiūrėti pažvelgti (at) siekti akimis (perk.) sekti 
look-in 		šansas 
look-out 		budrumas 
loser 		pralaimėtojas prasilošėlis 
loss 		netekimas praradimas pametimas netektis pralošimas 
lost 		prarastas dingęs paklydęs pamestas pražuvęs 
lot 		burtas burtai 
lot of 		daugybė daug 
lots 		marios daug 
lots of 		baisybė daugybė 
loth 		nelinkęs nenorintis 
lotion 		losjonas kosmetinis vanduo 
lotos 		lotosas 
lottery 		loterija 
lotus 		lotosas 
loud 		garsus skardus rėksmingas triukšmingas 
loudhailer 		megafonas 
loudly 		garsiai triukšmingai 
loudmouth 		rėksnys 
loudmouthed 		rėksmingas 
loudspeaker 		garsiakalbis reproduktorius 
lounge 		bastytis slankioti 
lounger 		dykinėtojas 
lounge about 		daužytis draikytis 
love 		meile įsimylėjimas 
lovely 		gražus puikus žavingas 
lover 		įsimylėjėlis mylimasis meilužis mėgėjas mylėtojas šalininkas 
low 		žemas 
lubricate 		tepti (mašinas) 
lubricant 		tepalas alyva 
luck 		likimas 
luck out 		(amer.) pavykti pasisekti 
luckily 		laimingai 
lucky 		laimingas pasisekęs 
lucre 		pelnas nauda 
luggage 		bagažas 
Luxemburg 		Liuksemburgas 
library 		biblioteka 
lock 		spyna užraktas 
lock in 		užrakinti uždaryti 
lock out 		paskelbti lokautą 
lock up 		užsklęsti užrakinti uždaryti į daboklę 
lock-gate 		šliuzo vartai 
locks 		garbanos plaukai 
locked 		užrakintas 
locker 		užrakinama spintelė stalčius 
locket 		medalionas 
lockout 		lokautas 
locksmith 		šaltkalvis 
lockup 		darbo baigimo laikas 
lung 		plautis 
lunge 		staigus kūno pasvirimas į priekį 
luxury 		prabanga prašmatnumas 
machine 		mašina separatorius 
machine-gun 		kulkosvaidis 
machine-tool 		staklės 
machinery 		mechanizmas 
mad 		beprotis pakvaišęs 
Madagascar 		Madagaskaras 
madness 		beprotybė įniršimas 
Madrid 		Madridas 
magazine 		žurnalas (periodinis) 
magnet 		magnetas 
mail 		paštas 
main 		svarbiausias pagrindinis vyriausias 
maintain 		palaikyti prižiūrėti (pa)remti 
majority 		dauguma 
major 		didesnis svarbesnis vyresnis 
make 		daryti gaminti dirbti 
make much of 		aukštai vertinti 
making 		(pa)gaminimas gamyba darymas dirbimas sukūrimas 
making up 		dažymas 
makings 		galimybės 
Malaysia 		Malaizija 
male 		vyras patinas 
malicious 		piktas pagiežingas 
Malta 		Malta 
mam 		mama 
mammy 		(amer.) mama 
man 		žmogus 
manage 		vadovauto vesti 
management 		vadovavimas 
manager 		menedžeris 
Manchester 		Mančesteris 
manner 		elgimasis manieros 
manual 		rankinis rankų 
many 		daug daugelis 
map 		žemėlapis planas 
margin 		kraštas 
marginal 		kraštinis ribinis 
marijuana 		marihuana 
mark 		markė žymė ženklas dėmė požymis atžyma įspaudas 
mark you! 		atsiminkite! 
marked 		pažymėtas paženklintas pastebimas ženklus 
markedly 		smarkiai žymiai ryškiai 
market 		rinka turgus 
marketing 		prekyba prekiavimas marketingas 
marketing place 		prekyvietė turgavietė 
marriage 		vedybos santuoka 
married 		vedęs ištekėjusi susituokęs 
marry 		vesti ištekėti 
marsh 		pelkė liūnas 
marshland 		pelkynas balynas 
mascot 		talismanas 
masculine 		vyriškas 
mask 		kaukė dujokaukė 
masked 		užmaskuotas, kaukėtas, su kauke 
mass 		masė 
mast 		(laivo) stiebas 
master 		šeimininkas 
mastery 		meistriškumas (dalyko) puikus mokėjimas 
material 		medžiaga duomenys 
materialism 		materializmas 
materialist 		materialistas 
materialistic 		materialistinis 
materialize 		įvykdyti įgyvendinti įkūnyti materializuotis 
matter 		medžiaga materija 
mature 		subrendęs prinokęs 
maturate 		bręsti 
maturation 		brendimas subrendimas 
maturity 		subrendimas branda brandumas 
May 		gegužis 
maybe 		galbūt gal gali būti 
mayor 		meras miesto galva 
March 		kovas (mėnuo) 
Mars 		Marsas 
mea culpa 		(lot.) mano kaltė dėl mano kaltės 
meal 		miltai 
mealy 		miltų miltinis 
mean 		prastas žemas 
meaning 		reikšmė prasmė 
meantime 		tuo tarpu tuo pat metu 
meanwhile 		
meaningful 		reikšmingas reikšminis 
meaningless 		beprasmis bereikšmis beprasmiškas nereikšmingas 
means 		priemonė būdas 
meat 		mėsa 
media 		(komp.) laikmena 
medial 		vidurinis vidurio 
mediocre 		pusėtinas vidutiniškas 
medium 		vidurys vidurkis 
meet 		su(si)tikti 
meeting 		mitingas susirinkimas susitikimas 
melon 		(bot.) melionas arbūzas 
memory 		atmintis 
memorize 		išmokti atmintinai atsiminti įsiminti įsidėmėti 
men 		vyrai 
mend 		(pa)(si)taisyti remontuoti 
menses 		mėnesinės menstruacija 
menstruation 		mėnesinės menstruacija 
menu 		meniu valgiaraštis 
merchandise 		prekės prekiavimas 
Mercury 		Merkurijus 
mercury 		gyvsidabris gyvsidabrio stulpelis gyvsidabrio preparatas 
mere 		grynas paprasčiausias tik vien tik 
merely 		tiesiog tik paprasčiausiai 
merit 		nuopelnas 
meritorious 		nusipelnęs (atpildo, pagyrimo) vertas pagyrimo pagirtinas 
merry 		linksmas džiugus 
mess 		bendras stalas bendras maitinimasis valgykla (kariuomenėje, laivyne 
mess about 		kvailioti kuistis terliotis čiupinėtis 
mess up 		pakrikdyti sujaukti sumaišyti (su)gadinti (reikalą ir pan.) 
mess-hall 		valgykla 
mess-room 		(jūr.) kajutkompanija 
mess-up 		(šnek.) jaukalas jovalynė netvarka 
message 		žinutė pranešimas laiškas telegrama 
messages 		pirkiniai 
messenger 		pasiuntinys pranešėjas kurjeris 
messenger-pigeon 		pašto karvelis 
messmate 		stalo bendras/draugas 
messhall 		(amer.) (bendra) valgykla 
messy 		nešvarus purvinas 
meteoric 		meteorinis 
meteorite 		meteoritas 
meter 		metras 
metre 		metras 
metropolis 		metropolija 
microbe 		mikrobas 
microphone 		mikrofonas 
microscope 		mikroskopas 
middle 		vidurinis 
midwife 		akušerė pribuvėja 
mike 		mikrofonas 
mile 		mylia 
military 		karinis kariuomenės 
milk 		pienas 
millimetre 		milimetras 
million 		milijonas 
mind 		protas mintis 
mind! 		žiūrėk! atsargiai! 
mind out! 		saugokis! 
minded 		linkęs nusiteikęs (ką nors daryti) 
mindful 		rūpestingas atidus 
mindless 		beprasmis kvailas lėkštas 
mine 		kasykla rūdynas šachta telkinys klodas 
mine-thrower 		minosvaidis 
miner 		kalnakasys šachtininkas angliakasys 
mineral 		mineralinis 
minor 		mažesnis 
minute 		minutė momentas 
minute down 		užsirašyti 
minutes 		protokolas 
minutely 		(kas)minutinis 
minuteness 		smulkumas mažumas detalumas kruopštumas 
Minsk 		Minskas 
miry 		klampus purvinas 
mirror 		veidrodis 
miser 		šykštuolis 
misdemeanor 		(teis.) baudžiamasis nusižengimas 
misdemeanour 		(teis.) baudžiamasis nusižengimas 
miserable 		pasigailėtinas nelaimingas skurdus menkas 
mission 		(prekybos, karinė) misija, delegacija 
mist 		migla rūkas ūkana 
mistake 		klaida suklydimas 
mistaken 		klaidingas ne vietoje 
mistress 		šeimininkė savininkė 
mobile 		judrus paslankus mobilus kilnojamas 
mobility 		judrumas paslankumas manevringumas 
mobilization 		mobilizacija 
mobilize 		mobilizuoti 
mode 		mada 
model 		modelis 
modifiable 		pakeičiamas modifikuojamas 
modification 		(nedidelis) pa(si)keitimas modifikacija 
modify 		modifikuoti (nežymiai) pakeisti 
moist 		drėgnas šlapias 
moisture 		drėgmė 
Moldavia 		Moldavija 
mole 		apgamas 
molecule 		molekulė 
moll 		(sl.)  kekšė 
mollification 		sušvelninimas, nuraminimas 
mollify 		(su)švelninti, (su)minkštinti, (nu)raminti 
mollusc 		(zool.) moliuskas 
mollusk 		(zool. amer.) moliuskas 
molly 		(šnek.) lepūnėlis, išlepėlis, ištižėlis 
mom 		(amer.) mama 
moment 		momentas akimirksnis 
Monaco 		Monakas 
monarchy 		monarchija 
monastery 		vyrų vienuolynas 
Monday 		pirmadienis 
Mongolia 		Mongolija 
money 		pinigai 
monk 		vienuolis 
monkey 		beždžionė 
monopoly 		monopolija monopolis 
month 		mėnuo 
monthly 		mėnesinis kas mėnesį 
mood 		nuotaika 
moody 		nepastovios nuotaikos 
moon 		mėnulis 
moose 		amerikinis briedis 
more 		daugiau 
morn 		(poet.) rytas 
morning 		rytas 
Morocco 		Marokas 
mosque 		mečetė 
most 		daugiausia dauguma didžioji dalis 
mostly 		daugiausia dažniausiai paprastai 
mental 		protinis 
mentality 		intelektas 
mentally 		mintyse 
mention 		(pa)minėti užsiminti suminėti remtis 
most likely 		tikriausiai veikiausiai 
mote 		dulkė krislelis 
motion 		judėjimas 
motivate 		skatinti būti priežastimi 
motivation 		motyvacija 
mother 		motina 
motherland 		gimtinė 
Moscow 		Maskva 
mount 		kalnas kalva 
move 		judėti judinti 
movement 		judėjimas judesys 
movies 		(šnek.) kinas (filmas) 
mountain 		kalnas 
mouse 		pelė 
mouth 		burna 
movie 		kinas (filmas) kino teatras 
mow 		pjauti (žolę, javus) šienauti 
Mozambique 		Mozambikas 
much 		daug daug kas daugelis 
mud 		purvas dumblas 
muddle 		(smth up) sumaišyti sujaukti 
muddle along 		veltui gaišti veltui eikvoti laiką 
muddle through 		žūt būt užbaigti 
muddy 		purvinas drumzlinas tamsus 
mug 		puodukas 
muscle 		raumuo 
museum 		muziejus 
music 		muzika 
mushroom 		grybas 
must 		turiu privalau turi privalai reikia 
mutiny 		maištas sukilimas 
mutton 		aviena 
mutual 		abipusiškas savitarpinis 
muzzle 		snukis antsnukis 
my 		mano savo maniškis 
myself 		save pats sau savęs 
mythology 		mitologija mitai mitų rinkinys 
naked 		nuogas plikas 
name 		vardas 
narrative 		pasakojimas 
narrow 		siauras ankštas ribotas 
nasty 		bjaurus šlykštus koktus 
national 		nacionalinis tautinis valstybinis 
native 		gimtasis gimtinės įgimtas 
navigate 		plaukioti (laivu) skraidyti (lėktuvu) valdyti (laivą, lėktuvą) 
navigation 		navigacija plaukiojimas laivininkystė 
navigator 		šturmanas 
near 		arti šalia 
nearby 		artimas kaimyninis 
nearly 		arti 
nearsight 		trumparegystė 
nebulous 		neaiškus miglotas 
necessary 		būtinas reikalingas reikiamas neišvengiamas 
neck 		kaklas sprandas 
neckband 		(baltinių, palaidinukės) apykaklė 
necking 		(amer. šnek.) bučiavimasis ir glamonės 
necklace 		(perlų, karolių ir pan.) vėrinys karoliai antkaklis 
neckline 		iškirpimo linija (gili) iškirptė 
neigh 		žvengimas 
neighbor 		(amer.) kaimynas artimas kaimynė 
neighbour 		kaimynas artimas kaimynė 
neighborhood 		(amer.) kaimynystė artumas 
neighbourhood 		kaimynystė artumas 
neighbourly 		kaimyniškas draugiškas 
neon 		neonas 
nephew 		sūnėnas brolvaikis 
nerve 		(anat.) nervas 
nerve-cell 		(anat.) nervinė ląstelė 
nerve-centre 		(fiziol.) nervinis mazgas 
nerved 		stiprus įsidrąsinęs 
nerveless 		silpnas bejėgis suglebęs 
nervous 		nervų nervinis 
nervy 		(šnek.) nervingas susinervinęs baikštus dirglus 
nest 		lizdas gūžta 
net 		tinklas spąstai 
network 		tinklas (sistema) 
neurogenic 		neurogeninis nervinės kilmės 
neurological 		neurologinis neurologijos 
neurologist 		neurologas 
neurology 		neurologija 
neuropathologist 		neuropatologas 
neuropsychiatry 		neuropsichiatrija 
neurosis 		neurozė 
neurosurgery 		neurochirurgija 
neurotic 		nervinis neurozinis 
never 		niekada niekuomet 
never again 		niekada daugiau 
never ever 		niekada niekada 
never more 		niekada daugiau 
never once 		nė karto 
nevertheless 		nepaisant to vis dėlto 
new 		naujas 
news 		naujiena naujienos žinia žinios 
next 		kitas sekantis būsimas 
nice 		geras malonus dailus puikus 
Nice 		Nica 
nick 		įkarpa įranta įraiža įpjova 
nickel 		nikelis 
nickname 		pravardė 
nicotine 		nikotinas 
nifty 		(šnek.) gudrus sumanus rezultatyvus 
night 		naktis vakaras 
nightingale 		lakštingala 
nine 		devyni devyneri 
nineteen 		devyniolika 
nineties 		dešimtas dešimtmetis 
ninetieth 		devyniasdešimtas 
ninety 		devyniasdešimt 
nip 		įgnybimas 
nipple 		spenys spenelis 
nitrogen 		azotas 
no 		ne 
nocuous 		kenksmingas 
node 		mazgas mazginis taškas susikirtimo taškas 
normal 		normalus 
north 		šiaurė 
northern 		šiaurės gyventojas 
northward 		šiaurės kryptis 
nose 		nosis uoslė 
not 		ne 
notation 		žymėjimas (ženklais, skaitmenimis, raidėmis) žymėjimo sistema 
note 		pastaba 
nothing 		niekas menkniekis 
notice 		(išankstinis) pranešimas įspėjimas 
noticeable 		pastebimas žymus 
noticeably 		pastebimai gerokai 
noun 		daiktavardis 
nourish 		maitinti 
nourishing 		maistingas 
novel 		romanas 
November 		lapkritis 
now 		dabar tuojau tuoj pat 
now and again 		tarpais kartais kartkarčiais 
now and then 		tarpais kartais retkarčiais 
now that 		kada dabar kai 
now then! 		na! greičiau! 
now! 		na na! 
nowaday 		dabartinis 
nowadays 		dabar mūsų laikais nūdien nūnai 
noway 		jokiu būdu jokiu atveju 
nowhere 		niekur 
number 		skaičius kiekis 
number off 		išsiskaičiuoti 
number plate 		automobilio numerio lentelė 
numberless 		nesuskaičiuojamas 
numerous 		gausus apstus skaitlingas 
nun 		vienuolė 
nurse 		auklė slaugytoja 
nutritious 		maistingas 
nuts 		pakvaišęs 
nylon 		nailonas 
oak 		ąžuolas 
oar 		irklas 
oasis 		oazė 
oath 		priesaika 
obedience 		paklusimas, (pa)klusnumas, nuolankumas 
obedient 		(pa)klusnus, nuolankus (to – kam) 
object 		daiktas dalykas 
object lens 		objektyvas 
object-glass 		objektyvas 
object-lesson 		akivaizdus įrodymas 
objection 		prieštaravimas protestas nepritarimas 
objectionable 		nepageidaujamas nemalonus 
objective 		objektyvus 
objectivity 		objektyvumas nešališkumas 
objectless 		betikslis beprasmiškas 
objector 		priešgyna 
obligate 		į(si)pareigoti 
obligation 		į(si)pareigojimas 
obligatory 		privalomas, būtinas, prievolinis, įpareigojantis 
oblige 		įpareigoti, priversti 
obliging 		paslaugus, mielas, malonus 
obligingly 		paslaugiai, mielai, mandagiai 
oboe 		obojus 
obstacle 		kliūtis 
obstacle-race 		(sport.) kliūtinis bėgimas, kliūtinės lenktynės 
obvious 		aiškus akivaizdus 
obviously 		akivaizdžiai aiškiai 
ocean 		vandenynas okeanas 
October 		spalis 
occurrence 		atsitikimas įvykis reiškinys 
odd 		nelyginis 
oddity 		keistumas keistuoliškumas 
oddly 		keistai stebėtinai 
odor 		kvapas aromatas 
odour 		kvapas aromatas 
oil 		aliejus alyva 
offence 		puolimas ataka 
offensive 		puolamasis 
often 		dažnai pakartotinai daug kartų tankiai 
often and often 		dažnokai 
oh 		o! 
oho 		oho! 
okay 		gerai viskas gerai 
old 		senas įsisenėjęs senovinis seniai buvęs praėjęs 
omnibus 		omnibusas autobusas 
once 		kartą kažkada kadaise 
once again 		dar kartą 
once and again 		kartais 
once and for all 		galutinai 
once for all 		kartą visiems laikams 
once more 		dar kartą 
one 		vienas pirmas vienintelis 
one after another 		po vieną vienas po kito 
one by one 		po vieną vienas po kito 
one or two 		nedaug vienas kitas 
one-armed 		vienarankis berankis 
one-color 		vienspalvis 
one-eyed 		vienaakis 
one-sided 		vienpusiškas vienašališkas ribotas šališkas vienašalis 
onefold 		paprastas nesudėtingas 
onerous 		reikalaujantis pastangų keblus sunkus 
one hundred 		vienas šimtas 
one more 		dar vienas 
one thousand 		vienas tūkstantis 
onion 		svogūnas 
only 		tiktai išimtinai 
open 		atdaras atviras 
opera 		opera 
opinion 		nuomonė pažiūra manymas 
opinionated 		per daug pasitikintis savimi 
oppose 		priešintis rodyti pasipriešinimą nepritarti būti nusistačiusiam prieš 
opposite 		priešingas visiškai skirtingas 
opposing 		priešiškas priešingas 
opposition 		(įv.reikšm.) opozicija 
oppositionist 		opozicionierius 
optimist 		optimistas 
optimistic 		optimistinis optimistiškas 
optimistical 		optimistinis optimistiškas 
or 		ar arba 
orb 		rutulys 
orbit 		orbita 
order 		tvarka eilė rikiuotė 
order about 		stumdyti 
order of the day 		dienotvarkė 
ordering 		iš(si)rašymas 
orderliness 		tvarkingumas tvarka tikslumas drausmė 
orderly 		tvarkingas drausmingas metodiškas organizuotas 
origin 		šaltinis ištaka pradžia 
original 		pradinis 
originality 		autentiškumas originalumas savitumas naujumas 
originally 		iš pradžių pradžioje 
other 		kitas kiti 
over 		(pažymi vietą) virš aukščiau per apie po 
overall 		darbinis chalatas/drabužis 
overcoat 		apsiaustas paltas milinė 
overhead 		viršuje aukštai viršutiniame aukšte 
o'clock 		(skaičius) valanda 
operate 		veikti (apie mechanizmą) 
operation 		operacija 
operator 		operatorius mechanikas 
our 		mūsų 
outcry 		sušukimas riksmas 
outlet 		išėjimas anga išleidimo vamzdis 
outline 		kontūras 
output 		produkcija išdirbis išeiga gavyba 
outside 		išorė išorinė pusė 
outside of 		išskyrus 
outsider 		pašalietis pašalinis 
owe 		būti skolingam 
owing 		skolingas 
owing to 		dėka dėl 
owl 		pelėda 
own 		savas nuosavas 
owner 		savininkas valdytojas 
ownership 		nuosavybės teisė 
ox 		jautis bulius 
oxbow 		jungas 
oxen 		galvijai 
oxford 		pusbatis 
oxidation 		oksidacija 
oxide 		oksidas 
oxygen 		deguonis 
page 		puslapis 
pail 		(medinis arba skardinis) kibiras kubilas 
pain 		skausmas kentėjimas 
paint 		dažai 
painter 		tapytojas 
painting 		paveikslas 
Pakistan 		Pakistanas 
palace 		rūmai rūmas puošnus namas 
Palestine 		Palestina 
pale 		(tvoros) statinis užtvara riba 
palm 		delnas 
panic 		panika 
pants 		(amer.) kelnės 
paper 		popierius 
par 		lygybė 
Paraguay 		Paragvajus 
pardon 		atleidimas dovanojimas 
parget 		tinkas 
Paris 		Paryžius 
parish 		parapija 
parity 		lygybė lygiavertiškumas 
park 		parkas 
parking 		automobilių (pa)statymas automobilių stovėjimo vieta (t.p. parking place) 
parole 		slaptažodis 
parson 		pastorius dvasininkas 
part 		dalis 
partial 		dalinis nepilnas 
participant 		dalyvis 
participate 		dalyvauti (in) 
particle 		dalelytė 
participation 		dalyvavimas 
party 		partija būrys grupė komanda 
particular 		tam tikras būtent tas konkretus 
particularity 		smulkmeniškumas detalumas išsamumas 
particularize 		leistis į smulkmenas 
particularly 		ypač ypatingai labai 
pass 		praėjimas perėja tarpeklis 
passed away 		mirti numirti pasimirti (švelnesnis pasakymas) 
passion 		aistra aistringas geidulys/potraukis (for) 
passionate 		aistringas 
passive 		pasyvus inertiškas 
passenger 		keleivis 
passport 		pasas 
password 		slaptažodis 
past 		praeitis 
paste 		pasta mastika 
paste over 		apklijuoti aplipdyti 
paste up 		apklijuoti 
pasteboard 		kartonas 
pasteurize 		pasterizuoti 
pastor 		pastorius kunigas 
pate 		galva makaulė 
pattern 		modelis šablonas 
pause 		pauzė pertrauka stabtelėjimas sustojimas 
pavement 		šaligatvis 
paw 		letena 
pawn 		užstatas įkaitas 
pay 		(už)mokestis atlyginimas 
payment 		(už)mokestis mokėjimas 
peace 		taika ramybė santarvė rimtis 
peace of mind 		dvasios ramybė 
peaceable 		taikingas taikus 
peaceful 		taikingas ramus taikus 
peacefully 		taikiai 
peat 		durpės 
pedestal 		pjedestalas papėdė pakolonis cokolis 
pedestrian 		pėsčiasis 
pee 		šlapimas 
peer 		tos pačios amžiaus grupės ar socialinės padėties žmogus toks pat lygus 
peer group 		(amžiumi, padėtimi ir pan.) lygių grupė 
pence 		pensai (monetos) 
penny 		peni pensas (1/100 svaro sterlingų) 
people 		liaudis tauta 
pessimism 		pesimizmas 
pessimist 		pesimistas 
pessimistic 		pesimistinis pesimistiškas 
per 		per su pagalba 
perfect 		visiškai išbaigtas tobulas nepriekaištingas 
perfection 		tobulinimas tobulėjimas 
perfectly 		tobulai puikiai idealiai labai gerai 
perform 		atlikti įvykdyti 
performance 		įvykdymas 
perfume 		kvepėjimas kvapas aromatas 
perhaps 		gal būt 
peril 		pavojus rizika 
permission 		leidimas 
permissive 		leidžiantis leidžiamas fakultatyvus nebūtinas liberalus 
permit 		leidimas 
permittivity 		skvarba 
pertain 		priklausyti sietis būti susijusiam turėti ryšio (to) 
Persia 		Persija 
persist 		užsispirti atkakliai toliau (ką) daryti (in) 
persistence 		užsispyrimas atkaklumas 
persistency 		užsispyrimas atkaklumas 
persistent 		atkaklus užsispyręs 
persistently 		atkakliai 
person 		asmuo žmogus asmenybė 
personal 		asmeninis privatus personalinis 
personality 		asmenybė individualybė 
personally 		asmeniškai pats 
personalty 		(teis.) kilnojamasis turtas 
Peru 		Peru 
petrol 		benzinas 
phone 		kalbos garsas fonema 
phoneme 		fonema 
phonetic 		fonetinis 
phoney 		netikras apsimestinis nenuoširdus 
phony 		netikras apsimestinis nenuoširdus 
phosphorus 		fosforas 
phrase 		frazė žodžių junginys posakis 
phrasebook 		posakių bei idiomų žodynėlis pasikalbėjimų knygelė (turistams ir pan.) 
phrasing 		(minčių) formulavimas formuluotė 
physician 		gydytojas 
physiologic 		fiziologinis fiziologijos 
physiological 		fiziologinis fiziologijos 
physiologist 		fiziologas 
physiology 		fiziologija 
pick 		kirtiklis kirstuvas kaplys 
picking 		rinkimas atrinkimas 
pickup 		surinkimas paėmimas 
picky 		(ypač amer., šnek.) pernelyg išrankus smulkmeniškas 
picnic 		piknikas iškyla gegužinė 
picture 		paveikslas fotografija 
pig 		kiaulė kiauliena paršiukas 
pigeon 		balandis (paukštis) karvelis 
pillow 		pagalvė priegalvis 
pine-tree 		pušis 
pine 		pušis 
piss 		šlapintis 
pitch 		smala derva degutas pikis 
pitchy 		dervuotas dervingas 
pith 		šerdis 
pitiable 		pasigailėtinas nelaimingas 
pitiful 		niekingas sukeliąs pasigailėjimą 
pity 		gailestis 
pivot 		sukimosi arba atsparos taškas 
placard 		plakatas afiša 
place 		vieta 
plane 		plokštuma 
plank 		stora lenta 
plaster 		trauklapis pleistras 
plastering 		tinkavimas tinko darbai 
plasterer 		tinkuotojas 
plateau 		plokščiakalnis plynaukštė 
platinum 		platina 
play 		žaidimas žaismas pokštas 
playable 		tinkamas žaisti (apie aikštelę) 
playback 		atsukimas atgal (juostoje įrašyto garso/vaizdo) 
playbill 		(teatr.) afiša programa 
playboy 		plevėsa lėbautojas švaistūnas 
played-out 		išsekęs išvargęs 
player 		žaidėjas 
playful 		žaismingas mėgstantis žaisti linksmas 
playing 		skambinimas 
playing-card 		korta 
pledge 		pažadas pasižadėjimas įžadas įsipareigojimas 
pleasant 		malonus mandagus mielas 
please 		prašau jums leidžiant 
pleasure 		malonumas pomėgis 
plug 		kamštis kaištis kištukas 
plug-switch 		el. jungiklis 
plug in 		įkišti kištuką 
plus 		pliusas pliuso ženklas (t.p. plus sign) 
pocket 		kišenė 
poem 		poema eilėraštis 
poet 		poetas 
poetry 		poezija 
point 		taškas punktas 
poke 		bakstelėjimas stumtelėjimas 
Poland 		Lenkija 
Pole 		lenkas lenkė 
policeman 		policininkas 
politic 		protingas sumanus politiškas diplomatiškas 
political 		politinis valstybinis 
politician 		politikas valstybės veikėjas politikierius 
pond 		baseinas tvenkinys kūdra 
pool 		klanas 
poor 		skurdus vargingas neturtingas 
pope 		popiežius 
pork 		kiauliena 
port 		uostas 
portion 		dalis davinys 
portress 		durininkė 
position 		padėtis pozicija stovis 
possession 		valdymas turėjimas 
postcard 		atvirukas 
post 		stulpas baslys 
postage 		pašto išlaidos 
postal 		pašto 
poster 		plakatas afiša 
posterior 		užpakalinis 
postpone 		atidėti nukelti 
posture 		(kūno) laikysena padėtis poza 
potassium 		kalis 
potato 		bulvė 
poulard 		nupenėta višta 
poult 		(naminio paukščio) jauniklis 
poulterer 		paukštienos pardavėjas 
poultice 		karštas kompresas 
poultry 		naminiai paukščiai 
pound 		svaras 
practical 		praktinis praktinio pobūdžio praktiškas 
practically 		praktiškai 
practice 		praktika (pri)taikymas panaudojimas 
practician 		praktikas 
practise 		praktikuoti(s) treniruotis 
practised 		prityręs įgudęs 
Prague 		Praha 
pray 		melstis poteriauti 
prayer 		prašytojas 
prayer-book 		maldaknygė 
praying 		meldimas 
preconception 		iš anksto susidariusi nepalanki nuomonė 
precaution 		atsargumo priemonė 
precautionary 		įspėjamasis prevencinis atsargumo (apie priemones) 
precautious 		atsargus budrus apdairus 
predicate 		(gram.) tarinys predikatas 
prefer 		duoti/teikti pirmenybę labiau mėgti/norėti bevelyti 
preferable 		labiau mėgstamas/pageidaujamas vertesnis tinkamesnis (to) 
preferably 		verčiau geriau 
preference 		pirmenybė pirmumas 
preferential 		turįs ar duodąs pirmenybę 
preferment 		pirmenybė 
preferred 		(ekon.) lengvatinis privilegijuotas 
prejudice 		prietaras iš anksto susidariusi nepalanki nuomonė 
prepare 		ruošti(s) pa(si)ruošti 
present 		esąs dalyvaująs 
presently 		greitai netrukus 
press 		spausti presuoti 
pressing 		neatidėliotinas skubus 
pretty 		gražus puikus 
previously 		anksčiau 
price 		kaina 
pride 		išdidumas pasididžiavimas išpuikimas didžiavimasis 
pride oneself on 		didžiuotis 
priest 		kunigas šventikas 
principal 		viršininkas patronas 
principality 		kunigaikštystė 
principally 		daugiausia 
principle 		principas 
principled 		principingas principinis 
prior 		ankstesnis pirmesnysis prior 
prison 		kalėjimas 
prisoner 		kalinys belaisvis 
pristine 		nesugadintas gerai išsilaikęs 
probably 		gali būti galimas dalykas 
problem 		problema klausimas 
procedure 		procedūra 
process 		procesas vyksmas eiga raida plėtotė 
processing 		apdorojimas apdirbimas perdirbimas 
procession 		procesija eitynės vilkstinė eisena 
proclamation 		atsišaukimas proklamacija 
product 		produktas gaminys 
production 		produkcija gamyba gaminimas 
production-line 		konvejeris 
productive 		produktyvus našus vaisingas derlingas 
productivity 		produktyvumas našumas derlingumas vaisingumas 
professor 		profesorius dėstytojas 
profit 		nauda 
profound 		gilus nuodugnus 
project 		projektas planas pasiūlymas sumanymas 
projection 		projektavimas 
projector 		projektorius projekcinis aparatas 
prompt 		greitas punktualus 
prone 		linkęs turintis polinkį (to) 
pronoun 		įvardis 
pronounce 		(iš)tarti 
pronounceable 		(lengvai) ištariamas 
pronounced 		aiškiai išreikštas ryškus 
pronouncement 		(nutarimo, nuosprendžio) paskelbimas 
pronouncing 		(iš)tarimas 
pronto 		(šnek.) greitai skubiai nedelsiant 
pronunciation 		(iš)tarimas 
proper 		įprastas būdingas 
properly 		tinkamai prideramai 
property 		turtas nuosavybė 
proposal 		pasiūlymas siūlymas 
propose 		(pa)siūlyti pateikti (svarstyti) 
proposer 		pasiūlymo autorius (klausimo, teorijos ir pan.) pateikėjas 
proposition 		teiginys tvirtinimas 
prosecute 		tęsti (užsiėmimus) toliau daryti (ką) 
prostate 		(anat.) prostata, priešinė liauka 
proud 		išdidus 
protect 		saugoti 
protection 		saugojimas 
protector 		gynėjas užtarėjas 
prove 		įrodyti patvirtinti 
proven 		įrodytas 
psalm 		psalmė 
pseudonym 		pseudonimas slapyvardis 
psychiatrist 		psichiatras 
psychiatry 		psichiatrija 
psychological 		psichologinis psichologijos psichologiškas 
psychologist 		psichologas 
psychology 		psichologija 
pub 		alinė aludė smuklė baras 
public 		viešas 
publication 		paskelbimas (iš)leidimas publikavimas publikacija 
publicist 		publicistas žurnalistas 
publicity 		viešumas 
publicize 		viešinti paskelbti 
publicly 		viešai 
publicly-funded 		įgyvendinamas/vykdomas iš valstybės lėšų (apie projektą ir pan.) 
pugilism 		(profesionalusis) boksas kumštynės 
pull 		traukimas truktelėjimas 
pulley 		(tech.) skriemulys 
pullover 		megztinis (užsivelkamas per galvą) 
puma 		puma 
pun 		kalambūras žodžių žaismas 
punctual 		punktualus tikslus 
punish 		(nu)bausti 
punishable 		baudžiamas baustinas 
punishing 		nubaudimas 
punishment 		nubaudimas 
pupil 		mokinys auklėtinis praktikantas 
purchase 		pirkinys 
purchaser 		pirkėjas 
pure 		grynas tikras tyras 
purpose 		tikslas ketinimas 
purse 		piniginė 
purse-bearer 		iždininkas 
pursue 		vykdyti 
pursuer 		persekiotojas vijikas ieškovas 
put 		(pa)dėti (pa)statyti 
put down 		padėti 
pyjamas 		pižama 
pyramid 		piramidė 
quackery 		šundaktariavimas, šundaktarystė, šarlataniškumas, sukčiavimas 
quadrangle 		(geom.) keturkampis 
quadrangular 		keturkampis 
quadrant 		(įv.reikšm.) kvadrantas 
quadrat 		kvadratas (plotas ekologiniams tyrimams) 
quadrate 		(ypač biol.) kvadratas 
quadratic 		(mat.) kvadratinis 
quadrille 		kadrilis 
quaint 		keistas, neįprastas 
quake 		drebulys, šiurpulys 
quaking 		drebantis, virpantis 
quaky 		drebantis, virpantis 
qualification 		kvalifikacija, kvalifikacijos suteikimas, parengtumas 
qualificatory 		apibūdinantis, kvalifikuojantis 
qualified 		kvalifikuotas, kompetentingas, tinkamas 
qualifier 		žmogus, turintis reikalingą kvalifikaciją 
qualify 		įgyti/turėti kvalifikaciją 
qualifying 		kvalifikacinis 
qualitative 		kokybinis 
quality 		kokybė, rūšis 
qualm 		nuogąstavimas, nerimastinga dvejonė 
qualmish 		šleikštus, pykinantis, jaučiantis šleikštulį 
quandary 		kebli padėtis, sunkumas, dvejojimas 
quantify 		nustatyti kiekį, išmatuoti ir įvertinti/išreikšti skaičiais 
quantitative 		kiekybinis, kiekinis 
quantity 		kiekis, kiekybė 
quantum 		kiekis, suma 
quarantine 		karantinas 
quarrel 		ginčas, kivirčas, vaidai, barniai 
quarrelsome 		priekabus, vaidingas, barningas, priešgynus 
quart 		kvorta (tūrio vienetas ~ 1,14 litro) 
quarter 		ketvirtis, ketvirtadalis (of) 
quarter-note 		(amer. muz.) ketvirtinė nata 
quarterfinal 		(sport.) ketvirtfinalis 
quarterly 		žurnalas, išeinantis kartą per tris mėnesius 
quartet 		(muz.) kvartetas 
quartette 		(muz.) kvartetas 
quartic 		(mat.) ketvirto laipsnio 
quartz 		kvarcas 
queasiness 		šleikštulys, šleikštumas, norėjimas vemti 
queasy 		verčiantis vemti, šleikštus 
Quebec 		Kvebekas (Kanados provincija ir miestas) 
queen 		karalienė 
queenhood 		karalienės titulas 
queenly 		karalienės, derantis karalienei, didingas 
queensize 		didelis, platus (apie lovą ir pan.) 
queer 		keistas, keistuoliškas, ekscentriškas 
quell 		(nu)malšinti, (nu)slopinti, užgniaužti 
quench 		(nu)malšinti (troškulį) 
quencher 		malšintojas, gesintojas 
quenchless 		nenumalšinamas, neužgesinamas, negęstamas 
quern 		girnos, rankinis malūnas 
quernstone 		girnapusė, girna 
query 		klausinėti (if,whether) teirautis 
quest 		ieškojimas 
question 		klausimas 
question-begging 		loginė klaida 
question-mark 		klaustukas 
questionable 		abejotinas, ginčijamas 
questioner 		klausėjas, klausinėtojas 
questioning 		klausinėjimas, klausimas, kvota, apklausa 
questionless 		neabejotinas, neginčijamas 
questionnaire 		anketa, apklausos lapas 
queue 		eilė (automobilių ir pan. ) vora vilkstinė 
queue-jump 		(šnek.) lįsti be eilės nesilaikyti eilės užlįsti į priekį 
quibble 		smulki priekabė 
quiche 		(kul.) (pyrago tešlos) apkepas su įdaru 
quick 		greitas vikrus gyvas 
quick-acting 		greitaveikis, greit veikiantis 
quick-freeze 		greitai užšaldyti (produktus) 
quick-setting 		greitai stingstantis (apie betoną ir pan.) 
quick-tempered 		karštas, ūmus 
quick-witted 		sumanus, nuovokus, sąmojingas 
quicken 		(pa)greitinti, (pa)spartinti, (pa)greitėti 
quickfire 		šmaikštus, sąmojingas (apie kalbą ir pan.) 
quickie 		(šnek.) skubotas darbas 
quickly 		greitai, skubiai, gyvai 
quickness 		greitumas, spartumas 
quickset 		gyvašakė (ypač gudobelės) 
quicksilver 		gyvsidabris 
quickstep 		kvikstepas, greitas fokstrotas 
quickthorn 		(bot.) gudobelė 
quid 		svaras sterlingų 
quiddity 		esmė 
quiescent 		nejudamas 
quiet 		ramybė tykumas rimtis 
quiet down 		aprimti nurimti aptilti atslūgti 
quiet! 		netriukšmauti! 
quieten 		(nu)raminti, apraminti, nurimti (t.p. quieten down) 
quietly 		ramiai, tyliai 
quietness 		ramumas, tylumas, ramybė, tyluma 
quietude 		ramybė, tyla 
quietus 		mirtis 
quill 		(paukščio) plunksna, plunksnos kotas 
quilt 		dygsniuota antklodė 
quilted 		dygsniuotas 
quinine 		(farm.) chininas 
quint 		( muz.) kvinta 
quintet 		(muz.) kvintetas 
quintette 		(muz.) kvintetas 
quip 		sąmojinga/šmaikšti pastaba, sąmojis, šmaikštybė 
quipster 		šmaikštuolis 
quirk 		keistybė 
quirky 		keistas 
quirt 		(amer.) rimbas 
quit 		(amer.) išėjimas iš darbo/tarnybos 
quitch 		(bot.) varputis (t.p. quitch grass) 
quitclaim 		(teis.) teisės atsisakymas 
quite 		visiškai, visai 
quite a number 		gana daug 
quiver 		drebėjimas virpėjimas drebulys virpulys 
quivering 		mirguliavimas 
quiz 		viktorina 
quod 		(sl.) kalėjimas 
quoin 		(stat.) išorinis pastato kampas, kertinis akmuo, kertinė plyta 
quorate 		turintis kvorumą (apie posėdį, susirinkimą) 
quorum 		kvorumas 
quota 		kvota, dalis, kiekis 
quotable 		cituotinas, cituojamas, vertas (pa)cituoti 
quotation 		citata 
quotation-marks 		kabutės 
quote 		cituoti, remtis (kuo) 
quotidian 		kasdieninis 
quotient 		koeficientas 
quotum 		kvota, dalis, kiekis 
rabbi 		rabinas 
rabbit 		triušis 
rabies 		pasiutimas 
raccoon 		meškėnas 
race 		lenktynės greitas judėjimas 
race-hatred 		rasinė neapykanta 
racehorse 		lenktyninis arklys/žirgas 
racer 		lenktynininkas arklių lenktynių dalyvis 
racoon 		meškėnas 
radar 		radiolokatorius 
radiator 		radiatorius 
radio 		radijas 
radiolocation 		radiolokacija 
radish 		ridikas ridikėlis 
radium 		radis 
radius 		radiusas spindulys 
rain 		lietus 
rain or shine 		bet kokiu oru 
rainbow 		vaivorykštė 
raincoat 		lietpaltis 
raindrop 		lietaus lašas 
rainfall 		liūtis 
rainproof 		neperšlampamas 
raintight 		neperšlampamas 
rainy 		lietingas darganotas 
ram 		avinas 
ramp 		šlaitas nuožulnumas nuožulnioji plokštuma 
ranch 		gyvulininkystės ferma 
random 		padarytas arba išrinktas aklai padarytas arba išrinktas aklai 
rant 		pompastiškai kalbėti deklamuoti 
rant and rave 		šaukte šaukti 
rapid 		greitas smarkus 
rascal 		sukčius nenaudėlis 
raspberry 		avietė 
rat 		žiurkė 
rate 		greitis tempas dažnumas 
rates 		komunaliniai mokesčiai vietiniai mokesčiai 
ratepayer 		mokesčių mokėtojas 
rather 		greičiau verčiau mieliau 
ratio 		santykis proporcija 
ray 		spindulys 
rayon 		dirbtinis šilkas viskozė 
razor 		skustuvas 
reach 		(pa)siekti 
read 		skaityti 
reading 		skaitymas apsiskaitymas paskaita 
ready 		paruoštas gatavas pagamintas 
reality 		tikrovė 
realize 		įvykdyti įgyvendinti 
really 		tikrai iš tikrųjų iš tiesų 
really? 		nejaugi? tikrai? tiesa? 
rear 		(pa)statyti iškelti 
reason 		priežastis pagrindas argumentas paaiškinimas 
rebel 		sukilėlis maištininkas 
rebellion 		sukilimas pasipriešinimas 
rebound 		atatranka atšokimas rikošetas 
rebuke 		priekaištas papeikimas 
recall 		atšaukti 
receive 		priimti 
recent 		nesenas paskutinis naujas dabartinis 
recently 		neseniai pastaruoju metu šiomis dienomis 
reclaim 		(ką) atgauti atsiimti 
recline 		pusiau gulėti 
recollect 		atsiminti 
recognize 		atpažinti 
record 		dokumentas protokolas 
recruit 		naujokas, (ist.) rekrutas 
rector 		rektorius 
recurrence 		pasikartojimas kartojimasis 
red 		raudonas paraudęs 
redness 		raudonumas raudonis 
refer 		minėti kalbėti (to) 
referable 		priskirtinas (to) 
referee 		(sport.) teisėjas 
reference 		paminėjimas užuomina 
refrain 		su(si)laikyti 
refuse 		atsisakyti atmesti nepriimti paneigti 
regard 		įdėmus žvilgsnis pagarba dėmesys rūpinimasis 
regrettable 		apgailėtinas liūdnas 
regularly 		reguliariai 
regulation 		taisyklė 
reject 		atmesti atstumti 
rejection 		at(si)sakymas atmetimas 
relate 		pasakoti 
relation 		santykis giminaitis(tė) 
relational 		santykinis sąryšinis reliacinis 
relationship 		giminingumas giminystė 
relative 		reliatyvus santykinis susijęs 
relax 		susilpninti susilpnėti 
relaxation 		pramoga poilsis 
release 		(pa)leidimas 
relevance 		tiesioginis ryšys 
relevancy 		tiesioginis ryšys 
religion 		religija tikyba 
remain 		pasilikti 
remainder 		likutis 
remark 		pastaba (teis.) replika 
remarkable 		nepaprastas nuostabus (į)žymus puikus 
remarkably 		nepaprastai nuostabiai puikiai 
remember 		atsiminti atminti 
remuneration 		atlyginimas kompensacija darbo užmokestis 
rent 		skylė plyšys trūkimas plyšimas 
repast 		valgis valgymas užkandis valgymo laikas (pietūs, vakarienė) 
repeat 		kartojimas pakartojimas 
repeatable 		pakartojamas kartojamas kartotinas 
repeated 		pakartotinis kartotinis daugkartinis dažnas 
repeatedly 		pakartotinai kelis kartus 
repetition 		(pa)kartojimas kartojimasis pasikartojimas 
repetitious 		nuolat kartojamas/pasikartojantis nuobodus įkyrus 
repetitive 		kartojamasis pasikartojantis 
replace 		(pa)keisti išstumti (by, with) 
replaceable 		pakeičiamas keičiamasis 
replacement 		pakeitimas pakaitas pakaitalas 
replay 		(sport.) peržaisti 
reply 		atsakymas 
report 		pranešimas ataskaita raportas 
reporter 		pranešėjas 
repose 		poilsis ramybė 
reputable 		gerbiamas garbingas 
reputation 		reputacija geras vardas 
repute 		bendroji nuomonė reputacija vardas 
reputed 		geros reputacijos gero vardo žinomas 
reputedly 		visų manymu 
request 		prašymas reikalavimas 
require 		(pa)reikalauti įsakyti reikėti 
requirement 		(pa)reikalavimas 
research 		(mokslinis) tyri(nėji)mas nagrinėjimas (into, on) mokslo tiriamasis darbas (t.p. research work) 
researcher 		tyrėjas tyrinėtojas 
reservoir 		rezervuaras baseinas 
reside 		gyventi būti buvoti 
residence 		gyvenamoji vieta rezidencija 
residue 		liekana likutis 
residual 		(pa)likęs 
resist 		priešintis atsispirti 
resonance 		rezonansas 
resonant 		aidintis skambantis skambus rezonuojantis rezonansinis 
resonate 		rezonuoti 
resonator 		rezonatorius 
respect 		pagarba dėmesys (for) 
respond 		atsakyti 
response 		atsakymas atsiliepimas atsakas 
rest 		likutis liekana likusieji 
result 		rezultatas padarinys pasekmė baigtis išdava 
results 		vaisius 
resultant 		išplaukiantis kylantis sekąs 
retire 		pasitraukti (iš pareigų) išeiti, išleisti (į atsargą, pensiją) atsistatydinti 
retired 		atsistatydinęs išėjęs į pensiją atsargos dimisijos 
retirement 		atsistatydinimas pasitraukimas išėjimas į pensiją/atsargą 
return 		sugrįžimas 
rev 		(variklio) apsisukimas sūkis apsisukimų/sūkių skaičius (per minutę) 
revealing 		atskleidžiantis pamokantis įdomus atviras (apie pareiškimą ir pan.) 
revolt 		maištas sukilimas 
revolver 		revolveris 
Rex 		karalius 
rhino 		raganosis 
rhinoceros 		raganosis 
rice 		ryžiai 
rich 		turtingas gausus 
riches 		turtas apstumas 
ridden 		pp iš ride 
ride 		jojimas pasijodinėjimas 
ride-off 		kliūtis užtvara (jojimo varžybose) 
rider 		jojėjas jojikas raitelis raitininkas 
ridicule 		išjuokimas pajuokimas pajuoka 
ridiculous 		juokingas absurdiškas kvailas 
rifle 		šautuvas graižtvinis ginklas 
right 		dešinysis 
rim 		kraštas briauna 
ring 		žiedas apskritimas 
ripe 		subrendęs prinokęs 
rise 		keltis (pa)kilti iškilti patekėti (apie saulę) 
risk 		rizika 
reveal 		atskleisti 
river 		upė 
road 		kelias 
roam 		klajoti bastytis keliauti 
robber 		plėšikas 
robe 		mantija 
robot 		robotas 
rock 		uola 
rocket 		raketa 
rod 		meškeriakotis 
rode 		pt iš ride 
roe 		stirna 
rogue 		sukčius niekšas 
role 		rolė vaidmuo 
roller 		skrituliukas 
romance 		romanas meilės nuotykis romantiškas epizodas 
Roman 		Romos 
Romania 		Rumunija 
Romanian 		rumuniškas rumunų Rumunijos 
Romanism 		katalikybė 
romantic 		romantiškas 
romanticism 		romantizmas 
romanticist 		romantikas 
Romany 		čigonas čigonė 
roof 		stogas pastogė namai 
roofer 		stogdengys 
roofing 		stogo dengimas stogo danga 
roofrack 		bagažinė (metaliniai rėmai ant automobilio stogo) 
rooftop 		stogo viršus kraigas 
room 		kambarys 
root 		šaknis 
rope 		virvė lynas 
rose 		rožė 
rouble 		rublis 
rough 		šiurkštus nelygus grubus grubletas rupus 
roughly 		apytikriai grubiai 
round 		apskritas apvalus 
roundabout 		aplinkinis 
route 		kelias maršrutas 
row 		eilė 
rubber 		guma kaučiukas 
rubbish 		šlamštas niekai 
ruble 		rublis 
rule 		taisyklė norma 
run 		bėgti bėgioti 
run across 		su(si)tikti užtikti 
run away 		išbėgti pabėgti pasprukti 
rural 		kaimo kaimiškas 
Russia 		Rusija 
Russian 		rusas 
sack 		plėšti grobti 
sad 		liūdnas nusiminęs susisielojęs niūrus 
saddle 		balnas 
sadden 		liūdinti nuliūdinti nuliūsti 
sadly 		liūdnai 
sadness 		liūdesys nuliūdimas nusiminimas 
safe 		seifas nedegamoji spinta 
safety 		saugumas sauga 
safety-pin 		žiogelis (toks segtukas) 
sagacious 		sumanus nuovokus įžvalgus 
sage 		išmintingas gudrus 
sail 		burė burės 
sailor 		jūreivis jūrininkas 
sake 		(for the)  dėl ko nors kieno/ko labui 
sake 		sakė (ryžių degtinė) 
salary 		alga atlyginimas 
sallow 		gluosnis blindė 
salmon 		lašiša 
salon 		salonas svetainė 
salty 		sūrus sūrokas sūdytas pikantiškas 
sand 		smėlis žvirgždas 
sand-dune 		kopa 
sandwich 		sumuštinis 
sash 		juosta diržas 
satellite 		satelitas šalininkas 
satisfaction 		pa(si)tenkinimas (at, with) 
satisfactory 		patenkinamas pakankamas 
satisfied 		patenkintas (with – kuo) 
satisfy 		pa(si)tenkinti atitikti (reikalavimus) 
satisfying 		teikiantis pasitenkinimą 
Saturday 		šeštadienis 
saucer 		lėkštelė lėkštutė padėklas 
Saudi Arabia 		Saudo Arabija 
sausage 		dešra dešrelė 
save 		gelbėti 
saw 		būtasis laik. iš see 
saw off 		atpjauti nupjauti 
saw the air 		gestikuliuoti 
sawdust 		pjuvenos 
sawer 		pjovikas 
sawing 		pjovimas 
sawing out 		išpjovimas 
sawmill 		lentpjūvė 
say 		sakyti kalbėti 
saying 		priežodis pasakymas posakis patarlė 
scale 		svarstyklės svarstyklių lėkštė 
Scandinavia 		Skandinavija 
scant 		menkas nepakankamas ribotas 
scantling 		nedidelis kiekis truputis 
scanty 		skurdus menkas 
scar 		randas 
scarce 		retas 
scarcely 		vos-ne-vos vargu ar 
scare 		išgąstis panika 
scarecrow 		baidyklė kaliausė 
scorer 		taškų pelnytojas 
scent 		kvapas 
schedule 		katalogas grafikas planas sąrašas 
scheme 		schema projektas 
school 		mokykla 
science 		mokslas mokslo šaka 
scream 		riksmas, klyksmas, spiegimas 
screen 		uždanga ekranas 
Scotland 		Škotija 
scrap 		gabaliukas skutelis 
scuffle 		muštynės 
sea 		jūra vandenynas 
sea-dog 		ruonis 
seal 		antspaudas 
seaside 		pajūris 
seat 		kėdė 
second 		sekundė momentas 
secondary 		antrinis antraeilis 
secrecy 		slaptumas paslaptis 
secret 		paslaptis 
secretly 		slaptai (pa)slapčia (pa)slapčiom(is) 
security 		saugumas apsauga 
see 		matyti žiūrėti stebėti 
seed 		sėkla grūdas 
seem 		rodytis atrodyti 
seeming 		netikras tariamas menamas 
seemingly 		matyt 
seize 		pagriebti pačiupti uždėti areštą konfiskuoti 
seldom 		retai 
sell 		parduoti prekiauti 
sell-off 		privatizavimas (pramonės šakos) 
sell-out 		renginys, į kurį visi bilietai parduoti anšlagas 
seller 		pardavėjas prekiautojas 
selling 		pardavimas prekiavimas 
send 		siųsti pasiųsti 
sender 		siuntėjas 
senior 		vyresnis (amžiumi) 
seniority 		vyresnumas vyresniškumas pirmenybė (dėl darbo stažo) 
sensation 		pojūtis jausmas įspūdis 
sense 		jutimas jausmas pojūtis 
senses 		protas sąmonė 
senseless 		beprasmis beprasmiškas bereikšmis neprasmingas 
sentence 		nuosprendis 
separability 		atskiriamumas skaidumas 
separable 		atskiriamas išskiriamas 
separate 		atskiras 
separation 		at(si)skyrimas per(si)skyrimas 
separatism 		separatizmas 
separatist 		separatistas 
separator 		skirtuvas separatorius 
September 		rugsėjis 
serial number 		eilės numeris 
series 		serija eilė komplektas 
serious 		rimtas 
serpent 		gyvatė 
servant 		tarnas tarnaitė 
set 		statyti dėti talpinti 
settlement 		kolonija į(si)kurdinimas 
seven 		septyni septynetas 
seventeen 		septyniolika 
seventeenth 		septynioliktas 
seventieth 		septyniasdešimtas 
seventh 		septintas 
seventy 		septyniasdešimt 
several 		keletas keli 
severe 		griežtas žiaurus 
severity 		griežtumas žiaurumas aštrumas (skausmo) 
sex 		lytis 
sextant 		sekstantas šeštoji apskritimo dalis 
sexton 		bažnyčios sargas zakristijonas varpininkas 
sexual 		lytinis seksualinis seksualus 
sexy 		seksualus erotiškas jaudinantis fiziškai patrauklus 
sexless 		belytis 
Siberia 		Sibiras 
Sicily 		Sicilija 
sick 		nesveikas jaučiąs šleikštulį 
side 		pusė šonas 
sideboard 		bufetas indauja 
sidewalk 		(amer.) šaligatvis 
sign 		ženklas 
sign-board 		iškaba 
sign-post 		kelrodis kelrodinis stulpas 
signal 		signalas ženklas 
signalling 		signalizacija 
signature 		parašas signatūra 
signet 		antspaudas (asmeninio parašo) 
significance 		reikšmė svarba 
significant 		reikšmingas svarbus 
signification 		reikšmė prasmė 
significative 		reikšmingas prasminis 
signify 		reikšti 
silent 		tylus nešnekus 
silicon 		silicis 
silicone 		silikonas 
silk 		šilkas šilkinė medžiaga 
silly 		paikas kvailas kvailokas nerimtas neprotingas 
silver 		sidabras 
similar 		panašus 
similarity 		panašumas 
similarly 		panašiai 
since 		nuo 
sincere 		nuoširdus tikras atviraširdis 
sincerity 		nuoširdumas tiesumas 
simple 		paprastas nesudėtingas 
simple-hearted 		atviraširdis naivus patiklus 
simple-minded 		naivus kvailas kvailokas 
simpleton 		neišmanėlis mulkis nenuovoka 
simply 		paprastai nesunkiai tik tiesiog 
sing 		dainuoti giedoti 
Singapore 		Singapūras 
single 		vienas vienintelis 
siren 		pavojaus signalas sirena 
sister 		sesuo 
sit 		sėdėti 
sit down 		sėstis 
six 		šeši 
site 		sklypas vieta aikštelė 
sitting 		posėdis 
sitting‐room 		svetainė svečių kambarys 
situation 		padėtis situacija aplinkybės 
sixteen 		šešiolika 
sixteenth 		šešioliktas 
sixtieth 		šešiasdešimtas 
sixth 		šeštas 
sixty 		šešiasdešimt 
size 		dydis kalibras gabaritas apimtis formatas 
size up 		nustatyti dydį nustatyti apimtį 
sizeable 		didokas didelis gerokas 
Sudan 		Sudanas 
Sunday 		sekmadienis 
seek 		ieškoti 
seek out 		suieškoti 
seeker 		ieškotojas (after, for – ko) 
shallow 		seklus negilus 
shame 		gėda nešlovė 
share 		dalis 
shareholder 		akcininkas dalininkas pajininkas 
shark 		ryklys 
sharp 		aštrus smailus 
shave 		skutimas(is) 
she 		ji 
shed 		pašiūrė 
sheen 		spindėjimas švytėjimas 
sheep 		avis avinas 
sheet 		paklodė 
shelf 		lentyna 
shelter 		pastogė prieglobstis prieglauda 
shepherd 		piemuo kerdžius 
shift 		pakeitimas perkėlimas perėjimas (from… to– nuo… prie) 
shift off 		vengti kratytis atsikratyti (atsakomybės ir pan.) 
shifting 		nepastovus kintantis atsinaujinantis 
shiftless 		neapsukrus nemokantis gudrauti/išsisukinėti 
shifty 		apsukrus gudrus mokantis išsisukti 
shilling 		šilingas 
shiny 		šviesus spindįs blizgąs 
ship 		laivas 
shirt 		marškiniai 
shit 		šūdas šlamštas 
shock 		smūgis 
shock‐absorber 		amortizatorius 
shoe 		batas 
shoot 		medžioklė 
shoot-out 		(šnek.) susišaudymas 
shooter 		šaulys 
shooting 		šaudymas 
shooting-gallery 		šaudykla tiras 
shooting-iron 		(amer. šnek.) šaunamasis ginklas 
shooting-match 		šaudymo varžybos 
shooting-range 		šaudykla tiras 
shop 		parduotuvė krautuvė 
shore 		ramstis atrama 
shoreward 		kranto link 
short 		trumpas striukas trumpalaikis 
shorts 		kelnaitės šortai trumpikės glaudės 
shot-put 		(sport.) rutulio stūmimas 
shot-putter 		(sport.) rutulio stūmikas 
shot 		šūvis 
shoulder 		petys 
shout 		šauksmas rėksmas 
shouting 		šauksmai (pritarimo, sveikinimo) šūksniai 
shouting-match 		(šnek.) barimasis plūdimasis 
shovel 		semtuvas kastuvas 
show 		(pa)rodymas 
show-case 		vitrina 
show-down 		(galimybių, resursų) atskleidimas parodymas 
show-off 		maivymasis manieringumas 
show-room 		parodų demonstravimo salė 
show-window 		vitrina 
shower 		liūtis dušas kruša gausybė 
shower-bath 		dušas 
shut 		uždaryti uždengti užsidaryti 
shut-down 		išjungimas 
shuttle 		šaudyklė 
shy 		drovus bailus 
ski 		slidė 
skill 		sumanumas įgudimas meistriškumas nagingumas sugebėjimas 
skilled 		prityręs kvalifikuotas įgudęs 
skillet 		(amer.) keptuvė 
skillful 		meistriškas sumanus nagingas įgudęs prityręs 
skin 		oda kailis 
skulduggery 		machinacijos, akių dūmimas 
skull 		kaukolė 
skullcap 		šlikė, (aukštųjų dvasininkų) kepuraitė 
skullduggery 		machinacijos, akių dūmimas 
sky 		dangus padangė 
skyline 		horizontas horizonto linija 
slam 		dėjimas kamuolio dėjimas į krepšį iš viršaus 
slave 		vergas 
slaughter-house 		skerdykla 
slay 		užmušti nužudyti 
sleep 		miegas 
slice 		riekė dalis 
slip 		(pa)slydimas 
slip-on 		lengvas apsivilkti/nusivilkti drabužis laisvas drabužis (ypač megztinis) 
slip-up 		(šnek.) klaida apsirikimas neapsižiūrėjimas 
slip-over 		užvelkamas per galvą 
slipper 		šliurė šlepetė 
slippery 		slidus 
slippy 		slidus 
slit 		prapjova ilgas pjūvis 
slither 		slysti slidinėti 
slithery 		slidus vinguriuojantis 
slow 		lėtas ramus 
slug 		šliužas 
small 		mažas menkas smulkus nežymus 
smart 		smarkus skausmas (perk.) kančia 
smarts 		protas nuovoka 
smarten 		gražintis puoštis 
smartly 		dailiai prašmatniai 
smartness 		prašmatnumas puošnumas 
smell 		kvapas 
smile 		šypsena šypsnys 
smith 		kalvis 
smoke 		dūmai 
smuggle 		verstis kontrabanda 
smuggler 		kontrabandininkas 
snack 		lengvas užkandis 
snail 		sraigė 
snake 		gyvatė 
sneaking 		niekšiškas pasalūniškas 
sneer 		pajuoka pašaipa 
sneering 		patyčios pašaipa 
snip 		(į)kirpimas įkarpa įpjova 
sniper 		snaiperis taiklus šaulys 
snipper 		siuvėjas 
snippet 		nuokarpa gabalėlis 
snippy 		fragmentinis trumpas 
snow 		sniegas 
snowflake 		snaigė snieguolė 
so 		taip taigi tuo būdu vadinasi 
so! 		na jau! nejaugi! 
so-called 		vadinamasis 
so-so 		šiaip sau vidutiniškai pusėtinai pakenčiamai 
soak 		įmerkti išmirkyti 
soak in 		įsigerti įsisunkti įsiurbti siurbtis 
soak off 		atmirkyti atvilgyti 
soak up 		suimti įsisavinti įsiurbti 
soaked 		įmirkęs įmirkytas 
soaking 		įmirkymas 
soaking off 		atmirkymas 
soap 		muilas 
soccer 		futbolas (ypač amer.) 
socialism 		socializmas 
socialist 		socialistas 
society 		visuomenė draugija 
sociology 		sociologija 
sock 		kojinaitė puskojinė 
sodium 		natris 
sofa 		sofa kanapa 
soft 		minkštas švelnus malonus 
software 		programinė įranga 
soil 		žemė dirva dirvožemis 
soil-pipe 		kanalizacijos vamzdis 
soiled 		apčiuręs nešvarus purvinas 
sold 		pt ir pp iš sell 
solder 		(su)lituoti prilituoti 
soldering-iron 		lituoklis 
soldier 		kareivis karys kariškis 
soldierly 		drąsus ryžtingas karingas 
soldiery 		kariauna 
sole 		padas puspadis (techn.) pamatas dugnas 
solely 		išimtinai tiktai 
solicitor 		advokatas patikėtinis įgaliotinis 
solid 		kietas tvirtas 
solidarity 		solidarumas vieningumas vienybė 
solidify 		stiprinti vienyti 
solidity 		kietumas tvirtumas vientisumas 
solidly 		kietai 
solids 		tirščiai 
solitary 		vienišas atsiskyręs atskiras nuošalus 
solution 		(iš)sprendimas sprendinys 
solvability 		išsprendžiamumas 
solvable 		išsprendžiamas 
solve 		spręsti išspręsti išaiškinti įminti 
solvency 		(ekon.) mokumas mokamasis pajėgumas 
solvent 		(chem.) tirpiklis 
some 		kažkoks tam tikras kuris 
somebody 		(apie žmogų) kažkas kas nors 
somehow 		kaip nors kažkaip kažin kaip kažkodėl šiaip taip 
someone 		(apie žmogų) kažkas kas nors 
sometime 		kada nors kažkada 
sometimes 		kartais 
something 		kažkas kas nors 
somewhat 		iš dalies šiek tiek 
some one 		(apie žmogų) kažkas kas nors 
son 		sūnus 
song 		daina giesmė 
soon 		greit netrukus 
sorcerer 		burtininkas kerėtojas 
sort 		rūšis 
soul 		siela dvasia vėlė 
soulful 		jausmingas melancholiškas 
soulless 		besielis beširdis 
soulmate 		gimininga siela 
sound 		garsas skambėjimas ūžesys bildesys 
sound as a bell 		geros būklės 
soundless 		begarsis 
soundness 		pagrįstumas 
soundspeaker 		garsiakalbis 
soup 		sriuba 
sour 		rūgštus surūgęs 
source 		šaltinis versmė 
source code 		išeitinis kodas 
sorry 		liūdnas nelaimingas apgailestaująs 
sour cream 		grietinė 
sourish 		rūgštokas gižus 
sourness 		rūgštis rūgštumas 
south 		pietūs pietų kraštas 
South Africa 		Pietų Afrika 
sow 		sėti apsėti 
space 		tuščia vieta 
spade 		kastuvas 
Spain 		Ispanija 
span 		trukmė 
Spanish 		ispaniškas ispanų 
spar 		skersinis sija 
spare 		taupyti saugoti apsieiti be ko nors 
sparing 		nuosaikus taupus 
spark 		kibirkštis žiežirba 
sparkle 		žaižaravimas žėrėjimas žibėjimas kibirkščiavimas 
sparklet 		kibirkštėlė 
sparkling 		žėrįs žibąs 
sparrow 		žvirblis 
sparse 		retas negausus 
speak 		kalbėti šnekėti sakyti tarti 
speaker 		kalbėtojas oratorius 
special 		specialus ypatingas nepaprastas tam tikras 
special case 		kazusas 
specialist 		specialistas 
speciality 		specialybė 
specialities 		detalės smulkmenos 
specialization 		specializacija 
specialize 		specializuotis 
specially 		specialiai 
specialty 		
specific 		būdingas ypatingas specifinis 
specifically 		konkrečiai 
specification 		specifikacija 
speech 		kalba kalbėjimas pranešimas 
speed 		greitis tempas 
speedy 		greitas spartus skubus 
spend 		(iš)leisti eikvoti naudoti (on – kam) 
spender 		eikvotojas išlaidūnas 
spending 		išlaidos 
spent 		pt ir pp iš spend 
spider 		(zool.) voras 
spider-crab 		(zool.) jūrų krabas 
spider-line 		voratinklio/voratinklinis siūlas 
spider-web 		(amer.) voratinklis 
spidery 		voro pavidalo voriškas 
spiral 		spiralė (t.p. mat.) 
splash 		(ap)taškymas purslai pliuškenimas 
spool 		kaupas 
sport 		sportas žaidimas (pl.) rungtynės sporto rūšys 
spot 		dėmė šlakelis 
spreadsheet 		(komp.) skaičiuoklė elektroninė sprendimo lentelė 
spring 		pavasaris pražydimas (perk.) pradžia 
springtime 		pavasaris pavasario laikas 
spud 		bulvė 
square 		kvadratinis stačiakampis 
squash 		spūstis kamšatis grūstis 
squashy 		minkštas mėsingas 
squeeze 		(su)spaudimas (su)slėgimas 
squirrel 		(amer.) voverė 
stair 		laiptelis pakopa 
staircase 		laiptai 
staff 		lazda ramstis 
stage 		stadija fazė tarpsnis etapas pakopa (t.p. spec.) 
star 		žvaigždė (dangaus) šviesulys 
stars and banners 		žvaigždutės ir juostelės 
standard 		vėliava 
stand 		stovėti atsistoti 
stand by 		(komp.) pristabdyti 
stand up 		stovįs stačias 
standing 		pastovus nustatytas 
start 		pradėti imtis 
start menu 		(komp.) pradžios meniu 
start path 		(komp.) paleidimo kelias 
startup 		(komp.) operacinės sistemos paleidimas 
state 		būsena padėtis visuomeninė padėtis 
statement 		pareiškimas tvirtinimas konstatavimas 
station 		vieta postas punktas 
status 		būsena būklė padėtis stovis 
status bar 		(komp.) būsenos juosta 
stay 		buvimas apsistojimas viešėjimas viešnagė 
steal 		vogti 
stealing 		vogimas vagystė 
steak 		mėsos/žuvies pjaustinys 
step 		žengtelėti žengti 
step after 		sekti 
step aside 		pasitraukti į šalį duoti kelią užleisti vietą 
step back 		atsitraukti trauktis 
step down 		nužengti išlipti 
step forward 		išeiti į priekį prisistatyti 
step on 		užminti numinti 
step out 		išeiti 
step over 		peržengti 
steps 		kopėčios 
stepdaughter 		podukra 
stepfather 		patėvis 
stepmother 		pamotė 
stepson 		posūnis 
stewardess 		stiuardesė palydovė 
still 		dar vis dar iki šiol 
stink 		smarvė dvokas dvokimas 
stinker 		smirdžius susmirdėlis smirdalas 
stinking 		dvokiantis smirdintis 
stinky 		dvokiantis dvokus smardus 
stock 		atsarga ištekliai (turimas, esamas) kiekis 
stock-account 		(ekon.) kapitalo sąskaita 
stock-in-trade 		prekių atsarga/ištekliai 
stock-market 		fondų birža 
stock-raising 		gyvulininkystė 
Stockholm 		Stoholmas 
stole 		past tense iš steal 
stolen 		pp iš steal 
stomach 		pilvas skrandis skilvis 
stone 		akmuo 
stool 		taburetė sėdynė kėde 
stop 		sustojimas stabdymas sulaikymas stotelė 
storage 		saugojimas sandėliavimas laikymas 
storage battery 		akumuliatorius 
storage media 		(komp.) laikmena 
store 		atsarga gausumas sandėlis universalinė parduotuvė 
stork 		gandras 
storm 		audra štormas 
story 		pasakojimas pasaka apysaka sakmė padavimas 
stout 		narsus ryžtingas 
straight 		tiesus teisingas sąžiningas doras 
strange 		svetimas nepažįstamas nežinomas 
stranger 		svetimšalis pašalinis žmogus 
strangle 		pasmaugti uždusinti uždusti 
strangled 		duslus prislopintas 
stranglehold 		(už)dusinimas (pa)smaugimas 
strangler 		smaugėjas žmogžudys 
stream 		srovė upė upelis tekėjimas 
street 		gatvė 
stress 		kirtis 
strike 		streikas 
strikethrough 		perbraukimas 
strictly 		griežtai tiksliai 
string 		virvė styga vėrinys 
stroll 		vaikščioti klaidžioti 
strong 		stiprus tvirtas griežtas ryžtingas 
structural 		struktūrinis 
structure 		struktūra sandara 
structured 		struktūrinis struktūriškai apibrėžtas 
struggle 		kova grumtynės 
stucco 		tinkas 
stuccowork 		lipdytiniai pagražinimai 
student 		studentas moksleivis 
studio 		dirbtuvė studija 
study 		mokslinis darbas tyrinėjimas (of) 
stuff 		medžiaga materija 
stuffing 		kamšalas įdaras 
stupid 		kvailas bukaprotis atbukęs apglumęs 
subconscious 		pasąmonės nesąmoningas 
subconsciousness 		pasąmonė 
subdirectory 		(komp.) pakatalogis 
subfolder 		(komp.) poaplankis 
subject 		tema klausimas dalykas 
subject to 		jei priklausomai nuo 
subject-matter 		turinys tema dalykas siužetas 
subjects 		tematika 
subjection 		pajungimas pavergimas priklausomybė priklausomumas 
subjective 		subjektyvus įsivaizduojamas 
subnet 		(komp.) potinklis 
subroutine 		(komp.) paprogramė 
subscribe 		užsisakyti prenumeruoti 
subscriber 		prenumeratorius abonentas 
subsequent 		einantis po paskesnis vėlesnis tolesnis 
subsequently 		vėliau paskui 
substantive 		savarankiškas nepriklausomas 
substantial 		esminis svarbus 
substantiality 		realybė 
substantially 		iš esmės iš pagrindų 
subtle 		subtilus įmantrus švelnus (apie jausmą) aštrus (apie protą) vos pastebimas 
subtlety 		subtilumas įmantrumas švelnumas aštrumas (proto ir pan.) 
subtotal 		(komp.) tarpinė suma tarpinis rezultatas 
subtract 		atimti (ypač mat.) 
subtraction 		(mat.) atimtis 
subway 		tunelis požeminė perėja 
success 		pasisekimas sėkmė 
successful 		sėkmingas nusisekęs vykęs 
succession 		eilė eiliškumas seka 
successive 		einantis vienas po kito sekantis vienas paskui kitą (iš eilės) nuoseklus 
successively 		iš eilės vienas paskui kitą (be pertraukos) 
successor 		tęsėjas perėmėjas paveldėtojas įpėdinis (to, of) 
such 		toks šitoks 
such as 		toks kaip kaip antai 
suck 		čiulpimas žindymas siurbimas įtraukimas 
sucked 		iščiulptas išspaustas 
suddenly 		staiga netikėtai nelauktai ūmai 
sufficient 		pakankamas 
sugar 		cukrus 
sugary 		saldus cukringas 
suggest 		įteigti pakišti mintį 
suggestible 		paveikiamas pasiduodąs įtaigai 
suggestion 		patarimas pasiūlymas 
suggestive 		(su)keliantis mintis verčiantis galvoti 
suitability 		tinkamumas tikimas (for) 
suitable 		tinkamas tinkąs atitinkamas 
suitably 		tinkamai deramai 
sulphur 		siera 
sultan 		sultonas 
summer 		vasara 
summit 		viršūnė aukščiausias taškas viršukalnė 
summon 		pakviesti pašaukti 
summons 		kvietimas šaukimas 
sun 		saulė saulės šviesa 
super 		aukščiausios rūšies puikus nuostabus 
superable 		įveikiamas 
superscript 		(komp.) viršutinis indeksas 
superstition 		prietaras 
supper 		vakarienė 
supplication 		nuolankus prašymas maldavimas meldimas 
support 		palaikymas parama atrama ramstis atspara 
supported 		prižiūrimas palaikomas 
supporter 		šalininkas rėmėjas 
suppose 		galvoti manyti daryti prielaidą 
supposed 		tariamas menamas spėjamas įsivaizduojamas numatomas 
supposedly 		galbūt manoma spėjama 
sure 		tikras įsitikinęs neabejotinas 
surely 		be abejo žinoma būtinai 
surface 		paviršius 
surge 		didelė banga bangavimas bangos 
surgeon 		chirurgas 
surgery 		chirurgija 
surname 		pavardė pravardė 
surprise 		nustebimas nuostaba 
surprising 		nelauktas nuostabus stebinąs stebinantis 
survey 		apžiūra apžiūrėjimas 
survive 		išlikti išlikti gyvam gyvuoti 
suspend 		pristabdyti sulaikyti sustabdyti nutraukti atidėti 
suspend mode 		(komp.) laukimo būsena 
sustain 		(iš)laikyti paremti 
sustained 		nepertraukiamas ilgalaikis ilgas 
swamp 		pelkė raitas bala 
swan 		gulbė 
swank 		puikavimasis pasipūtimas gyrimasis 
swap 		(apsi)keitimas pasikeitimas mainai 
swap file 		(komp.) sukeitimų/mainų failas 
Sweden 		Švedija 
Swedish 		švediškas švedų 
swear 		prisiekti prižadėti 
swear-word 		keiksmažodis keiksmas 
swearing-in 		prisaikdinimas (pradedant eiti pareigas) 
sweep 		šlavimas valymas 
sweet 		saldus šviežias kvapus malonus švelnus 
swept 		pt ir pp iš sweep 
swift 		greitas skubus sraunus guvus vikrus mitrus 
swim 		plaukti plaukioti maudytis paplūsti būti paplūdusiam pasrūti būti pasruvusiam 
swimming 		plaukimas plaukymas plaukiojimas 
swimming‐bath 		plaukymo baseinas 
swimming‐pool 		plaukymo baseinas 
swimmingly 		sklandžiai sėkmingai 
swine 		kiaulė 
swing 		siūbavimas supimasis svyravimas mostelėjimas eiga 
switch 		perjungiklis jungiklis komutatorius 
sword 		kardas kalavijas špaga 
Switzerland 		Šveicarija 
Syria 		Sirija 
system 		sistema 
synopsis 		konspektas trumpa apžvalga 
systematic 		sistemingas metodiškas sisteminis 
systematize 		(su)sisteminti sistematizuoti 
systematized 		susistemintas 
systemic 		sisteminis sistemos 
Thursday 		ketvirtadienis 
Tuesday 		antradienis 
tab 		ąselė kilpelė 
table 		stalas 
table of contents 		turinys 
table‐cloth 		staltiesė 
tablet 		lentelė (su užrašu) 
tabstop 		(komp.) tabuliavimo pozicija 
tabulation 		lentelių sudarymas 
tackle 		reikmenys įrengimai 
tact 		taktas 
tactics 		taktika 
tag 		kadaruojąs, laisvas galas 
tail 		uodega eilė 
tailor 		siuvėjas 
take 		imti priimti 
taken aback 		nustebintas priblokštas pasimetęs 
take account of 		atsižvelgti 
take away 		paimti nunešti pašalinti 
take care 		būti atsargiam 
take care of 		rūpintis 
take down 		nuimti (nuo lentynos ir pan.) 
take fire 		užsidegti 
take in 		priimti (svečią, gyventoją) 
take leave 		atsisveikinti 
take note 		daryti pastabą 
take off 		nuimti 
take over 		perimti (pareigas ir pan.) 
take the place of 		įvykti 
taking 		patrauklus limpamas užkrečiamas 
tale 		pasaka pasakojimas 
talent 		talentas 
talisman 		talismanas 
talk 		pokalbis gandas plepalai 
tall 		aukštas didelio ūgio 
tame 		prijaukintas jaukus paklusnus 
tangent 		(geom.) liestinė 
tangential 		tangentinis liestinis liečiamasis 
tangerine 		mandarinas 
tangle 		painiava su(si)painiojimas raizginys 
tank 		rezervuaras bakas 
tap 		čiaupas kamštis 
tape‐recorder 		magnetofonas 
tape 		kaspinas juosta raištis 
taper 		plona žvakė 
tar 		degutas derva 
target 		taikinys 
tart 		aitrus rūgštus 
task 		užduotis uždavinys pareiga 
taskbar 		(komp.) užduočių juosta 
taskmaster 		brigadininkas prižiūrėtojas 
taste 		skonis ragavimas 
tasty 		skanus gardus 
tater 		bulvė 
tatter 		skarmalai skutai 
tattler 		plepys liežuvautojas 
tax 		mokestis 
taxation 		apmokestinimas mokesčio dydis 
taxi 		taksi 
tea‐pot 		arbatinis (virdulys) 
tea 		arbata 
teach 		mokyti dėstyti 
teacher 		mokytojas dėstytojas 
team 		komanda būrys brigada 
tear 		plėšti plėšyti 
tear off 		nuplėšti suplėšyti 
tease 		erzinti pykinti 
teaser 		erzintojas mėgėjas (pa)erzinti 
teat 		spenys spenelis 
technician 		technikas 
technics 		technika techniniai mokslai 
technique 		technika  (metodai ir įgūdžiai) 
tedious 		nuobodus varginąs 
teeth 		dantys 
teetotaller 		absoliutus blaivininkas 
telegram 		telegrama 
telegraph 		telegrafas 
telephone 		telefonas 
television 		televizija 
tell 		pasakoti kalbėti 
tellable 		pasakotinas kurį galima/verta (pa)pasakoti 
teller 		pasakotojas 
telling 		pasakojimas 
telling-off 		(šnek.) (iš)barimas pyla 
telltale 		(šnek.) skundikas skundeiva 
tell a lie 		sakyti netiesą meluoti 
temper 		reguliuoti 
temperate 		vidutinis santūrus 
temperature 		temperatūra 
template 		šablonas 
temple 		šventykla šventovė 
templet 		šablonas lekalas 
tempt 		gundyti vilioti 
temptation 		pagunda gundymas 
ten 		dešimt dešimtis 
tenant 		nuomininkas valdytojas (laikinas) 
tendency 		tendencija siekimas palinkimas 
tender 		slaugytojas 
tenderness 		švelnumas, meilumas minkštumas 
tend to 		linkti į krypti į 
tense 		įtemptas įsitempęs standus 
tensely 		įtemptai įsitempus 
tension 		įtempimas 
tent 		palapinė 
term 		tam tikras periodas terminas 
terminal 		galutinis galinis 
terminate 		baigti(s) 
terrace 		terasa 
terrain 		vietovė teritorija 
terrestrial 		žemės žemiškas 
terrible 		siaubingas baisus 
territory 		teritorija 
terror 		siaubas 
test 		mėginimas bandymas tyrimas 
testament 		testamentas 
testicle 		vyriškosios sėklidės 
testify 		liudyti duoti parodymus 
testimony 		paliudijimas raštu 
text 		tekstas 
text box 		(komp.) teksto langelis 
textbox 		(komp.) teksto langelis 
text direction 		teksto kryptis 
text justification 		teksto lygiuotė 
textile 		audinys tekstilė 
texture 		audinio kokybė/tankis audimas audinio faktūra audinys 
than 		negu kaip 
thank 		dėkoti 
thankful 		dėkingas 
thankless 		nedėkingas 
thanks 		dėkui 
thanks to 		dėka 
thank you 		ačiū dėkoju 
that 		anas tas 
that is 		tai yra 
that much 		tiek 
thaw 		tirpti tirpdyti 
the 		žymimasis artikelis 
theatre 		teatras 
theater 		teatras 
thee 		(poet.) tave tau 
theft 		vagystė vogimas 
their 		jų savo 
them 		juos jas jiems joms 
theme 		tema rašinys 
then 		tada po to paskui tuo laiku 
theory 		teorija 
there 		ten į ten 
thereabout 		netoliese maždaug 
thereabouts 		netoliese maždaug 
thereafter 		nuo to laiko atitinkamai 
therefore 		dėl to todėl taigi 
there are 		yra turima 
there is 		yra turima 
thermometer 		termometras 
thesaurus 		tezauras žodynas enciklopedija 
these 		šie 
these days 		šiomis dienomis 
thesis 		tezė 
they 		jie 
thick 		storas drūtas stambus tirštas tankus 
thicken 		storėti tirštėti 
thieve 		vogti pavogti 
thievery 		vagystė vogimas 
thieving 		vogimas vagiliavimas 
thievish 		suktas nedoras vagiliškas 
thigh 		šlaunis 
thimble 		antgalis antpirštis 
thin 		plonas liesas 
thing 		daiktas dalykas 
think 		galvoti manyti būti nuomonės, laikyti 
third 		trečias trečdalis 
thirst 		troškulys 
thirteen 		trylika 
thirteenth 		tryliktas tryliktoji dalis 
thirty 		trisdešimt 
thirtieth 		trisdešimtas 
this 		ši(ta)s ši(ta) 
thorn 		dyglys dagys spyglys 
thorough 		kruopštus nuodugnus 
thoroughbred 		grynakraujis grynaveislis 
thoroughfare 		pagrindinė gatvė magistralė pravažiavimas 
thoroughgoing 		bekompromisinis beatodairiškas nepaisantis kliūčių 
thoroughly 		kruopščiai nuodugniai 
thou 		tu (pasen., poet.) 
though 		tačiau vis dėlto bet priešingai 
thought 		mintis mąstymas 
thousand 		tūkstantis 
thread 		siūlas 
threat 		grasinti 
threaten 		grasinti (with, to) 
threatening 		grasinąs grėsmingas 
three 		trys 
thresh 		plakti mušti kulti 
threshold 		slenkstis 
throat 		gerklė 
through 		per pro 
throw‐back 		judėjimas atgal grįžimas regresas 
throw away 		išmesti veltui nustoti 
throw off 		atmesti atstumti 
throw up 		pakelti (ranką, akis) 
thrush 		strazdas 
thrust 		stumti įbrukti durti 
thumb 		nykštys 
thumbnail 		nykščio nagas 
thunder 		griausmas perkūnas 
thus 		taip tuo būdu 
tick 		tiksėjimas 
ticket‐window 		kasa 
ticket 		bilietas etiketė skelbimas 
tickle 		kutenti 
tic douloureux 		trišakio nervo neuralgija 
tidbit 		pikantiška naujiena 
tide 		jūros potvynis ir atoslūgis 
tidy 		tvarkingas švarus 
tie 		(su)rišti perrišti (su)varstyti 
tie up 		surišimas ryšys sąjunga 
tiger 		tigras 
tight 		tankus standus suspaustas kompaktiškas 
tighten 		su(si)traukti suspausti 
tigress 		tigrė 
tilde 		riestinis kirtis 
tile 		čerpė koklis 
tile horizontal 		komp.) iškloti gulsčiai 
tile vertical 		(komp.) iškloti stačiai 
tilt 		palenkti pakreipti pasvirti 
timber 		rąstas sija 
time 		laikas 
time zone 		laiko juosta 
timekeeper 		laikininkas chronometražistas chronometrininkas tabelininkas 
timer 		laikininkas chronometruotojas 
timeout 		baigėsi laikas 
timetable 		tvarkaraštis grafikas planas 
tin 		alavas 
tinkle 		skambėjimas skambinimas 
tint 		atspalvis spalva 
tiny 		mažytis smulkutis 
tin plate 		skarda 
tip 		galiukas (plonas) viršūnė (kalno) 
tip of the day 		šios dienos patarimas 
tired 		pavargęs išvargęs 
tireless 		nenuilstamas nenuilstantis nepavargstantis 
tiresome 		nuobodus varginąs įkyrus 
titanium 		titanas 
title 		titulas vardas pavadinimas 
titmouse 		zylė 
to 		(parodo kryptį) į pas prie 
toad 		rupūžė 
toast 		skrebutis spirginta duonos riekė 
tobacco 		tabakas 
today 		šiandien 
toe 		pirštas (kojos) 
together 		kartu drauge 
together with 		kartu su 
toggle 		perjungiklis 
toilet 		tualetas išvietė 
token 		ženklas požymis žymė 
tolerate 		(pa)kęsti toleruoti 
tolerance 		pakanta pakantumas tolerancija 
toll 		muitas 
tomato 		pomidoras 
tomb 		kapas 
tomorrow 		rytoj 
tomorrow evening 		ryt vakare 
tomorrow morning 		ryt ryte 
ton 		tona 
tone 		tonas garsas 
toner cartridge 		(komp.) dažų kasetė 
tongs 		replės žnyplės 
tongue 		liežuvis 
tonsil 		migdolinė liauka 
too 		taip pat irgi 
tool 		įrankis priemonė 
toolbar 		(komp.) įrankių juosta 
tooltip 		(komp.) mygtuko etiketė 
tooth 		dantis 
tooth‐brush 		dantų šepetukas 
toothbrush 		dantų šepetėlis 
too much 		per daug 
top 		viršūnė viršus 
topic 		tema 
topical 		vietinės reikšmės 
topicality 		aktualumas 
torch 		žibintuvas žiburys 
torment 		kankinimas kančia 
torpedo 		torpeda 
torrent 		srovė srautas 
tortoise 		vėžlys 
torture 		kančia kankinimas 
total 		pilnas visas visiškas 
totally 		visiškai visai absoliučiai 
touch 		(pa)liesti (pa)lytėti 
tough 		kietas diržingas tamprus tąsus 
toughen 		kietėti diržti kietinti 
toughie 		(šnek.) užsispyręs, sunkiai sukalbamas žmogus kietakaktis 
tourism 		turizmas 
tourist agency 		turizmo agentūra 
tousle 		taršyti šiaušti 
tow 		kuodelis (linų, kanapių) pakulos 
toward 		link į 
towel 		rankšluostis 
tower 		bokštas tvirtovė 
town‐hall 		miesto tarybos rūmai rotušė 
town 		miestas miestelis 
township 		miesto rajonas priemiestis 
town hall 		miesto tarybos rūmai rotušė 
trace 		pėdsakas 
tracer 		sekiklis tyrėjas 
track 		takas pėdsakas vėžė glžk. bėgiai 
tractable 		sukalbamas paklusnus 
tractor 		traktorius 
trade‐union 		profsąjunga 
trade 		amatas profesija 
tradition 		paprotys tradicija 
traffic 		judėjimas eismas transportas 
tragic 		tragiškas baisus 
trailer 		vijoklis 
train 		mokyti auklėti treniruoti ruošti dresiruoti 
trainer 		treneris instruktorius 
trait 		charakteringas bruožas savybė 
trajectory 		trajektorija 
tram 		tramvajus vagonas 
tranquil 		ramus tylus 
transfer 		perdavimas perkėlimas 
transform 		pakeisti pertvarkyti transformuoti 
transformation 		pakeitimas 
transgress 		peržengti pažeisti prasižengti nusidėti 
transgression 		pažeidimas prasižengimas 
transitive 		pereinąs pereinamas 
translate 		(iš)versti 
transmit 		perduoti nusiųsti perleisti 
transparent 		skaidrus permatomas 
transport 		transportas gabenimas pervežimas 
transpose 		perkelti perstatyti sukeisti 
trap 		pinklės spąstai žabangai 
trash 		(amer.) atmatos padugnės 
trauma 		trauma 
traumatic 		trauminis sukeliantis traumą 
traumatize 		traumuoti 
travel 		keliauti vaikščioti eiti važiuoti kilnotis 
traveller 		keleivis 
travel agency 		kelionių agentūra 
tray 		padėklas 
treacherous 		išdavikiškas klastingas nepatikimas 
tread 		žengti minti 
treasure 		turtai brangenybės 
treat 		elgtis traktuoti 
treatment 		elgimasis veikimo būdas 
tree 		medis 
tremble 		drebėjimas drebulys 
trend 		(nu)krypti 
triage 		rūšiavimas 
trial 		bandymas išmėginimas 
triangle 		trikampis 
triangular 		trikampis 
tribe 		gentis giminė padermė 
tribunal 		tribunolas teismas 
tribute 		mokestis duoklė įnašas 
trick 		gudrybė apgaulė 
trifle 		niekai mažmožis niekniekiai 
trifling 		menkos vertės 
trim 		tvarkingas 
trip 		ekskursija, kelionė išvyka 
trite 		banalus nuvalkiotas 
triumph 		triumfas 
trolley 		vežimėlis stalelis su ratukais 
trollop 		nevala apsileidėlė 
trombone 		trombonas 
troop 		minia 
tropical 		tropinis 
trot 		greitas žingsnis risčia 
trouble 		rūpesčiai vargas bėda 
trough 		lovys gelda 
troupe 		trupė artistų grupė 
trousers 		kelnės 
trout 		upėtakis (žuvis) 
truce 		paliaubos 
truck 		vežimas 
truculent 		įžūlus šiurkštus agresyvus 
true 		tikras teisingas, teisus ištikimas 
truly 		tikrai iš tikrųjų 
trump 		koziris (kort.) 
trumpet 		trimitas 
truncate 		nukirsti nukapoti nupjauti 
trunk 		liemuo kamienas 
trust 		pa(si)tikėjimas 
trustworthy 		vertas pasitikėjimo 
try 		bandyti mėginti 
tub 		kubilas statinė 
tube 		vamzdis vamzdelis 
tug 		vilkti tempti traukti buksyruoti 
tummy 		pilvas (šnek.) pilvelis 
tumult 		triukšmas skandalas sujudimas 
tundra 		tundra 
tune 		melodija gaida 
tungsten 		volframas 
tunnel 		tunelis 
tup 		avinas 
turkey 		kalakutas 
turn 		sukti(s) pa(si)sukti (nu)kreipti 
turn off 		išjungti 
turnip 		ropė 
turnover 		apyvarta (prekių, lėšų) 
turn away 		pašalinti atleisti 
turn on 		atsukti (čiaupą) 
turn over 		apvirsti 
turn round 		apsisukti 
tusk 		iltis 
tussle 		grumtis peštis imtis 
tutor 		repetitorius (namų, privatus) mokytojas 
tutorage 		mokytojo ir auklėtojo darbas kuratoriaus pareigos 
tutoress 		kuratorė mokytoja ir auklėtoja 
tutorial 		auklėjimo ir mokymo 
tutorship 		auklėtojo/mokytojo pareigos 
tweak 		gnaibyti žnybti 
twelfth 		dvyliktas dvyliktoji dalis 
twelve 		dvylika 
twentieth 		dvidešimtas dvidešimtoji dalis 
twenty 		dvidešimt 
twig 		šakelė 
twin 		dvyniai dvynukai 
twine 		virvė šniūras 
twitter 		čiulbėti čirškėti čiauškėti 
two 		du 
two hundred 		du šimtai 
type 		tipas 
typewriter 		rašomoji mašinėlė 
typhus 		dėmėtoji šiltinė 
typical 		tipiškas 
typist 		mašininkė 
tyrant 		tironas despotas 
udder 		tešmuo 
ugly 		bjaurus šlykštus negražus 
ulcer 		opa piktžaizdė 
ultimate 		paskutinis galutinis 
ultimately 		pagaliau galų gale galiausiai 
umbrella 		skėtis 
umpire 		(trečiasis) teisėjas tarpininkas 
unaware 		nenujaučiantis nežinantis neįtariantis (of) 
unawares 		nelauktai netikėtai staiga 
uncertainty 		netikrumas 
uncertain 		netikras nepastovus 
uncle 		dėdė 
unclean 		nešvarus 
uncouple 		atkabinti išjungti 
uncover 		nusiimti kepurę, skrybėlę 
undelete 		(komp.) grąžinti pašalintą 
under 		po žemiau apačioje 
underlying 		nekrintantis į akis neryškus reikalaujantis gilios analizės 
undermine 		minuoti 
underneath 		apačioje žemiau apačion 
underpants 		apatinės kelnės 
understand 		suprasti, žinoti 
understanding 		protas supratimas suvokimas 
undertake 		pradėti imtis ko nors 
underwater 		povandeninis 
underway 		vykdomas 
underwear 		apatiniai baltiniai 
underwood 		pomiškis atžalynas brūzgynas 
underworld 		nusikaltėlių pasaulis 
underwrite 		pasirašyti 
underwriter 		draudimo agentas draudėjas 
underwritten 		žemiau pasirašęs 
undo 		atšaukti anuliuoti (kas buvo padaryta) 
undoubtedly 		be abejo tikrai 
undress 		nuvilkti nurengti nusirengti 
undulate 		garbanoti 
uneasy 		neramus sunerimęs susirūpinęs (about) 
unfair 		neteisingas nedoras nesąžiningas neobjektyvus šališkas 
unfairness 		neteisybė 
unfaithful 		neištikimas išdavikiškas 
unfortunately 		deja nelaimei 
ungrateful 		nedėkingas 
ungroup 		(komp.) išgrupuoti 
unhappy 		nelaimingas liūdnas 
unhide 		rodyti padaryti matomą 
uniform 		uniforma 
unimportant 		nesvarbus 
uninstall 		(komp.) pašalinti programą 
union 		sąjunga 
unique 		unikalus vienintelis 
unintelligible 		nesuprantamas neįskaitomas 
unit 		vienetas elementas 
unite 		su(si)vienyti su(si)jungti 
unity 		vieningumas vienybė 
universe 		pasaulis visata 
university 		universitetas 
unkind 		nemalonus piktas žiaurus 
unknown 		nežinomas nepažįstamas 
unlawful 		neteisėtas neįstatymiškas 
unlawfulness 		neteisėtumas 
unleash 		paleisti nuo saito išlaisvinti 
unless 		jeigu ne išskyrus kai nebent 
unload 		iškrauti 
unlock 		atrakinti 
unmarried 		nevedęs netekėjus 
unmarried woman 		netekėjusi moteris 
unpack 		išpakuoti iškrauti 
unpleasant 		nemalonus 
unprotect 		panaikinti apsaugą 
unroll 		iš(si)vynioti 
unsound 		netvirtas nesveikas liguistas 
unsubscribe 		atsisakyti prenumeratos 
untidy 		nešvarus netvarkingas 
untie 		atrišti paleisti 
until 		iki kol 
untitled 		bevardis 
unusual 		nepaprastas neįprastas retas 
unusable 		netinkamas nenaudojamas 
up 		aukštyn į viršų 
up‐to‐date 		išsilaikęs iki šio laiko 
update 		naujausios žinios 
upgrade 		naujovinimas atnaujinimas 
upload as 		nusiųsti kaip 
upholster 		aptraukti baldus 
upload 		išsiųsti 
upon 		ant 
upper 		viršutinis aukščiausias 
upper case 		(komp.) didžiosios raidės 
upset 		ap(si)versti 
upstairs 		(laiptais) aukštyn, viršun 
upward 		kylantis/nukreiptas į viršų 
upwardly 		aukštyn viršun 
upwards 		į viršų aukštyn 
uranium 		uranas 
urchin 		vaikėzas vaikigalis padauža 
urge 		raginti 
urgency 		būtinumas 
urgent 		primygtinis 
urine 		(med.) šlapimas 
us 		mums mus mumis 
usable 		vartojamas naudojamas galimas/tinkamas vartoti/naudoti 
use 		naudojimas(is) vartojimas (pri)taikymas 
used to 		būti įpratusiam 
useful 		naudingas 
useless 		nenaudingas netinkamas 
use up 		išeikvoti išnaudoti 
user 		vartotojas naudotojas 
user defined 		naudotojo apibrėžtas 
user information 		duomenys apie abonentą 
user name 		abonento vardas 
usual 		paprastas įprastas 
usually 		paprastai 
uterus 		gimda įsčios (anat.) 
utilize 		utilizuoti panaudoti 
utter 		visiškas absoliutus 
vacant 		laisvas vakuojantis 
vacation 		atostogos 
vaccinate 		skiepyti 
vagina 		makštis vagina 
vain 		tuščias bergždžias 
vale 		(poet.) slėnys 
valiant 		šaunus narsus 
valid 		turįs galios galiojąs 
validate 		patvirtinti ratifikuoti pagrįsti 
validity 		pagrįstumas svarumas 
validation 		patvirtinimas ratifikavimas 
valise 		sakvojažas kuprinė 
valley 		slėnys 
valorous 		šaunus narsus 
valuable 		vertingas brangus 
value 		vertingumas 
valve 		vožtuvas 
vanilla 		(bot., kul.) vanilė 
vanish 		dingti (iš)nykti pranykti prapulti 
vanity 		tuštybė 
variable 		nepastovus kintamas 
variable char width 		(komp.) kintamas rašmenų/simbolių plotis 
varied 		įvairus 
variety 		įvairumas 
various 		(su daiktavardžio daugiskaita) daugelis įvairūs 
varnish 		lakas 
vary 		keistis įvairuoti 
vase 		vaza (amer.) 
vast 		platus didžiulis 
vastitude 		didumas 
vastly 		(šnek.) labai žymiai 
vat 		kubilas statinė 
vault 		skliautas 
vaulted 		skliautinis skliautuotas 
veal 		veršiena 
vegetable 		daržovės 
vegetate 		augti vegetuoti (perk.) 
vehicle 		vežimas ekipažas transporto priemonės 
veil 		šydas vualis 
vein 		vena kraujo indas kraujagyslė 
velocity 		greitumas greitis 
velvet 		aksomas 
vena 		vena 
vend 		pardavinėti prekiauti 
vendor 		pardavėjas prekiautojas 
vengeance 		kerštas 
ventilate 		vėdinti ventiliuot 
ventilator 		ventiliatorius 
venture 		rizikingas sumanymas užmačia 
venue 		susirinkimo/susitikimo vieta 
verb 		veiksmažodis 
verbal 		žodinis sakytinis pažodinis verbalinis 
verbally 		žodžiu (ne raštu) 
verbatim 		pažodinis 
verdict 		sprendimas (teismo) 
verge 		kraštas riba (perk.) 
verge of a road 		prie pat kelio ribos 
verify 		patikrinti 
verse 		eilėraštis poezija 
vertebra 		(stuburo) slankstelis stuburas 
vertical 		vertikalus 
vertical scrollbar 		(komp.) stačioji slankjuostė 
very 		tikras tas pats 
very much 		labai labai daug 
very well 		labai gerai puikiai 
vessel 		indas 
vest 		liemenė apatiniai marškiniai 
vex 		erzinti pykinti 
via 		per 
viability 		gaivumas gajumas 
viable 		gyvastingas 
viaduct 		viadukas pralaida 
vibrate 		vibruoti skambėti virpėti svyruoti 
vibration 		vibracija svyravimas virpėjimas 
vicar 		vikaras (bažn.) 
vice 		yda trūkumas (charakterio) 
vicious 		klaidingas nepagrįstas bjaurus ydingas 
victory 		pergalė nugalėjimas 
view 		vaizdas 
viewer 		žiūrovas televizijos žiūrovas 
viewpoint 		požiūris 
vigour 		jėga energija 
vile 		bjaurus šlykštus 
villa 		vila 
village 		kaimas 
villager 		kaimietis kaimo gyventojas 
vine 		vynmedis vijoklinis augalas 
vinegar 		actas 
violate 		prievartauti 
violation 		pažeidimas prasižengimas žaidimo taisyklėms 
violent 		stiprus smarkus 
violently 		smarkiai labai 
violin 		smuikas 
viper 		gyvatė 
virgin 		nekalta mergaitė 
virginal 		skaistus nekaltas 
virtual 		beveik visiškas 
virus 		virusas 
visa 		viza 
visible 		matomas aiškus 
vision 		regėjimas 
visit 		lankyti 
visitor 		svečias lankytojas 
vista 		perspektyva (perspektyvinis) vaizdas 
visual 		regimasis regėjimo vizualus 
visualization 		vizualizacija ryškus regimasis vaizdas 
visualize 		įsivaizduoti 
visually 		vizualiai iš pažiūros 
vital 		gyvybinis (biol. t.p.) vitalinis 
vitality 		gyvybingumas gyvybiškumas gyvybinė jėga 
vitalize 		įkvėpti gyvybę pagyvinti atgaivinti 
vitally 		gyvybiškai nepaprastai 
vivid 		ryškus aiškus 
vividly 		gyvai ryškiai 
vividness 		gyvumas ryškumas 
vixen 		lapė (patelė) 
vocabulary 		žodynas 
vocation 		pašaukimas palinkimas polinkis (for) 
vocational 		profesinis 
vodka 		degtinė 
voice 		balsas 
void 		tuščias negaliojąs 
volatile 		kintamas nepastovus besikeičiantis 
volcano 		ugnikalnis vulkanas 
volley 		salvė kruša (priekaištų, keiksmų) 
voltage 		el. įtampa 
volume 		apimtis talpumas tūris masė 
volume label 		(komp.) tomo vardas 
vomit 		vemti išsiveržti (apie ugnikalnį) 
vote 		balsavimas balsas 
vote down 		atmesti 
vote out 		neišrinkti 
voter 		rinkėjas 
vow 		įžadas priesaika 
vowel 		balsis balsė 
voyage 		kelionė (jūra) skridimas (lėktuvu) 
vulgar 		neskoningas vulgarus 
vulnerability 		sužeidžiamumas 
vulnerable 		sužeidžiamas 
vulture 		maitvanagis 
wadding 		vata pakulos medžiaga kam užkimšti 
wade 		(per)bristi braidžioti 
wage 		alga darbo užmokestis 
wager 		lažybos pastatytoji suma (lošiant) 
wail 		dejavimas dejonė rauda 
wainscot 		panelis (sienoms apkalti) 
waist 		juosmuo talija 
waistcoat 		liemenė 
wait 		laukti (for) 
waiter 		padavėjas 
waiting‐room 		laukiamasis (kambarys) 
wait for 		įtaisyti žabangus spąstus (perk.) 
wake 		kilvateris pėdsakas 
walk 		ėjimas žingsniavimas 
wall 		siena 
wallet 		piniginė 
wallflower 		geltonžiedė smalka (bot.) 
wallpaper 		sienų apmušalai tapetai 
walnut 		graikiškasis riešutas riešutmedis 
wand 		dirigento lazdelė magiškoji lazdelė 
wander 		klajoti keliauti bastytis 
wane 		mažėti nykti 
wanna 		(sutr.) want to want a ... 
want 		stoka trūkumas būtinas reikalas reikalingumas 
war 		karas 
ware 		dirbiniai 
warfare 		karas kariavimas 
warm 		šiltas karštas 
warn 		įspėti perspėti 
warning 		įspėjimas perspėjimas 
warrant 		įgaliojimas 
warrantee 		asmuo, kuriam duodama garantija 
warranty 		užtikrinimas garantija 
warrior 		karys kovotojas 
wart 		karpa 
wash 		prausimas(is) mazgojimas 
washed-out 		išblukęs 
wasp 		vapsva 
waste 		eikvojimas nudėvėjimas nuniokojimas 
watch 		laikrodis (kišeninis ar rankinis) 
watchmaker 		laikrodininkas 
watchword 		šūkis lozungas 
watch out for 		saugotis 
watch over 		saugoti 
water 		vanduo 
waterfall 		krioklys 
watermark 		vandenženklis 
wave 		banga banguota linija mojimas 
waver 		svyruoti 
wax 		vaškas vaškinis 
way 		kelias kryptis pusė nuotolis 
way out 		išeitis 
wayfarer 		keliautojas pakeleivis 
we 		mes 
weak 		silpnas neryžtingas (perk.) 
weaken 		silpnėti silpninti 
wealth 		turtai lobis gausumas 
wealthy 		turtingas 
weapon 		ginklas 
wear 		nešioti dėvėti(s) sudėvėti pratrinti 
weary 		nuvargęs nuvargintas (of) 
wearying 		varginąs 
wear off 		nu(si)trinti nudilti 
wear out 		išsitrinti iš(si)dėvėti išsekti 
weasel 		žebenkštis 
weather 		oras oro stovis 
weave 		austi pinti 
web layout 		(komp.) tinklalapio maketas 
wed 		su(si)tuokti 
wedding 		vedybos sutuoktuvės 
wedge 		pleištas 
weed 		piktžolė 
Wednesday 		trečiadienis 
weekend 		savaitgalis savaitgalio poilsis 
week 		savaitė 
week day 		darbo diena 
whole words only 		tik ištisų žodžių 
whopping 		(šnek.)pyla, (su)mušimas 
weekly 		kas savaitę (kartą) per savaitę savaitinis savaitraštis 
weep 		verkti apverkti raudoti ašaroti 
weigh 		pa(si)sverti sverti 
weighing machine 		svarstyklės (stambios) 
weight 		svoris svarstis svarmuo krovinys našta (perk.) 
weir 		užtvanka vandens slenkstis 
weird 		keistas antgamtinis 
welcome 		sveikas! sveiki! 
well 		šulinys šaltinis (perk.) 
wench 		mergina merga 
west 		vakarai vakaris vėjas 
wet 		šlapias lietingas 
whale 		banginis 
wharf 		prieplauka 
what 		kas koks kokia kokie 
whatever 		bet kuris kas bebūtų kuris 
wheat 		kviečiai 
wheel 		ratas tekinis 
wheelbarrow 		karutis 
wheezy 		dusulingas sergąs astma 
when 		kada kai 
where 		kur kame 
whereas 		tada kai tuo tarpu 
which 		kuris 
while 		laikas valandėlė 
whilst 		kol 
whim 		užgaida įnoris įgeidis 
whinny 		tylus žvengimas (arklio) 
whip 		botagas 
whirl 		sukimas(is) skriejimas 
whiskey 		viskis 
whisky 		viskis degtinė 
whisper 		šnabždesys kuždesys šnibždėjimas 
whispering 		šnabždėjimas(is) šnabždesys 
whistle 		švilpimas švilpukas 
white 		baltas baltumas baltymas 
whither 		paskyrimo vieta kur link 
who 		kas kuris 
whole 		visas sveikas 
whole numbers 		sveikieji skaičiai 
wholesale 		didmeninė prekyba pardavimas urmu 
wholly 		visiškai 
whom 		ką kam 
why 		kodėl kaip 
wick 		dagtis knatas 
wide 		erdvus platus 
widget 		(šnek.) nematytas/keistas daiktelis/dalykėlis 
widow 		našlė 
widower 		našlys 
width 		platumas platuma plotis 
wife 		žmona 
wig 		perukas 
wild 		laukinis 
willing 		pasiruošęs norįs 
willingness 		pasiruošimas pasiryžimas 
willow 		gluosnis karklas 
willowy 		lankstus liaunas 
win 		išlošti laimėti užkariauti nugalėti 
wind 		vėjas 
wind scale number 		balas 
winding 		vingiavimas vingis išlanka išlinkis 
window 		langas 
windpipe 		kvėpuojamoji gerklė 
wind up 		užsukti (laikrodį) apvynioti 
wine 		vynas 
wing 		sparnas 
winged 		sparnuotas greitas (perk.) 
winter 		žiema 
win back 		atgauti atsilošti susigrąžinti 
win over 		palenkti savo pusėn 
wipe 		šluostyti valyti 
wipe off 		nušluostyti nubraukti ištrinti 
wipe out 		nušluostyti nuplauti sunaikinti 
wire 		viela laidas 
wireless 		bevielis 
wisdom 		išmintis 
wise 		išmintingas 
wish 		noras pageidavimas linkėjimas 
witch 		ragana burtininkė 
with 		su kartu su 
withdraw 		atsiimti atšaukti atsitraukti nueiti 
wither 		(nu)vysti (su)džiūti (su)džiovinti 
within 		viduje ribose 
without 		be 
withstand 		priešintis spirtis išlaikyti 
witness 		liudininkas liudijimas 
witty 		sąmojingas 
wizard 		burtininkas kerėtojas 
woe 		nelaimė sielvartas 
wolf 		vilkas 
woman 		moteris 
womb 		(anat.) gimda (perk.) įsčios 
women 		moterys 
wonder 		stebėtis norėti žinoti 
wonderful 		nuostabus puikus 
wonted 		įprastas paprastas 
woo 		pirštis garbinti (moterį) 
wood 		miškas 
wool 		vilna 
word 		žodis 
word count 		(komp.) statistika 
wording 		parinkimas suformulavimas redakcija formuluotė 
work‐room 		darbo kambarys kabinetas 
work 		darbas veikimas veikla 
working 		dirbantis veikiantis darbinis 
workman 		darbo žmogus dirbantysis 
worksheet 		mokomoji medžiaga užduotys (atskiruose lapuose) 
workshop 		cechas dirbtuvė 
work out 		paruošti (planus) spręsti (uždavinius) sudaryti pasiekti 
world 		pasaulis 
worm 		kirmėlė 
worry 		nerimas rūpestis vargas 
worse 		blogesnis 
worship 		garbinimas dievinimas 
worth 		vertė 
worthless 		nieko nevertas 
worthy 		vertas nusipelnęs 
wound 		žaizda 
wrangle 		ginčas barnis 
wrap 		apsiaustas skara (kailinė) pelerina 
wrapper 		apsiaustas chalatas viršelis 
wrapping style 		(komp.) apgaubimo stilius 
wrap text 		(komp.) skaidyti tekstą 
wreathe 		apsiausti apsupti apsivynioti (apie ką) 
wrench 		truktelėjimas timptelėjimas išplėšimas išnirimas 
wrestle 		eiti imtynių imtis 
wretched 		nelaimingas apgailėtinas 
wrinkle 		raukšlė 
wrist 		riešas 
write 		rašyti 
writer 		rašytojas 
write down 		užrašyti 
write protected 		(komp.) apsaugota nuo rašymo 
writhe 		raitytis (iš skausmo) sudarkyti iškreipti 
writing 		rašymas 
writing down 		užrašymas 
writing out 		išrašymas išsirašymas 
writing pad 		bloknotas 
writing-desk 		rašomasis stalas 
wrong 		neteisingas neteisus klaidingas neatitinkąs netinkamas 
X-axis 		(mat.) abscisių ašis 
X-ray 		rentgeno spinduliai 
xenophobe 		ksenofobas, žmogus, neapkenčiantis svetimšalių 
xenophobia 		ksenofobija, nemėgimas visko, kas užsienietiška, neapykanta svetimšaliams 
xerox 		dauginimo aparatas „Kseroksas“ 
xylograph 		medžio raižinys 
xylographer 		medžio raižytojas 
xylography 		ksilografija 
xylophone 		(muz.) ksilofonas 
xylophonist 		ksilofonistas 
y'all 		(amer. šnek.) jūs visi 
Y-axis 		(mat.) ordinačių ašis 
yacht 		jachta 
yacht-club 		jachtų klubas 
yachting 		buriavimas (sportas, t.p. yachting sport), plaukiojimas jachta 
yachtsman 		jachtos savininkas 
yachtswoman 		jachtos savininkė 
yah 		et!, eik jau!, a jau!, he! (reiškiant pajuoką/niekinimą) 
Yahweh 		Jahvė (judaizmo dievas) 
Yakut 		jakutas 
yammer 		skųstis, niurzgėti, verkšlenti 
yang 		vyriškasis pradas (kinų filosofijoje) 
yank 		trūktelėjimas 
Yankee 		(džn. niek.) jankis, amerikietis 
yankeefied 		suamerikonėjęs 
yap 		kiauksėjimas, amsėjimas, viauksėjimas, vampsėjimas kiauksėti, amsėti, ambryti, vampsėti, viauksėti 
yapp 		minkštas odinis (knygos) viršelis 
yard 		jardas ( = 91,44 cm) 
yarmulke 		šašbauda, šlikas (žydų kepurė) 
yarn 		verpalai, siūlas, gija, skaidula 
yashmak 		(arab.) čadra (musulmonių veido apdangalas) 
yatter 		(šnek.) pliaukšti, taukšti, ≈ liežuviu malti 
yaw 		(jūr., av.) nukrypimas nuo kurso, pokrypis, vingiavimas 
yawn 		žiovulys žiovavimas 
year‐book 		metraštis 
yea 		pritarimas, teigiamas atsakymas 
year 		metai 
year-round 		(veikiantis, trunkantis, daromas) ištisus metus 
yearling 		vienerių metų, vienmetis 
yearlong 		trunkantis vienerius metus, vienerių metų, metinis 
yearly 		kasmetinis 
yearn 		ilgėtis, kankintis (for, after) 
yearning 		ilgesys (for) 
yeast 		mielės, raugas 
yeasty 		mielinis, mielių, mielėtas 
yegg 		(amer. sl.) įsilaužėlis, keliaujantis vagis/plėšikas (t.p. yegg man) 
yell 		šauksmas, klyksmas, riksmas 
yellow 		geltonas, pageltęs 
yellow-belly 		(šnek.) bailys 
yellow-flag 		(geltona) karantino vėliava 
yellow-painted 		geltonai dažytas 
yellow-skinned 		geltonodis 
yellowish 		gelsvas 
yellowness 		geltonumas, geltonis 
yellowy 		gelsvas 
yelp 		viauktelėjimas, amtelėjimas, inkštimas 
Yemen 		Jemenas (Afrikos valstybė) 
yen 		jena (Japonijos piniginis vienetas) 
yenta 		(amer. šnek.) liežuvautoja, liežuvininkė 
yep 		(amer. šnek.) taip 
Yerevan 		Jerevanas (Armėnijos sostinė) 
yes 		taip taigi 
yes-man 		(šnek.) pataikūnas, šunuodegautojas, asmuo, kuris visada pritaria 
yes-vote 		balsas „už“ 
yesterday 		vakar vakarykštė diena 
yet 		dar vis dar 
yid 		(niek.) žydas 
Yiddish 		jidiš 
Yiddisher 		asmuo, kalbantis jidiš 
yield 		derlius 
yin 		moteriškasis pradas (kinų filosofijoje) 
yock 		(amer. šnek.) kvatojimas 
yoghourt 		rūgusis pienas jogurtas 
yoghurt 		rūgusis pienas jogurtas 
yoga 		(ind.) joga 
yogi 		(ind.) jogas 
yokefellow 		partneris, porininkas 
yokemate 		partneris, porininkas 
yolk 		trynys 
yoo-hoo 		ei! (atkreipiant dėmesį) 
yonder 		ten tenai štai ten 
you 		jūs tu jums tau jus tave 
young 		jaunas nepatyręs ankstyvas 
youngish 		apyjaunis, jaunyvas 
youngster 		paauglys, jaunuolis, berniukas jaunis 
younker 		paauglys, jaunuolis, berniukas jaunis 
your 		jūsų tavo 
yours 		jūsų tavo tavasis 
yourself 		save pats save 
youth 		jaunystė 
youthen 		jauninti(s), pa(si)jauninti 
youthful 		jaunatviškas, jaunas, jaunuoliškas 
yowl 		staugimas, kaukimas, klyksmas 
yuan 		juanis (Kinijos piniginis vienetas) 
yucky 		(šnek.) šlykštus, bjaurus 
yurt 		jurta 
Zaire 		Zairas (Afrikos valstybė) 
Zambia 		Zambija (Afrikos valstybė) 
zany 		(ist.) juokdarys, dzanis (italų komedijos personažas) kvailys, keistuolis (juokingas, paikas, juokdariškas) 
Zanzibar 		Zanzibaras (Afrikos miestas ir sala) 
zap 		kas nors pritrenkiantis, patraukiantis dėmesį, efektingas, gyvumas, efektas 
zapper 		(šnek.) distancinis valdymas 
zappy 		(šnek.) patraukiantis dėmesį, krintantis į akis, gyvas, efektingas 
zeal 		uolumas, stropumas, atsidėjimas, užsidegimas, aistra 
zealot 		fanatikas, uolus/atsidavęs šalininkas 
zealotry 		fanatizmas, uolumas 
zealous 		uolus, stropus, atsidėjęs, aistringas, karštas 
zebra 		(zool.) zebras 
zebra 		(zool.) zebras 
Zen 		(rel.) dzenbudizmas (t.p. Zen Buddhism) 
zenith 		zenitas 
zephyr 		(poet.) švelnus šiltas vėjelis, zefyras 
Zeppelin 		(ist.) cepelinas, dirižablis 
zero 		nulis 
zest 		susidomėjimas, užsidegimas, įkarštis 
zestful 		pikantiškas 
Zeus 		(mit.) Dzeusas 
zigzag 		zigzagas 
zilch 		(šnek.) nulis, ničniekas 
zillion 		(šnek.) nesuskaitoma daugybė, begalė(s) (of) 
Zimbabwe 		Zimbabvė (Afrikos valstybė) 
zimmer 		vaikštynė (invalidams, t.p. zimmer frame/aid) 
zinc 		cinkas 
zincography 		cinkografija 
zing 		zvimbimas, švilpesys 
zingara 		čigonė 
Zingaro 		(tik v.) čigonas 
zingy 		(šnek.) smarkus 
Zionism 		sionizmas 
Zionist 		sionistas 
zip 		užtrauktukas 
zip-up 		užsegamas užtrauktuku 
zipper 		(ypač amer.)  užtrauktukas 
zippered 		užsegamas užtrauktuku 
zippo 		(amer. šnek.) nulis, ničniekas 
zippy 		(šnek.)  energingas, smarkus, gyvas, žvalus 
zit 		(ypač amer.) (šnek.) spuogas 
zizz 		(šnek.) snustelėjimas, nusnūdimas 
zloty 		zlotas (Lenkijos piniginis vienetas) 
zodiac 		(astr.) Zodiakas 
zodiacal 		(astr.) Zodiako 
zombie 		(rel.) zombis, antgamtiškos jėgos atgaivintas numirėlis (Afrikoje, Vest Indijoje, JAV pietuose) 
zone 		zona 
zoo 		zoologijos sodas 
zoological 		zoologinis, zoologijos 
zoologist 		zoologas 
zoology 		zoologija 
zoom 		zvimbimas 
zoom in 		didinti 
zoom out 		mažinti 
zounds 		(po) šimts pypkių! 
zucchini 		(ypač amer.) (bot.) cukinija 
Zurich 		Ciurichas (Šveicarijos miestas) 
