ABC 		abc alfabet 
Abyssinia 		Abessinië 
Abyssinian 		Abessinies 
Achilles 		Achilles 
Achilles' 		Achilleshiel 
Achilles' 		Achillespees 
Adam 		Adam 
Adam's 		adamsappel komhalertjie 
Aden 		Aden 
Adonis 		Adonis 
Adriatic 		Adriatiese See 
Adriatic 		Adriatiese See 
Aegean 		Egeïese Zee 
Aegean 		Egeïese Zee 
Afghan 		Afgaans 
Afghanistan 		Afganistan 
Africa 		Afrika 
African 		Afrikaans 
African 		afrikanertjie 
Afrikaans 		Afrikaans 
Afrikaner 		Afrikaner Boer 
Afro‐Asian 		Afro‐Asiaties 
Aix‐la‐Chapelle 		Aken 
Albania 		Albanië 
Albanian 		Albaans Albanees Albanies 
Albanian 		Albanies Albaniese taal 
Albion 		Albion 
Alexandria 		Alexandrië 
Algeria 		Algerië 
Algerian 		Algeryns 
Algiers 		Algiers 
Allah 		Allah 
All 		Allerheilige 
All 		Allerheilige 
All 		Allersiele 
Alpenrose 		alperoos 
Alpinist 		alpinis bergbeklimmer 
Alps 		Alpe 
Alsatian 		Elsasies 
Amazon 		Amasone 
America 		Amerika 
American 		Amerikaans 
Americanize 		amerikaniseer 
American 		Indiaan Rooihuid 
Anatolia 		Anatolië 
Andalusia 		Andalusië 
Anglican 		Anglikaans 
Anglo‐Saxon 		Angel‐Saksies 
Angola 		Angola 
Annunciation 		Annunsiasie 
Antarctic 		Antarktika 
Antarctic 		Suidelike Yssee 
Antichrist 		antichris 
Antilles 		Antille 
Antony 		Antonius 
Apocalypse 		Apokalips Openbaring 
April 		April 
Arab 		Arabier 
Arabia 		Arabië 
Arabian 		Arabies 
Arabic 		Arabies 
Arctic 		Noordpool 
Arctic 		Yssee 
Ardennes 		Ardenne 
Areopagus 		Areopagus 
Argentina 		Argentinië 
Argentine 		Argentyns 
Argentinean 		Argentyns 
Argus 		Argus 
Aristotle 		Aristoteles 
Ark 		Ark van die Verbond 
Armenia 		Armenië 
Armenian 		Armenies 
Aryan 		Aries 
Ascension 		Hemelvaartdag 
Ash 		Asdag 
Asia 		Asië 
Asian 		Asiaties 
Asiatic 		Asiaties 
Asia 		Anatolië 
Assyria 		Assirië 
Assyrian 		Assiries 
Athena 		Athene 
Athene 		Athene 
Athenian 		Atheens 
Athens 		Athene 
Atlantic 		Atlantiese Oseaan 
Atlantic 		Atlantiese Oseaan 
Atlas 		Atlas 
Attic 		Atties 
Augean 		Augiasstal 
Augeas 		Augias 
August 		Augustus 
Augustus 		Augustus 
Aurora 		Aurora 
Australia 		Australië 
Australian 		Australies 
Austria 		Oostenryk 
Austrian 		Oostenryks 
Aztec 		Astekies 
Baal 		Baäl 
Babel 		Babel 
Babylon 		Babel 
Babylonia 		Babilonië 
Babylonian 		Babilonies 
Bacchus 		Bacchus 
Balearic 		Baleare Baleariese Eilande 
Balkans 		Balkan 
Baltic 		Balties 
Baltic 		Baltiese See Oossee 
Bantu 		Bantoe‐ 
Barbery 		Barbarye 
Basque 		Baskies 
Batavian 		Bataaf Bataviaan Batavier 
Bavaria 		Beiere 
Bavarian 		Beiers 
Bedouin 		swerwer woestynbewoner 
Belgian 		Belgies 
Belgium 		België 
Belgrade 		Belgrado 
Benedictine 		Benediktyner Benediktynermonnik 
Benedictine 		Benediktyner Benediktynermonnik 
Benelux 		Benelux 
Bengal 		Bengale 
Beotia 		Beosië 
Berlin 		Berlyn 
Berliner 		Berlyner 
Berne 		Bern 
Bethlehem 		Betlehem 
Bible 		Bybel 
Black 		Swart See 
Bloemfontein 		Bloemfontein 
Bluebeard 		Bloubaard 
Boer 		Afrikaner Boer 
Bohemia 		Boheme 
Bohemian 		Boheems 
Bolivia 		Boliwië 
Bolivian 		Boliwies 
Bolshevik 		Bolsjewiek Bolsjewis 
Bombay 		Bombaai 
Brabant 		Brabant 
Brabantine 		Brabants 
Brazil 		Brasilië 
Brazilian 		Brasiliaans 
Bretagne 		Bretagne 
Britain 		Groot‐Brittanje 
British 		Brits 
Briton 		Brit 
Brittany 		Bretagne 
Brunswick 		Brunswyk 
Brussels‐sprouts 		Brusselse spruitjies 
Brussels 		Brussel 
Bucharest 		Boekarest 
Buddha 		Boeddha 
Buddhism 		Boeddhisme 
Buddhist 		Boeddhist 
Bulgar 		Bulgaar 
Bulgaria 		Bulgarye 
Bulgarian 		Bulgaars 
Burma 		Birma 
Burmese 		Birmees 
Bushman 		Boesman 
Byzantine 		Bisantyns 
Byzantium 		Bisantium 
Caesar 		Caesar 
Cain 		Kain 
Cairo 		Kaïro 
California 		Kalifornië 
Calvary 		Kalvarieberg Kruisberg 
Calvin 		Calvyn 
Cameroon 		Kameroen 
Canada 		Kanada 
Canadian 		Kanadees 
Canary 		Kanaries 
Canary 		Kanariese Eilande 
Candlemas 		Maria‐ligmis Vrouedag 
Canterbury 		klokkie koppies‐en‐pierings mariëteklokke 
Canticles 		Hooglied 
Cape 		Kaaps 
Cape 		Kaapprovinsie die Kaapprovinsie 
Cape 		Kaapstad 
Cape 		Kaap die Goeie Hoop 
Capitol 		Kapitool 
Capricorn 		Steenbok 
Carmelite 		Karmeliet 
Carpathians 		Karpate 
Carpathian 		Karpate 
Carthage 		Carthago 
Carthaginian 		Carthager 
Caspian 		Kaspiese See 
Castillian 		Kastiliaans 
Catholic 		katoliek 
Catholisism 		katolisisme 
Caucasus 		Kaukasus 
Celebes 		Celebes 
Celt 		Kelt 
Celtic 		Kelties 
Ceylon 		Ceylon 
Chile 		Chili 
Chilean 		Chileens 
China 		China Sjina 
Chinaman 		Chinees 
Chinese 		Chinees Sjinees 
Christ 		Christus 
Christian 		Christelik 
Christianity 		Christendom 
Christian 		doopnaam voornaam 
Christmas 		Kersfees Kersmis 
Christmas 		Kersfees Kersmis 
Christmas 		kersboom 
Cinderella 		Asepoestertjie 
Cologne 		Keulen 
Columbus 		Columbus 
Confucius 		Confucius 
Congo 		Kongo 
Copenhagen 		Kopenhagen 
Corinthian 		Korinthies 
Crete 		Kreta 
Crimea 		Krim die Krim 
Croat 		Kroaat 
Croatia 		Kroasië 
Croatian 		Kroaties 
Cuba 		Kuba 
Cuban 		Kubaan 
Cupid 		Amor 
Curaçao 		Curaçao 
Cypriot 		Cipries 
Cypriote 		Cipries 
Cyprus 		Ciprus 
Czech 		Tsjeggies 
Czechoslovak 		Tsjeggies 
Czechoslovakia 		Tsjeggo‐Slowakye 
Czechoslovakian 		Tsjeggies 
Dane 		Deen 
Danish 		Deens 
Danube 		Donau 
Dardanelles 		Dardanelles Hellespont 
Day 		Versoendag 
December 		Desember 
Denmark 		Denemarke 
Deuteronomy 		Deuteronomium 
Dominican 		Dominikaans 
Dorian 		Dories 
Doric 		Dories 
Drakensberg 		Drakensberge 
Dutch 		Hollands 
Dutchman 		Hollander 
East 		ooste 
Easter 		Paasfees Pase 
East 		Oos‐Duitsland 
Eden 		Eden 
Edinburgh 		Edenburg 
Egypt 		Egipte 
Egyptian 		Egipties 
England 		Engeland 
English 		Engels 
Englishman 		Engelsman 
English 		Engels 
Epiphany 		Driekoninge Driekoningefees 
Eskimo 		Eskimo 
Esperantist 		esperantis 
Esperanto 		Esperanto 
Estonia 		Estland 
Estonian 		Ests 
Ethiopia 		Ethiopië 
Ethiopian 		Ethiopiër 
Etruria 		Etrurië 
Etrurian 		Etruries Etruskies 
Etruscan 		Etruries Etruskies 
Euphrates 		Eufraat 
Europa 		Europa 
Europe 		Europa 
European 		blanke witmens 
European 		Europese bison 
Euxine 		Swart See 
Eva 		Eva 
Evening 		Aandster Venus 
Exodus 		Eksodus 
Father 		Kersvader 
Feast 		Versoendag 
February 		Februarie 
Finland 		Finland 
Finn 		Fin Finlander 
Finnish 		Fins 
Flanders 		Vlaandere 
Flemming 		Vlaming 
Flemmish 		Vlaams 
Flushing 		Vlissingen 
France 		Frankryk 
Franconia 		Frankeland 
Frankish 		Frankies 
French 		Frans 
French 		Frans Franse taal 
Friday 		Vrydag 
Friesland 		Friesland 
Frisian 		Fries 
GDR 		Oos‐Duitsland 
Gaelic 		Kelties 
Galician 		Galicies 
Gaul 		Gallië 
Genesis 		Genesis 
Geneva 		Geneve 
Genoa 		Genua 
German 		Duits 
Germanic 		Germaans 
Germany 		Duitsland 
German 		Duits Duitse taal 
German 		Duitse masels rooihond 
Ghent 		Gent 
God 		God 
God's 		begraafplaas begraafplek 
Golden 		Gulde Vlies 
Gold 		Goudkus 
Golgotha 		Kalvarieberg Kruisberg 
Good 		Goeie Vrydag 
Gothic 		Goties 
Grail 		Graal 
Great 		Groot‐Brittanje 
Greece 		Griekeland 
Greek 		Grieks 
Greenland 		Groenland 
Guelder 		balroos 
Guinea 		Guinee 
Gypsy 		sigeuner 
Haiti 		Haïti 
Havana 		Havanna 
Hawaii 		Hawaiï 
Hawaiian 		Hawaïes 
Hebrew 		Hebreeus 
Hebrides 		Hebride 
Hellenian 		Grieks Helleens 
Hellenic 		Grieks Helleens 
Hellespont 		Dardanelles Hellespont 
Helvetia 		Helvesië Switserland 
Highlander 		Hooglander 
Hindu 		Hindoe‐ Hindoes 
Holland 		Holland 
Hollander 		Hollander 
Hungarian 		Hongaars 
Hungary 		Hongarye 
Iberian 		Iberies 
Iceland 		Ysland 
Icelander 		Yslander 
Icelandic 		Yslands 
India 		Indië 
Indian 		Indies 
Indian 		mielies 
Indo‐China 		Agter‐Indië Indo‐China Indo‐Sjina 
Indo‐European 		Indo‐Europees 
Indo‐Germanic 		Indo‐Europees Indo‐Germaans 
Indonesia 		Indonesië 
Indonesian 		Indonesies 
Ionian 		Ionies 
Iran 		Iran Persië 
Iranian 		Iranies 
Iraq 		Irak 
Iraqi 		Iraaks 
Iraquian 		Iraaks 
Ireland 		Ierland 
Irish 		Iers 
Irishman 		Ier 
Islam 		Islam Mohammedanisme 
Islamic 		Islamities Mohammedaans Slams 
Israel 		Israel 
Israeli 		Israelies 
Israelian 		Israelies 
Israelite 		Israelities 
Israelitish 		Israelities 
Istanbul 		Istanboel Konstantinopel 
Italian 		Italiaans 
Italy 		Italië 
Jamaica 		Jamaika 
January 		Januarie 
Japan 		Japan 
Japanese 		Japannees Japans 
Java 		Java 
Javan 		Javaans 
Javanese 		Javaans 
Jehovah 		Jehova 
Jerusalem 		Jerusalem 
Jew 		Hebreër Israeliet Jood 
Jewish 		Hebreeus 
Johannesburg 		Johannesburg 
Jordan 		Jordaan 
Joseph 		Josef 
Jove 		Jupiter 
July 		Julie 
June 		Junie 
Jupiter 		Jupiter 
Kenya 		Kenia 
Kremlin 		Kremlin 
Krishna 		Krisjna 
Lady 		Annunsiasie 
Lapland 		Lapland 
Laplander 		Lap Laplander 
Lapp 		Laplands 
Lappish 		Laplands 
Latin 		Latyns 
Latvia 		Letland 
Latvian 		Lets 
Lebanon 		Libanon 
Lett 		Let 
Lettish 		Lets 
Leyden 		Leiden 
Liberia 		Liberië 
Libya 		Libië 
Libyan 		Libies 
Lisbon 		Lissabon 
Lithuania 		Litaue 
Lithuanian 		Litaus 
Livonia 		Lyfland 
Livonian 		Lyflands 
Liège 		Luik 
London 		Londen 
Lorraine 		Lotaringe 
Lothringen 		Lotaringe 
Low 		Nederduits Platduits 
Lucerne 		Lusern 
Lucifer 		Lucifer 
Macedonia 		Macedonië 
Machiavelli 		Machiavelli 
Madagascar 		Madagaskar 
Madonna 		Madonna Moedermaagd 
Madrid 		Madrid 
Malacca 		Malakka 
Malay 		Maleis Slams 
Malta 		Malta 
Maltese 		Maltees 
Manchuria 		Mantsjoerye 
March 		Maart 
Mars 		Mars 
Mauretanian 		Moors 
May 		Mei 
Mecca 		Mekka 
Melanesia 		Melanesië 
Melanesian 		Melanesies 
Mexican 		Mexikaans 
Mexico 		Mexiko 
Miss 		juffrou Mej. Mejuffrou 
Mister 		heer Meneer Mnr. 
Monday 		Maandag 
Mongolia 		Mongolië 
Montenegrin 		Montenegryns 
Montenegro 		Montenegro 
Moor 		Moor 
Moorish 		Moors 
Moresque 		Moors 
Moroccan 		Marokkaans 
Morocco 		Marokko 
Moscow 		Moskou 
Mozambique 		Mosambiek 
Mr. 		heer Meneer Mnr. 
Mrs. 		dame Mev. Mevrou 
Muscovite 		Moskowiet 
Namibia 		Namibië 
Namur 		Namen 
Ndebele 		Ndebele 
Negro 		swarte 
New 		Nuwejaarsdag 
Nguni 		Nguni 
Nigeria 		Nigeria 
North 		Noord‐Amerika 
Norway 		Noorweë 
Norwegian 		Noors Noorweegs 
November 		November 
Occident 		Aandland Awendland 
October 		Oktober 
Orange 		Oranje 
Orange 		Oranje‐Vrystaat Vrystaat 
Oriental 		oostelik 
Paris 		Parys 
Parthian 		aandeel deel gedeelte stuk 
Peiping 		Peking 
Peking 		Peking 
Persia 		Iran Persië 
Persian 		Iraniër 
Persian 		Persiese Golf 
Philippine 		Filippyns 
Philistine 		Filistyn 
Pietermaritzburg 		Pietermaritzburg 
Poland 		Pole 
Pole 		Pool 
Polish 		Pools 
Portuguese 		Portugees 
Portuguese 		Portugees 
Pretoria 		Pretoria 
Prussian 		berlynsblou 
Pyrenees 		Pireneë 
Red 		Indiaans 
Rhine 		aak 
Romania 		Roemenië 
Romanian 		Roemeen Roemeniër 
Rome 		Rome 
Russia 		Rusland 
Russian 		Russies 
Sabbath 		Saterdag 
Saint 		Sint Helena 
Sardinian 		Sardinies 
Sassenach 		Engelsman 
Satan 		Lucifer Satan 
Saturday 		Saterdag 
Scot 		Skot 
Scotland 		Skotland 
Scotsman 		Skot 
Scottish 		Skots 
September 		September 
Serb 		Serwies 
Serbia 		Serwië 
Siamese 		Siamees 
Slovak 		Slowaaks Slowakies 
Slovakia 		Slowakye 
Slovene 		Sloween 
Slovenia 		Slovenië 
Slovenian 		Sloweens 
Song 		Hooglied 
Song 		Hooglied 
South 		Suid‐Afrika 
South 		Suid‐Afrikaans 
South 		Suid‐Amerika 
Spain 		Spanje 
Spanish 		Spaans 
Spanish 		Spaans Spaanse taal 
Sudan 		Soedan 
Sunday 		Sondag 
Swede 		Sweed 
Sweden 		Swede 
Swedish 		Sweeds 
Swiss 		Switser 
Switzerland 		Switserland 
T‐shirt 		T‐hemp 
TV 		beeldradio televisie TV 
TV 		televisiestel 
Teuton 		Germaan 
Teutonic 		Germaans 
Thursday 		Donderdag 
Transkei 		Transkei die Transkei 
Transvaal 		Transvaal 
Transvaalian 		Transvaals 
Tuesday 		Dinsdag 
Turk 		Turk 
Turkey 		Turkye 
Turkish 		Turks 
Twelfth‐night 		Driekoninge Driekoningefees 
‐in‐law 		aangetroud 
‐less 		‐loos 
USA 		Amerika VSA 
US 		Amerikaner 
Ukraine 		Oekraine 
Ukrainian 		Oekrains 
United 		Amerika VSA 
Vaal 		Vaal 
Valhalla 		Walhalla 
Vatican 		Vatikaan 
Venezuela 		Venezuela 
Venezuelan 		Venezolaans 
Venus 		Venus 
Vienna 		Weens 
Viennese 		Weens 
Vietnamese 		Vietnamees 
Volga 		Wolga 
Wales 		Wallis 
Wallonia 		Waleland 
Wednesday 		Woensdag 
Welsh 		Wallies 
Welshman 		Walliser 
Western 		Hebride 
Xhosa 		Xhosa‐ 
Xhosa 		Xhosavrou 
Yule 		Kersfees 
Zaire 		Kongo 
Zambia 		Zambia 
Zeus 		Zeus 
Zimbabwe 		Zimbabwe 
Zulu 		Zoeloe 
Zulu 		Zoeloe 
... 		... gelede 
... 		... a 
a 		in binne op per 
aardwolf 		aardwolf 
aa 		aä‐lawa 
abacus 		abakus 
abandon 		verlaat 
abandoned 		immoreel 
abandonment 		afstand 
abase 		verneder 
abashed 		bedees 
abashment 		benardheid 
abate 		verminder 
abatement 		agteruitgang 
abattoir 		abattoir 
abbess 		abdis 
abbey 		abdy 
abbot 		ab 
abbreviate 		bekort 
abbreviation 		bekorting 
abdicate 		abdikeer 
abdication 		abdikasie afstand 
abdomen 		abdomen agterlyf 
abdominal 		abdominaal 
abduct 		ontvoer 
abductor 		afvoerder 
aberrance 		afwyking 
aberration 		afwyking 
abet 		agiteer beroer 
abetter 		handlanger 
abhorrence 		aakligheid afgryse afskrik 
abhorrent 		afskuwelik 
abide 		verwag wag wag vir 
abiding 		aanhoudelik aanhoudend permanent vas 
ability 		bekwaamheid 
abject 		beroerd 
abjuration 		afswering 
abjure 		afsweer 
ablative 		ablatief 
able 		bekwaam 
abnegate 		afsweer 
abnormal 		abnormaal 
abnormality 		afwyking 
abnormity 		afwyking anomalie 
abode 		woning 
abolish 		afskaf 
abolition 		afskaffing 
abominable 		afskuwelik 
abomination 		aakligheid 
aboriginal 		binnelands inheems 
abort 		aborteer 
abortion 		aborsie 
abortionist 		aborteur 
abortive 		vrugteloos 
about 		belangende 
above‐board 		eerlik 
above‐mentioned 		bogenoemd 
above 		benoorde 
above 		veral 
abridge 		begrens bepaal beperk 
abridgement 		oorsig 
abrogate 		afskaf 
abrogation 		afskaffing 
abscess 		abses 
abscond 		weghardloop 
absence 		absensie afwesigheid 
absent 		absent 
absentee 		afwesige 
absent 		aftrek vertrek 
absinth 		absint 
absolute 		absoluut 
absolutely 		sowaar 
absolute 		alleenheerskapy 
absolute 		alleenheerskapy 
absolute 		alleenheerser 
absolution 		begenadiging vergifnis 
absolutism 		absolutisme 
absorption 		absorpsie 
abstemious 		besadig 
abstract 		abstrak 
abstruse 		misterieus 
absurd 		absurd 
absurdity 		absurditeit 
abundant 		oorgenoeg 
abuse 		beledig 
abuse 		ampsmisdryf 
abusive 		beledigend 
abut 		belend 
abutment 		beer 
abysmal 		afskuwelik 
abyss 		afgrond 
acacia 		akasia 
academic 		student 
academician 		akademielid 
academy 		akademie 
acanthus 		akant beerklou 
acceleration 		akselerasie 
accelerator 		akselerator 
accelerator 		akselerator 
accent 		aksentueer beklemtoon 
accentuate 		aksentueer beklemtoon 
accent 		aksent aksenteken 
accept 		aanneem aanvaar aksepteer neem 
acceptable 		aanneembaar aanneemlik aanvaarbaar akseptabel 
acceptance 		aanvaarding 
accepted 		aangenome 
acceptor 		aanvaarder akseptant 
access 		aanval 
accessible 		toeganklik 
accessory 		sekondêr 
accidence 		morfologie 
accident 		ongeluk 
accidental 		aksidenteel 
acclaim 		akklamasie 
acclamation 		akklamasie 
acclimate 		akklimatiseer 
acclimatization 		akklimatisasie akklimatisering 
acclimatize 		akklimatiseer 
accommodating 		behulpsaam 
accommodation 		akkommodasie 
accomodate 		afsluit beëindig eindig 
accompaniment 		akkompanjement 
accompanist 		akkompanjis begeleider begeleier 
accompany 		akkompanjeer begelei 
accomplice 		handlanger 
accomplish 		behaal bereik presteer 
accomplished 		ervare 
accomplishment 		daad 
accord 		akkoord ooreenkoms ooreenstemming 
accordance 		akkoord ooreenkoms ooreenstemming 
accordingly 		dus gevolglik 
according 		volgens 
according 		volgens 
accordion 		akkordeon 
accost 		toespreek 
account 		verduideliking 
accountable 		verantwoordelik 
accountant 		rekenmeester 
accounting 		boekhou 
account 		register 
account 		verduidelik 
accoutrement 		akkomodasie uitrusting 
accoutrements 		akkomodasie uitrusting 
accredit 		akkrediteer 
accrue 		afstam 
accumulate 		akkumuleer 
accumulation 		akkumulasie 
accumulator 		akkumulator battery 
accuracy 		akkuraatheid 
accurate 		akkuraat 
accusal 		aanklag 
accusation 		aanklag 
accusative 		akkusatief 
accuse 		aankla aanklaag aanklae 
accused 		beklaagde 
accuser 		aanklaer 
accustom 		gewoond wees 
ace 		aas 
acerbic 		skerp 
acetone 		aseton 
acetylene 		asetileen 
ache 		seer wees 
ache 		verlang na 
achievable 		haalbaar 
achieve 		behaal verwerf 
achievement 		aksie daad 
acknowledge 		beken 
acknowledgement 		bekentenis 
acme 		apogeum 
acne 		akne 
acolyte 		adep 
aconite 		akoniet 
acorn 		akker 
acoustic 		akoesties 
acoustics 		akoestiek 
acquaint 		in kennis stel 
acquaintance 		bekendheid 
acquiesce 		berus 
acquiescence 		berusting 
acquire 		behaal verwerf 
acquisition 		aankoop 
acquisitive 		begerig belus gretig 
acquittal 		kwytskelding 
acre 		acre 
acrobat 		akrobaat 
acrobatic 		akrobaties 
acronym 		akroniem 
across 		dwarsdeur 
across 		jeens teen vir 
act 		ageer optree 
acting 		toneelspel 
actinium 		aktinium 
action 		aksie 
activate 		aktiveer 
active 		bedrywig 
activist 		aktivis 
activity 		aksie 
actor 		akteur 
actress 		aktrise 
actual 		effektief 
actuality 		werklikheid 
actually 		sowaar 
actuary 		aktuaris 
actuate 		beweeg roer 
act 		bemiddel 
act 		amnestie 
acuity 		aandag ag attensie 
acute 		intens 
ad 		aandiening aankondiging advertensie 
adagio 		adagio 
adapt 		aanpas adapteer 
adaptable 		aanpasbaar 
add 		byvoeg toevoeg 
adder 		adder 
addition 		bylae 
additional 		ekstra 
addled 		bedorwe 
address 		adresseer 
addressee 		geadresseerde 
addressing 		adresseermasjien 
address 		adresboek 
adept 		adep 
adequate 		adekwaat 
adherence 		aanhanklikheid 
adherent 		adep 
adherents 		aanhang 
adhesive 		kleefband 
adieu 		adieu 
adjacent 		belendend 
adjectival 		adjektiwies 
adjective 		adjektief 
adjoin 		belend 
adjoining 		aangrensend 
adjunct 		bylae 
adjust 		aanpas adapteer 
adjustment 		akkoord beskikking 
administer 		administreer 
administer 		bedien bereg 
administration 		administrasie 
administration 		beregting 
administrative 		administratief 
administrator 		administrateur 
admiral 		admiraal 
admire 		bewonder 
admission 		aanvaarding 
admit 		beken 
admixture 		allegaartjie mengsel 
admonish 		aanmaan 
admonition 		aanmaning 
ado 		lawaai ophef 
adolescence 		puberteit 
adopted 		aangenome 
adoption 		adopsie 
adoptive 		adoptief 
adorable 		aanbidbaar aanbiddelik 
adoration 		aanbidding 
adore 		aanbid adoreer 
adorer 		aanbidder 
adornment 		sieraad 
adrenaline 		adrenalien adrenaline 
adroit 		bedrewe behendig kunstig 
adult 		volwasse 
adumbration 		afskaduwing 
advance 		aandag vestig op 
advantage 		voordeel 
advantageous 		gunsteling‐ 
adventitious 		sekondêr 
adventure 		avontuur 
adventurer 		avonturier 
adventurous 		avontuurlik 
adverb 		adverbium bywoord 
adverbial 		adverbiaal bywoordelik 
adversary 		vyand 
adverse 		teenoorgesteld 
advert 		ag slaan op oppas 
advertence 		aandag ag attensie 
advertency 		aandag ag attensie 
advertise 		aandien aankondig aansê adverteer annonseer meld 
advertisement 		aandiening aankondiging advertensie 
advertiser 		aankondiger 
advice 		aanrading advies raad 
advise 		aanraai adviseer 
advise 		afraai 
advocate 		advokaat 
aerial 		antenne 
aerodrome 		lughawe vliegveld 
aerodynamic 		aërodinamies 
aerodynamics 		aërodinamika 
aerogramme 		lugposbrief 
aeroplane 		vliegtuig 
afar 		ver 
affable 		vriendelik 
affair 		affêre affêring ding saak 
affect 		aandoen 
affected 		behep met 
affecting 		aandoenlik 
affection 		aandoening emosie 
affectionate 		aanhanklik 
affiliation 		verwantskap naverwantskap verwantskapsbetrekking 
affined 		geparenteer verwant 
affinity 		affiniteit 
affirm 		seker maak sertifiseer verseker 
affirmation 		belofte 
affix 		affiks agtervoegsel 
afflict 		bedroewe bedroef beproef beproewe 
afflicted 		behep met 
affliction 		beproewing 
affluent 		ryk 
afford 		afwerp oplewer produseer 
afoot 		te voet 
afraid 		bang bedug 
afresh 		alweer weer 
after 		agter 
afternoon 		agtermiddag 
afterwards 		daarna later 
again 		alweer weer 
against 		jeens teen vir 
agate 		agaat 
age 		ouderdom 
agency 		agentskap 
agenda 		agenda 
agent 		agent 
agglomerate 		agglomeraat 
aggregate 		aggregaat 
aggression 		aggressie 
aggressive 		aggressief 
aggressor 		aanvaller 
aggro 		aggressie 
agile 		lewendig 
agitate 		agiteer beroer 
agitated 		bedug benoud 
agitation 		beroering 
agitator 		aktivis 
agnostic 		agnosties 
agog 		nuuskierig 
agonizing 		afgryslik 
agony 		angst 
agoraphobia 		agorafobie 
agrarian 		agrariër boer landbouer 
agree 		afspreek 
agreeable 		aangenaam behaaglik heerlik lekker 
agreeably 		lekker 
agreed 		top 
agreement 		akkoord ooreenkoms ooreenstemming 
agree 		saamstem met 
agricultural 		agronomies 
agricultural 		landbouskool 
agriculture 		akkerbou landbou 
agriculturist 		agronoom 
agrimony 		akkermonie 
agronomics 		agronomie 
ague 		koors 
ah 		a aag aai ag 
ahead 		voorheen vroeër 
ai 		ai 
aid 		assistent 
ailing 		bekwaald 
ailment 		kwaal siekte 
aim 		bedoel beoog 
air‐balloon 		aërostaat 
air 		lug 
aircraft 		vliegtuig 
airdrome 		lughawe vliegveld 
airfield 		lughawe vliegveld 
airless 		bedompig 
airmail 		lugpos 
airman 		aviateur 
airplane 		vliegtuig 
airport 		lughawe 
airs 		allure 
airy 		dun 
air 		lugposbrief 
akin 		geparenteer verwant 
alabaster 		albas 
alacrity 		begerigheid 
alarm 		alarmeer 
alarmclock 		wekker 
alarming 		benouend 
alas 		a foei tog jammer 
alb 		albe 
albatross 		albatros 
albino 		albino 
album 		album 
alchemist 		alchemis 
alchemy 		alchemie 
alcohol 		alkohol 
alcoholic 		alkoholies 
alcoholic 		alkoholgehalte 
alcoholism 		alkoholisme 
aldehyde 		aldehide aldehied 
alder 		els elsboom 
ale 		bier 
alert 		lewendig 
alga 		alg alge 
algebra 		algebra 
algebraic 		algebraïes 
alibi 		alibi 
alien 		afskuwelik 
alike 		ewe 
alimony 		alimentasie 
all‐knowing 		alwetend 
all 		allerhande allerlei 
allegoric 		allegories 
allegory 		allegorie 
allergic 		allergies 
allergy 		allergie 
alliance 		alliansie 
alligator 		alligator 
alliteration 		alliterasie 
allow 		laat 
alloy 		alliasie allooi 
alluvial 		alluviaal 
alluvion 		alluvie alluvio alluvium 
alluvium 		alluvie alluvio alluvium 
all 		allerweë alom oral 
all 		skielik 
all 		alles al's 
all 		alweer weer 
all 		allerhande allerlei 
all 		allerhande allerlei 
all 		alleman almal elke elkeen 
all 		ewe 
all 		intusse solank tegelyk 
all 		intusse 
almanac 		almanak 
almond 		amandel 
almonership 		aalmoesenierskap 
almonry 		aalmoeseniershuis 
almost 		alhaas amper byna 
alms‐box 		aalmoeskassie 
alms 		aalmoes 
almshouse 		aalmoeseniershuis 
aloe 		aalwee aalwyn 
aloetic 		aalweeagtig aalwynagtig 
aloe 		aalwynsap 
aloe 		aalwyntapper 
aloin 		aalwynbitter 
alone 		alleen allenig enigste 
alongside 		langs 
alpaca 		alpakka 
alpha 		alfa 
alphabet 		abc alfabet 
alphabetical 		alfabeties 
alpine 		Alpien Alpinies Alpyns 
already 		al klaar reeds alreeds 
also 		ook 
altar 		altaar 
altarpiece 		altaarstuk 
alter 		verander 
alternative 		alternatief 
although 		alhoewel 
alto 		alt altsanger altstem 
altogether 		alles al's 
altruism 		altruïsme 
altruist 		altruïs 
altruistic 		altruïsties 
alum 		aluin 
aluminium 		aluminium 
aluminum 		aluminium 
always 		altoos altyd steeds 
amaranthus 		amarant 
amateur 		amateur 
amateurish 		amateuragtig 
amaze 		verbaas 
amazing 		wonderbaarlik 
ambassador 		ambassadrise 
amber 		amber 
ambition 		ambisie 
ambitious 		ambisieus 
ambrosia 		ambroos ambrosyn 
ambulance 		ambulans 
ambush 		agterlaag 
amen 		amen 
amend 		amendeer 
amendment 		amendement amendering 
amethyst 		ametis 
ammeter 		ampèremeter 
ammonia 		ammoniak 
ammunition 		ammunisie 
amnesty 		begenadig 
amoeba 		amebe 
among 		tussen 
amorphous 		amorf 
amortize 		afskryf amortiseer 
amount 		aantal 
amount 		bedra 
amphibian 		amfibie 
amphitheatre 		amfiteater 
amphora 		amfora 
amplitude 		amplitude 
amputate 		afsit amputeer 
amputation 		afsitting amputasie 
ampère 		ampère 
amuck 		amok 
amulet 		amulet 
amuse 		amuseer 
amusement 		amusement vermaak 
amusing 		amusant 
an 		'n 
ana 		anna 
anachronism 		anachronisme 
anaconda 		anakonda 
anaemia 		anemie 
anaemic 		anemies 
anaesthesist 		narkotiseur 
anagram 		anagram 
anal 		anaal 
analogous 		analoog 
analogy 		analogie 
analyse 		analiseer 
analysis 		analise 
analyst 		analis 
analytical 		analis 
anapaest 		anapes 
anarchic 		anargies 
anarchical 		anargies 
anarchism 		anargisme 
anarchist 		anargies 
anarchy 		anargie 
anatomical 		anatomies 
anatomist 		anatoom 
anatomy 		anatomie 
anchor 		anker 
anchorage 		ankerplek 
anchovy 		ansjovis 
ancient 		antiek 
and 		en 
and 		ensovoorts 
anecdotal 		anekdoties 
anecdote 		anekdote 
anemone 		anemoon 
anew 		alweer weer 
angina 		angina 
angle 		hoek 
angler 		hengelaar 
anguilliform 		aalvormig 
anguish 		angst 
aniline 		aniline 
animal 		dier 
anise 		anys 
anna 		anna 
annex 		annekseer 
annexation 		anneksasie 
annotate 		annoteer 
annotation 		kommentaar 
announce 		aandien aankondig aansê adverteer annonseer meld 
announcement 		bekendmaking berig kennisgewing 
annual 		jaarliks 
annul 		afsê annulleer kanselleer 
anode 		anode 
anomaly 		afwyking anomalie 
anonymity 		anonimiteit 
anonymous 		anoniem 
anonymous 		anonymus 
another 		ander 
answer 		antwoord 
antelope 		antiloop 
antenna 		antenne 
anthracite 		antrasiet 
anthropologist 		antropoloog 
anthropology 		antropologie 
anti‐Semite 		antisemiet 
anti‐Semitic 		antisemities 
anti‐Semitism 		antisemitisme 
anticipate 		antisipeer 
anticipation 		antisipasie 
antidote 		antidoot teengif 
antimony 		antimonium antimoon 
antipode 		antipode 
antique 		antiek 
antiseptic 		antisepties bederfwerend 
antisocial 		antisosiaal 
antithesis 		teenstelling 
anus 		aars anus 
anvil 		aambeeld 
anxious 		bedug benoud 
any 		iemand enigiemand 
anybody 		iemand enigiemand 
anything 		iets enigiets 
anywhere 		êrens 
any 		enige tyd 
an 		'n uur se stap 
aorta 		aorta 
apache 		apache 
apart 		afsonderlik afsydig apart 
apartheid 		apartheid 
apartment 		appartement woonstel 
apart 		behalwe 
apathetic 		apaties 
apathy 		apatie 
ape‐like 		aapagtig 
ape 		aap 
aphasia 		afasie 
aphorism 		aforisme 
apish 		aapagtig 
apocalypse 		apokalips 
apocalyptic 		apokalipties 
apocryphal 		apokrief 
apoplectic 		apopleksie beroerte 
apostasy 		afval 
apostate 		afvallig 
apostatize 		afval 
apostle 		apostel 
apostleship 		apostelskap apostolaat 
apostolate 		apostelskap apostolaat 
apostolic 		apostolies 
apostrophe 		afkappingsteken apostroof 
apotheosis 		apoteose 
apparatus 		apparaat toestel 
appeal 		appelleer 
appeal 		aanroep oproep 
appear 		verskyn 
appearance 		aanblik aansien aansig air aspek 
appear 		lyk skyn 
appease 		kalmeer 
appellation 		benaming naam 
appendicitis 		appendisitis 
appetite 		aptyt 
applaud 		apploudiseer 
apple‐sauce 		appelmoes 
apple‐tart 		appeltert 
apple‐tree 		appelboom 
apple 		appel 
apply 		toepas 
appoint 		aanstel 
appointment 		aanstelling 
appointment 		agenda 
appointment 		aanstelling 
appraise 		begroot 
appreciate 		waardeer 
apprehension 		aanhouding arrestasie 
approach 		benader nader 
appropriate 		geskikt 
approval 		akklamasie 
approximate 		benader 
approximately 		by benadering omtrent so sowat 
apricot‐tree 		appelkoosboom 
apricot 		appelkoos 
aptitude 		begaafdheid 
aquamarine 		akwamaryn 
aquarium 		akwarium 
aqueduct 		akwadukt 
aquiline 		arendsneus 
arabesque 		arabesk 
arbutus 		aarbeiboom 
arbutus 		aarbeiboomvrug 
arch‐enemy 		aartsvyand 
archaeological 		argeologies 
archaeologist 		argeoloog 
archaeology 		argeologie 
archaic 		argaïes 
archaism 		argaïsme 
archangel 		aartsengel 
archbishop 		aartsbiskop 
archbishopric 		aartsbisdom 
archduchy 		aartshertogdom 
archduke 		aartsherog 
archipelago 		argipel 
architect 		argitek 
architectonic 		argitektuur 
architectural 		argitektuur 
architrave 		argitraaf 
archivist 		argiefbewaarder argivaris 
are 		are 
area 		area gebied oppervlakte 
arena 		arena 
argon 		argon 
argue 		beredeneer 
argument 		argument 
aria 		aria 
arise 		opstaan styg 
aristocracy 		aristokrasie 
aristocrat 		aristokraat 
aristocratic 		aristokraties 
ark 		ark 
arm 		arm 
armchair 		leunstoel 
armour 		bepantser 
armoury 		arsenaal 
army 		leër 
army 		aalmoesenier 
arnica 		arnika 
aroma 		aroma 
arrack 		arak 
arrange 		bedissel beredder beskik reël 
arrangement 		akkoord beskikking 
arrears 		agterstand 
arrest 		arresteer 
arrested 		arrestant 
arrival 		koms aankoms 
arrive 		aankom aanland arriveer beland 
arrogant 		arrogant 
arrow 		pyl 
arrowroot 		araroet 
arse 		aars anus 
arsenal 		arsenaal 
art 		kuns 
arteriosclerosis 		aarverkalking arteriosklerose 
artery 		arterie 
artesian 		artesies 
arthritis 		artritis 
artichoke 		artisjok 
article 		artikel 
artificial 		kunstig 
artillery 		artillerie 
artilleryman 		artilleris 
artisan 		ambagsman 
artist 		artis kunstenaar 
artistic 		kunstig 
art 		kunsgalery 
arum 		aronskelk 
as 		as hoe so lyk soos 
asbestos 		asbes 
ascend 		opstaan styg 
ascent 		beklimming 
ascetic 		asketies 
aseptic 		asepties 
ash 		as 
ashamed 		beskaamd 
ask 		vra 
ask 		vra 
ask 		wonder 
asparagus 		aspersie 
aspect 		aanblik aansien aansig air aspek 
aspen 		abeel 
asphalt 		asfalteer 
aspidistra 		aspidistra 
aspiration 		aansoek 
aspire 		aansoek doen ambieer 
aspire 		aansoek doen ambieer 
ass 		donkie esel groutjie 
assailant 		aanvaller 
assault 		aanval 
assaulter 		aanrander 
assemblage 		vergadering 
assemble 		saamgaan 
assent 		bevestig 
assertion 		bewering 
assessment 		aanslag belastingaanslag 
assign 		daag 
assigned 		taak 
assimilate 		assimileer 
assist 		assisteer help 
assistant 		assistente 
assistent 		assistent 
associate 		aansluit 
association 		vereniging 
assure 		seker maak sertifiseer verseker 
aster 		aster 
asterisk 		asterisk 
asteroid 		asteroïed asteroïde 
asthma 		aamborstigheid asma 
asthmatic 		aamborstig asmaties 
asthmatic 		asmalyer 
astonishing 		wonderbaarlik 
astrologer 		astroloog 
astrology 		astrologie 
astronomer 		astronoom 
astronomic 		astronomies 
astronomical 		astronomies 
astronomy 		astronomie 
asylum 		asiel toevlugsoord 
asymmetric 		asimmetries 
asymmetrical 		asimmetries 
as 		so ... soos 
as 		asof 
as 		na beliewe 
as 		ten opsigte van 
as 		aartsdom 
as 		asof 
as 		ten opsigte van 
at 		aan na na ... toe toe vir 
atavism 		atavisme 
atelier 		ateljee 
atheism 		ateïsme 
atheist 		ateïs 
athlete 		atleet 
athletic 		atleties 
athletics 		atletiek 
atlas 		atlas 
atmosphere 		atmosfeer 
atmospheric 		atmosferies 
atoll 		atol 
atom 		atoom 
atomic 		atomies 
atomic 		atoomenergie 
atomic 		atoomgewig 
atom 		A‐bom atoombom 
atrophy 		atrofie 
attach 		bepaal vasmaak vasstel 
attachment 		aanhanklikheid 
attack 		aanval 
attacker 		aanvaller 
attain 		behaal verwerf 
attempt 		poging 
attend 		verpleeg 
attendance 		bediening 
attention 		aandag ag attensie 
attentive 		aandagtig attent 
attentively 		aandagtig aandagtiglik 
attitude 		houding 
attract 		aanlok bekoor 
attraction 		aanloksel aas 
attractive 		aanloklik aantreklik 
attractiveness 		aanloklikheid aantreklikheid 
attune 		aanpas adapteer 
at 		heeltemal 
at 		aaneen agtereen 
at 		aanvanklik 
at 		tuis 
at 		uiteindelik 
at 		altans 
at 		snags 
at 		dadelik 
at 		a pari 
at 		nou tans 
at 		eendag eers 
at 		aldaar daar 
at 		agteraan 
at 		aanvanklik 
at 		betyds op tyd 
at 		tegelyk 
aubade 		aubade 
aubergine 		brinjal eiervrug 
auctioneer 		afslaer 
audit 		kontroleer 
auditorium 		aula 
auditory 		auditorium 
aum 		aam 
aunt 		tant 
aurochs 		oeros 
author 		skrywer 
authority 		gesag 
autobus 		bus 
autocracy 		alleenheerskapy 
autocrat 		alleenheerser 
autonomic 		onafhanklik 
autonomous 		onafhanklik 
autumn 		herfs 
avail 		baat 
available 		beskikbaar 
avenue 		allee 
average 		gemiddeld medium 
aversion 		antipatie 
aviator 		aviateur 
avidity 		begerigheid 
avoid 		vermy 
await 		verwag wag wag vir 
award 		bekroon 
awareness 		besef besinning 
away 		ver 
awful 		afskuwelik 
awfully 		verskriklik vreeslik 
axiom 		aksioma aksioom 
azalea 		asalea 
azimuth 		asimut 
a 		'n paar enige enkele sommige 
a 		ewe 
a 		nogal taamlik 
a 		geruime tyd lank 
a 		baie 
a 		baie 
a 		ewe 
a 		ewe 
baboon 		bobbejaan 
baby 		baba babetjie 
back‐door 		agterdeur 
back 		rug 
backbiting 		agterklap beskindering 
background 		agtergrond 
backside 		agterent agterste 
backward 		agteroor 
backwardness 		agterlikheid 
backwards 		agteruit agterwaarts 
back 		agteras 
back 		agterhoof 
back 		agterent 
back 		agterbank 
back 		agterbuurt agterwyk 
back 		agterstevoor 
back 		agterwiel 
bacterium 		bakterie 
bad 		beroerd kwaai sleg 
badger 		ratel 
badly 		sleg 
bad 		aakligheid 
bag 		tas 
baggage 		bagasie 
bairn 		kind 
bake 		bak 
bakelite 		bakeliet 
baker 		bakker 
balcony 		balkon 
baldachin 		baldakyn 
bale 		baal 
ball‐frame 		abakus rekenraam telraam 
ball 		bal 
ballad 		ballade 
ballade 		ballade 
ballast 		ballast 
ballerina 		ballerina balletdanseres 
ballet 		ballet 
ballet 		ballerina balletdanseres 
ballet 		ballerina balletdanseres 
ballistics 		ballistiek 
balloon 		aërostaat 
balm 		balsem 
balsam 		balsem 
balustrade 		balustrade 
bamboo 		bamboes 
banality 		banaliteit 
banana 		banana piesang 
band 		bende skare 
bandage 		verband 
bandit 		bandiet 
bands 		bef 
banisters 		balustrade 
banjo 		banjo 
bank‐note 		noot 
bank 		bank 
banker 		bankier 
banking 		bankrekening 
bankrupt 		bankrot 
bankruptcy 		bankrot 
bank 		bankrekening 
bank 		bankier 
bank 		bankier 
bank 		bankier 
banner 		vlag 
banquet 		banket 
baobab 		apebroodboom baobab 
baptism 		doop 
baptist 		Baptis 
bar 		afsluit afsper 
barbarian 		barbaar 
barbaric 		barbaars 
barbarism 		barbarisme 
barbarity 		barbaarsheid 
barbarousness 		barbaarsheid 
barbecue 		braai 
barbel 		babel 
barber 		barbier 
barberry 		berberis 
bard 		bard 
barely 		amper ampertjies bekwaald skaars 
bargain 		afding beknibbel 
barge 		aak 
baritone 		bariton 
barium 		barium 
bark 		skil 
barn 		barak 
barometer 		barometer 
baron 		baron vryheer 
baroness 		barones 
barony 		baronie 
barrack 		barak 
barrel 		buis 
barricade 		barrikadeer 
barrier 		barrière 
barring 		behoudens 
barrister‐at‐law 		advokaat 
barrister 		advokaat 
bas‐relief 		bas‐relief 
basalt 		basalt 
basement 		kelder 
bashfulness 		bedeesheid 
basic 		basies 
basil 		basilikum 
basilica 		basiliek basilika 
basin 		bassin 
basket 		mandjie 
basketball 		basketbal 
bass 		baars 
baste 		bedruip 
bastion 		bastion 
bath 		bad badkuip 
bathing‐sponge 		badspons 
bathing‐suit 		baaiklere baaikostuum badklere badkostuum badpak 
bathing 		baaihokkie badhokkie 
bathing 		baaiklere baaikostuum badklere badkostuum badpak 
bathroom 		badkamer 
baton 		stok 
battalion 		bataljon 
battery 		akkumulator battery 
battle 		geveg 
bauxite 		bauxiet 
bay 		baai 
bayonet 		bajonet 
bazaar 		basaar bazaar mark 
be 		wees 
beach 		strand 
beacon 		baak baken 
bead 		kraal 
beak 		bek snawel 
beam 		radio 
bear 		staan uithou 
beard 		baard 
bearskin 		beremus 
bearskin 		beremus 
bear 		afstewen 
bear 		bekostig 
beast 		bees dier 
beastly 		beesagtig 
beast 		roofdier 
beautiful 		deftig mooi 
beautiful 		skone 
beauty 		skone 
because 		aangesien deurdat omdat 
because 		weens 
become 		raak word 
become 		afstomp 
becoming 		geskikt 
bed‐clothes 		beddegoed 
bed 		bedding 
bedding 		beddegoed 
bedridden 		bedlêend 
bedroom 		slaapkamer 
bedspread 		bedsprei 
bedstead 		bababed 
beech 		beuk 
beef 		beesvleis 
beefsteak 		kruisskyf 
beer 		bier 
beet 		beet 
beetroot 		beetsuiker 
beet 		beetsuiker 
befit 		behoor behoort betaam 
befog 		benewel 
before 		voor 
beg 		bedel 
beggar‐woman 		bedelares bedelvrou 
beggar 		bedelaar 
begging 		bedelary bedelry 
begin 		aanvang begin instel 
beginner 		aanvanger beginneling beginner 
beginning 		aanvang begin 
begonia 		begonia 
begrudge 		bejammer 
beguine 		begyn begyntjie 
behave 		gedra hom 
behavior 		houding 
behaviour 		houding 
behind 		agteraan 
behind 		in die geheim 
beige 		beige 
believe 		ag glo meen 
bell‐wether 		belhamel 
bell 		bel 
belladonna 		belladonna 
belles‐lettres 		belletrie 
bellflower 		klokkie koppies‐en‐pierings mariëteklokke 
belly 		abdomen agterlyf 
belong 		aanbehoort behoor behoort 
beloved 		beminde geliefde 
below 		benede onderaan 
belt 		gordel 
bench 		bank 
bend 		buig 
beneath 		onder 
benefit 		voordeel 
benefit 		benefice beneficevoorstelling 
bengal‐light 		Bengaalse vuur 
bengal‐lights 		Bengaalse vuur 
benzene 		benseen 
bergamot 		bergamot 
beryl 		beril 
beseech 		smeek 
beset 		belaag belae 
beside 		aan by langs naby 
besides 		behalwe 
besiege 		beleër 
besieger 		beleëraar 
best 		beste 
bestial 		beesagtig 
betrayal 		verraad 
better 		beter 
between 		tussen 
bevy 		klomp kudde skare skool trop 
bewitch 		begoël begogel beheks 
beyond 		verby 
be 		kan mag 
be 		afwesig wees ontbreek 
be 		ken 
be 		dryf 
be 		leef 
be 		mag 
be 		pas 
be 		skaam hom 
be 		slaap 
be 		baklei 
be 		besef 
be 		bankrot raak 
be 		waag 
be 		oppas 
be 		sluit 
be 		besef 
be 		in aanmerking kom 
be 		agterbly 
be 		verskil 
be 		kampeer 
be 		behoor behoort betaam 
be 		mal wees oor 
be 		verkeer voorkom 
be 		geniet 
be 		honger wees 
be 		belangstel in 
be 		gewoond wees 
be 		agterbly 
be 		afwesig wees ontbreek 
be 		agterloop agter wees 
be 		verkeer voorkom 
be 		gelukkig wees 
be 		trou 
be 		afwesig wees ontbreek 
be 		belend 
be 		behoor tot behoort tot 
be 		seer wees 
be 		bywoon 
be 		bejammer jammer wees 
be 		floreer 
be 		pas 
be 		dors wees 
be 		bedrië bedrieg 
be 		bedrië bedrieg 
be 		aandryf aandrywe 
be 		wil 
be 		verdien 
bible 		bybel 
bicycle 		fiets 
bid 		aanbied 
bide 		afwag 
big 		groot 
bike 		fiets 
bikini 		bikini 
bill‐board 		aanplakbord 
bill 		bek snawel 
billiards 		biljart 
bind 		bind 
binding 		band 
bindweed 		akkerwinde 
birch 		berk berkeboom 
bird 		voël 
birth 		geboorte 
birthday 		verjaarsdag 
bishop 		biskop 
bismuth 		bismut 
bison 		bison 
bit 		stuk 
bite 		byt 
bitter 		bitter 
black 		swart 
blame 		beknor berispe 
blank 		blank wit 
blanket 		beddeken deken 
bleak 		aaklig onaangenaam 
blend 		meng 
bless 		benedy seën 
blind 		blind 
block 		blok 
block 		aä‐lawa 
blood‐red 		bloedrooi 
blood‐relationship 		verwantskap naverwantskap verwantskapsbetrekking 
blood 		bloed 
blood 		bloedrooi 
bloom 		blom 
blouse 		bloese 
blow 		slag 
blue 		blou 
blunt 		afstomp 
blushing 		rood 
boar 		beer 
boardroom 		raadskamer 
boast 		spog 
bobbin 		spoel 
body 		liggaam lyf 
boil 		kook 
bolt 		knip 
bombard 		beskiet 
bondwoman 		slavin 
bone 		been 
bonus 		bonus 
book‐keeping 		boekhou 
book 		boek 
booking‐office 		kaartjieskantoor 
booking 		bespreking 
border 		rand 
bore 		aanboor 
boring 		vervelig 
borrow 		leen 
borrow 		beleen 
bosom 		bors 
boss 		baas 
both 		albei altwee beide 
bother 		belemmer 
bottle 		bottel 
bottom 		agtergrond 
bough 		tak 
boundary 		grens 
boutique 		winkel 
bovine 		bees 
bovine 		bees 
bowl 		bak bekken 
box‐room 		bêreplek pakplek 
box 		boks doos 
boxer 		bokser 
boy 		seun 
brace 		hakie 
bracelet 		armband 
bracket 		hakie 
brag 		spog 
brain 		brein 
brake 		rem 
branch 		tak 
branching 		aftakking 
brandish 		swaai 
brandy 		brandewyn 
bread 		brood 
break 		afbreek 
breakable 		breekbaar 
breakfast 		ontbyt 
break 		afspring 
break 		aanbreek 
break 		afbreek 
break 		afwen 
break 		afwen 
breast 		bors 
breath 		adem 
breathe 		asem 
breathless 		ademloos 
breed 		aanhou teel 
bribe 		bederf 
brick 		baksteen 
bride 		verloofde 
bridge 		brug 
bridle 		bedwing 
brief 		kort 
bright 		blink pragtig skitterend 
bright 		potblou 
brilliant 		blink pragtig skitterend 
brim 		rand 
bring 		aanbring aandra aandraag bring 
bring 		meebring saambring 
bring 		oplei 
brinjal 		brinjal eierplant 
brink 		rand 
brisk 		lewendig 
brittle 		breekbaar 
broach 		aanboor 
broken 		stukkend 
broker 		eiendomsagentskap 
bronze 		brons 
broom 		besem 
brothel 		bordeel hoerhuis 
brother‐in‐law 		aangetroude broer skoonbroer swaer 
brother 		broer 
brow 		wenkbrou 
brown 		bruin 
brownie 		aardgees aardmannetjie 
brush 		borsel 
buddy 		makker 
budget 		begroting 
budgetary 		begrotingstekort 
buffalo 		bison 
buffer 		buffer 
buffoon 		nar 
builder 		aannemer 
building 		aanbou 
building 		aannemer 
built‐up 		beboude gebied 
bulb 		ampul 
bulk 		grootte 
bull 		bul 
bullet 		koeël 
bumblebee 		aardhommel 
bumper 		buffer 
bunch 		bondel 
bundle 		bondel 
burden 		belaai belas laai 
burdensome 		swaar 
bureau 		buro kantoor 
bureaucracy 		amptenaredom amptenary 
burglar 		inbreker 
burial 		begrafnis begrawing 
burn 		brand 
burst 		bars 
bury 		begraaf begrawe 
bus 		bus 
bush 		struik 
bushbody 		bemoeial 
bushbuck 		bosbok 
business 		affêre affêring ding saak 
businessman 		sakeman 
business 		affêre affêring ding saak 
busstop 		bushalte 
busy 		besig 
bus 		bushalte 
but 		behalwe 
butcher 		slag 
butcher's 		abattoir 
butter 		botter 
buttocks 		agterent 
button 		knoop knop 
buy 		aankoop aanskaf koop 
by 		aan by langs naby 
bye 		adieu 
byname 		bynaam 
by 		bedags 
by 		aangetroud 
by 		deur met per 
by 		abusieflik per abuis 
by 		snags 
by 		al klaar reeds alreeds 
by 		apropos 
cabinet 		kabinet 
cadaver 		lyk 
cadger 		klaploper rugryer tafelskuimer 
cadre 		raamwerk 
cafetaria 		kafeteria 
cage 		hok 
calculate 		bereken 
calculation 		berekening rekening 
call 		benaam benoem naam 
caller 		besoeker 
call 		aandoen 
call 		kuier 
call 		afroep 
calm 		kalm 
calm 		bedaar 
camel 		kameel 
camera 		kamera 
camp 		kampeer 
campaign 		veldtog 
camping 		kamp kampeerterrein 
camping 		kamp kampeerterrein 
camp 		kamp 
camp 		kampeer 
can 		blik 
canal 		kanaal 
cancel 		afsê 
cancel 		aftelefoneer 
cancer 		kanker 
candidate 		applikant kandidaat 
candle 		kers 
cane 		stok 
canker 		kanker 
canopy 		baldakyn 
cap 		pet 
capable 		bekwaam 
capital 		hoofstad 
capital 		hoofstad 
captain 		kaptein 
capture 		beetgryp beetkry beetneem beetpak beetvat vang vat 
car 		kar motor 
cardiac 		innig 
care 		behartiging 
careful 		behoedsaam beleidvol versigtig 
careless 		agteloos agtelosig agterlosig 
carelessness 		agteloosheid agtelosigheid 
caress 		aai 
care 		bekommer hom bekreun hom 
care 		behandel 
carillon 		beiaard 
carnation 		angelier 
carpet 		mat 
carp 		bedil 
carrion 		aas 
carrot 		wortel 
carry 		dra 
carrying 		afvoer 
carry 		staan uithou 
cart 		kar 
carve 		beeldhou 
car 		parkeerplek 
case 		affêre affêring ding saak 
cash 		kontant 
casino 		casino 
casserole 		pan 
cassette 		kasset 
cast 		afwerp 
castle 		kasteel 
cast 		beskadu beskaduwee oorskadu 
cast 		afwerp 
cat 		kat 
catalogue 		katalogus 
catch 		beetgryp beetkry beetneem beetpak beetvat vang vat 
cause 		aandoen berokken veroorsaak 
cause 		bedroewe bedroef 
cause 		bedroewe bedroef 
cause 		belê beleg 
caution 		waarsku 
cautious 		behoedsaam beleidvol versigtig 
cave 		grot 
cavern 		grot 
cease 		ophou 
ceaselessly 		aldeur 
cede 		afstaan afstand doen van 
celebration 		selebrasie viering 
celebrity 		beroemdheid 
cellar 		kelder 
cemetery 		begraafplaas begraafplek 
censorious 		bedilsiek 
censoriousness 		bedilsug 
censure 		bekritiseer beoordeel kritiseer 
cent 		sent 
centennial 		eeu 
centimetre 		sentimeter 
central 		sentraal 
century 		eeu 
certainly 		a ja a seker sekerlik 
certainty 		sekerheid 
certificate 		akte bedryf 
chain 		bergreeks 
chair 		stoel 
chairman 		voorsitter 
challenge 		uitdaging 
chamber 		kamer vertrek 
chance 		gebeurtenis geleentheid 
change 		verander 
change 		adresverandering 
channel 		kanaal 
chaos 		baaierd chaos 
chaplain 		aalmoesenier 
character 		aard karakter 
characteristic 		kenmerkend tipies 
charge 		bereken 
chariot 		kar 
charitable 		barmhartig 
charity 		aalmoes 
charm 		aanloklikheid aantreklikheid 
charming 		aanminlik aanvallig beelderig beeldig bekoorlik 
chase 		ten doel hê 
chasm 		afgrond 
cheap 		goedkoop 
cheat 		ploert 
check 		bedwing 
check 		bekruis 
check 		kontroleer 
cheek 		wang 
cheerful 		vrolik 
chemist 		apteker 
chemistry 		chemie 
chemist's 		apteek 
cheque‐book 		tjekboek 
cheque 		tjek 
chess 		skaak 
chest 		bors 
chew 		kou 
chicken 		hoender 
chief 		baas 
chiefly 		hoofsaaklik veral 
child 		kind 
chilly 		koud 
chimes 		beiaard 
chimpanzee 		sjimpansee 
chisel 		beitel 
chlorine 		chloor 
chocolate 		sjokolade 
choice 		keuse 
choke 		onderdruk 
choose 		kies verkies 
chord 		akkoord 
christening 		doop 
chuck 		aai 
church‐building 		bedehuis kerk 
church 		bedehuis kerk 
cider 		appeldrank appelwyn 
cigar 		sigaar 
cigarette 		sigaret 
cinder 		as 
cinema 		bioskoop fliekhuis 
cipher 		syfer 
circle 		vereniging 
circumstance 		omstandigheid 
circumstances 		situasie toestand 
cistern 		tenk 
citation 		aanhaling 
cite 		aanhaal 
citizen 		burger 
city 		stad 
civilization 		beskawing 
civilize 		beskaaf beskawe 
clamp 		hakie 
clan 		kliek 
clap 		apploudiseer 
clarify 		verduidelik 
class 		klas 
classic 		klassiek 
classical 		klassiek 
clean 		skoon 
cleanly 		netjies 
cleanse 		skoonmaak 
clear 		helder 
clearly 		duidelik 
clerk 		kantoorklerk 
clever 		bedrewe behendig kunstig 
click 		klik 
client 		kliënt 
climate 		klimaat 
climb 		klim 
climber 		alpinis bergbeklimmer 
climbing 		beklimming 
clinic 		kliniek 
clip 		sny 
clippings 		afval 
clique 		kliek 
close‐up 		voorgrond 
close 		toemaak 
closed 		toe 
closet 		kas 
clothe 		beklee bekleed klee pas 
clothes 		klere 
clothing 		klere 
cloud 		benewel 
clown 		nar 
club 		klub 
cluster 		bondel 
clutch 		bemagtig gryp 
co‐ 		aaneen‐ 
co‐operate 		saamwerk 
coal 		steenkool 
coast 		kus 
coat 		jas 
cobalt 		kobalt 
cobra 		kobra 
cock 		haan 
cocktail 		kelkie 
cod 		kabeljou 
code 		kode 
codfish 		kabeljou 
coffee 		Afrikanertroos koffie 
coil 		spoel 
coin 		geldstuk munt muntstuk 
cold 		koud 
colleague 		ampgenoot ampsbroer kollega 
collect 		bymekaarbring uithaal versamel 
collection 		klomp kudde skare skool trop 
college 		ampgenoot kollege 
collide 		bots 
collision 		botsing 
colony 		kolonie 
colour 		kleur 
columbine 		akelei 
column 		kolom 
comb 		kam 
combination 		kombinasie 
combine 		verbind 
come 		afstam 
comedy 		komedie 
come 		raak word 
come 		ontmoet sien 
come 		terugkom 
come 		naderkom 
come 		naderkom 
come 		naderkom 
come 		bekruip 
come 		aansluit 
come 		eindig ophou 
come 		gaan staan stilhou 
come 		afspring 
comfort 		troos 
comfortable 		behaaglik gerieflik maklik 
comfortably 		lekker 
coming 		afkomstig 
command 		bepaal 
commander 		kommandant 
commence 		aanvang begin instel 
commencement 		aanvang begin 
commencing 		aanvangsalaris beginsalaris 
commend 		prys 
comment 		annoteer 
commerce 		handel 
commission 		opdrag 
commodity 		artikel 
common 		gewoon 
commonplace 		alledaags banaal 
commotion 		beroering 
communicate 		meedeel 
communication 		berig kennisgewing 
community 		belangegemeenskap 
compact 		kompak 
companian 		akkompanjis begeleider begeleier 
companion 		makker 
company 		firma 
compare 		vergelyk 
comparison 		vergelyking 
compartment 		afdeling vak 
compel 		dwing verplig 
compensate 		beloon 
compensation 		beloning vergelding 
competition 		kompetisie wedstryd 
complain 		beklag doen kla 
complaint 		beklag 
complete 		aanvul 
completely 		vol 
composed 		beheers 
comprehensibility 		begryplikheid 
comprise 		behels bevat 
computer 		rekenaar 
comrade 		makker 
concept 		begrip opvatting 
conception 		begrip 
concern 		belang belangrykheid 
concerned 		betrokke 
concerning 		belangende 
concert 		konsert 
conclude 		afwikkel beklink 
conclusion 		gevolgtrekking 
concord 		akkoord ooreenkoms ooreenstemming 
concurrence 		akkoord ooreenkoms ooreenstemming 
condition 		beding bedinging bepaling 
conduct 		lei 
conduct 		gedra hom 
confess 		beken 
confession 		belydenis 
confide 		aanbetrou vertrouwe stel in 
confidence 		vertroue 
confine 		begrens bepaal beperk 
confined 		begrens 
confined 		bedlêend 
confirm 		bekragtig beseël bevestig erken 
confirmation 		bekragtiging 
conflagration 		brand 
conform 		pas 
confuse 		verwar 
confusion 		begripsverwarring 
congestion 		aandrang 
congregate 		saamgaan 
conjunction 		voegwoord 
connect 		aaneenbind verbind 
connection 		aansluiting koneksie verbinding 
conscience 		gewete 
consciousness 		besef besinning 
consecutively 		aaneen agtereen agtereenvolgens namekaar 
consequence 		agternadraai 
consequently 		dus gevolglik 
conservation 		behoud 
conservative 		behoudend behoudensgesind 
conserve 		behou bêre bewaar 
consider 		oorweeg 
considerable 		aanmerklik behartigenswaardig 
considerably 		aansienlik 
consideration 		bedenking 
consistency 		agternadraai 
consolation 		troos 
console 		troos 
constant 		aanhoudend permanent vas 
constantly 		aldeur permanent 
consternation 		konsternasie 
constitution 		grondwet 
consul 		konsul 
consult 		raadpleeg 
consultation 		beraadslaging 
consume 		verorber 
consumer 		verbruiker 
contact 		kontak 
contain 		behels bevat 
container 		bak boks pot 
contented 		tevrede 
contention 		bewering 
contents 		inhoud 
contest 		kompetisie wedstryd 
continent 		vasteland 
continual 		aanhoudend permanent vas 
continually 		aldeur permanent 
continuously 		aldeur permanent 
contract 		kontrak 
contractor 		aannemer 
contradistinction 		teenstelling 
contralto 		alt altstem 
contralto 		alt altstem 
contrary 		teenoorgesteld 
contrast 		teenstelling 
contrite 		berouhebbend berouvol 
control 		beheersing 
convenient 		geskikt 
conversance 		bekendheid 
conversation 		gesprek onderhoud 
conversion 		bekering 
convert 		bekeer 
convey 		inlewer oordra 
cook 		kook 
cooking 		pan 
cool 		koel 
cool 		bekoel 
cooperate 		saamwerk 
copy 		afskrif 
copyright 		kopiereg 
coquetry 		behaagsug 
coquettish 		behaagsiek 
cordial 		innig 
core 		pit 
cork 		kurk 
corn 		mielies 
corner 		hoek 
coronation 		bekroning 
corpse 		lyk 
correct 		juis reg 
corroborate 		bekragtig beseël bevestig erken 
corrode 		aantas 
corruption 		bederf 
cosmetic 		poeier 
cost 		kos 
costly 		waardevol 
costume 		pak klere 
coterie 		kliek 
cough 		hoes 
counsel 		advokaat 
count 		in aanmerking kom 
counter 		toonbank 
countermand 		afsê 
countermand 		aftelefoneer 
counterpane 		bedsprei 
counting‐frame 		abakus rekenraam telraam 
count 		aftel 
coupé 		koepee kompartement 
courage 		dapperheid durf moed 
course 		baan 
court 		hof 
courteous 		beleef 
courtesy 		beleefdheid 
cousin 		niggie 
cover 		bedek belê beleg dek 
coverlet 		bedsprei 
covet 		begeer belus wees op 
covetousness 		begerigheid 
cow 		koei 
cower 		hurk 
cow 		beerklou bereklou 
crack 		bars 
cramped 		bekrompe benoud 
crawl 		kruip 
crayfish 		kreef 
craziness 		besetenheid 
crazy 		bedol besete mal 
cream 		vla 
create 		kreëer skep 
credit 		kredietkaart 
creep 		kruip 
crew 		bemanning 
cricket 		besie 
crisis 		krisis 
criticism 		beoordeling 
criticize 		bekritiseer beoordeel kritiseer 
crockery 		eetservies 
crocodile 		krokodil 
crook 		ploert 
cross 		kruis 
crouch 		hurk 
crowd 		massa menigte skare stapel 
crown 		bekroon 
crude 		rou 
cruel 		wreedaardig 
crutch 		kruk 
crystal 		kristal 
cry 		angskreet 
cry 		skreeu 
cube 		kubus 
cubic 		Kubaans 
cultivate 		beskaaf beskawe aankweek kweek 
culture 		kultuur 
cunning 		slim 
cup 		koppie 
cupboard 		kas 
cure 		behandel 
curfew 		aandklok 
curious 		nuuskierig 
curl 		roer 
currant 		aalbessie 
currant 		aalbessiebos 
currant 		aalbessievla 
currant 		aalbessiesap 
current 		aktueel 
curry 		kerrie 
curtain 		gordyn 
cushion 		kussing 
custom 		gebruik gewoonte 
customer 		kliënt 
cut 		afskakel 
cuttings 		afval 
cut 		afskakel 
cut 		aanbreek 
cut 		afsny afsteek 
cyclamen 		alpeviooltjie 
cycle 		fietsry 
cymbal 		bekken 
cymbalist 		bekkenis 
cynical 		sinies 
daily 		alledaags daagliks 
daily 		koerant 
dainty 		delikaat teer 
dam 		afsluiting 
damage 		skade 
damaged 		stukkend 
dame 		dam 
dance 		bal 
dare 		waag 
dare 		aandurf 
dark 		donker 
darling 		skat 
darn 		verbrands 
date 		dateer 
daughter‐in‐law 		skoondogter 
daughter 		dogter 
day 		dag 
dazed 		bedremmeld deurmekaar verbysterd verward 
dead 		dood 
deaden 		afskryf amortiseer 
deaf 		doof 
deal 		uitdeel 
deal 		behandel 
dear 		geag 
death 		dood 
debris 		afval 
debt 		skuld 
decade 		dekade 
decay 		bederf 
decayed 		aftandig aftands 
deceitful 		bedrieglik 
deceive 		bedrië bedrieg 
deceiver 		bedrieër 
decent 		behoorlik 
decently 		behoorlik behoorlikheidshalwe na behore 
deceptive 		bedrieglik 
decide 		besluit 
decision 		beskikking 
declaration 		verklaring 
declaration 		beginselverklaring 
declare 		verklaar 
decline 		afneem 
decoration 		dekor 
decoy 		lok 
decrease 		verlaging 
decrepit 		aftandig aftands 
dedicate 		spandeer 
deductible 		aftrekbaar 
deem 		ag glo meen 
deep 		diep 
deer 		hert takbok 
defeat 		verslaan 
defecate 		sy behoefte doen 
defection 		afval 
defence 		afweer 
defend 		afweer verdedig 
defendant 		beklaagde 
defense 		afweer 
defiantly 		ten spyte van 
defile 		bergengte 
define 		bepaal 
defining 		bepalend 
definitely 		beslis definitief 
definition 		bepaling definisie 
deflect 		afwyk 
deflection 		afwyking 
defray 		bekostig 
degree 		graad 
dejected 		bedruk 
dejection 		bedruktheid beklemdheid beklemming 
delay 		vertraging 
delete 		afvee afveeg afwis 
deliberate 		beraadslaag 
deliberation 		beraadslaging 
delicacy 		lekkers 
delicate 		delikaat teer 
delicious 		heerlik kostelik 
delightful 		beelderig beeldig verruklik 
delight 		geniet 
deliver 		lewer aflewer inlewer 
delivery 		aflewering 
delude 		begoël begogel beheks 
delusion 		begoëlsing begogelsing 
delusive 		bedrieglik 
deluxe 		luukse 
demand 		afset aftrek 
democracy 		demokrasie 
democratic 		demokraties 
demonstrate 		aantoon 
den 		grot 
denounce 		aanbring aangee 
dentist 		tandarts 
depart 		aftrek vertrek 
department 		departement 
departure 		vertrek 
dependence 		afhanklikheid 
dependent 		afhanklik 
depict 		uitbeeld 
deport 		deporteer 
deportment 		houding 
depose 		afsit 
deposit 		afsit 
depository 		bêreplek 
depravation 		bederf 
depressed 		bedruk 
depression 		bedruktheid beklemdheid beklemming 
deprive 		afsit 
deprive 		beroof 
depth 		diepte 
depute 		afvaardig 
derive 		aftap 
descend 		daal 
description 		beskrywing 
desert 		verlaat 
deserter 		afvallige 
deserve 		verdien 
design 		afteken 
desirable 		begeerbaar begeerlik 
desire 		begeer verlang 
desk 		lessenaar 
despite 		ten spyte van 
dessert 		nagereg 
destiny 		lot 
destitution 		behoeftigheid 
detachment 		afdeling 
detail 		besonderheid detail 
detention 		aanhouding arrestasie 
deter 		afskrik 
determine 		bepaal 
determining 		bepalend 
deterrent 		afskrikwekkend 
detrimentally 		nadelig 
develop 		ontwikkel 
development 		evolusie ontwikkeling 
deviate 		afwyk 
deviation 		afwyking 
device 		apparaat toestel 
devil 		josie duiwel 
devote 		spandeer 
devoted 		aanhanklik 
dexterous 		bedrewe behendig kunstig 
de 		luukse 
diagram 		beeld 
dial 		plaat skyf 
diamond 		diamant 
dictionary 		woordeboek 
die 		sterf 
diet 		dieet 
die 		afsterf afsterwe 
differ 		verskil 
difference 		verskil 
different 		verskillend 
differently 		anders 
difficult 		moeilik 
difficulty 		moeilikheid 
digit 		syfer 
dilapidated 		aftandig aftands 
dim 		donker duister 
dimension 		grootte 
diminish 		verminder 
diminutive 		klein 
din 		lawaai ophef 
dining‐room 		eetkamer 
dinner 		dinee middagete 
diploma 		akte bedryf 
direct 		bestuur rig 
direction 		rigting 
directions 		instruksie 
directly 		regop 
director 		bestuurder direkteur 
directory 		katalogus 
dirty 		vuil 
disadvantageously 		nadelig 
disappear 		verdwyn 
disc 		plaat skyf 
discharge 		afvuur 
disciples 		aanhang 
discipline 		dissipline 
discontented 		ontevrede 
discount 		afslaan aftrek 
discourage 		afskrik 
discover 		ontdek 
discovery 		ontdekking 
discrete 		beskeie 
discretion 		beleid 
discuss 		behandel bepraat 
disease 		kwaal siekte 
dish 		inskep opskep 
disinterested 		belangeloos 
dislike 		antipatie 
dismal 		alledaags banaal 
dismiss 		ontslaan 
dismount 		afstyg 
dispatch 		afsend 
displeased 		ontevrede 
disposal 		lus 
dispose 		verkoop 
disposition 		beskikking 
dispute 		kwessie 
dissatisfied 		ontevrede 
dissolve 		oplos 
dissuade 		afraai 
dissymmetric 		asimmetries 
distance 		afstand 
distant 		ver 
distinct 		helder 
distract 		besighou 
distraction 		ontspanning 
distress 		bedroewe bedroef 
distribute 		uitdeel 
disturb 		belemmer 
ditch 		sloot 
diverge 		afwyk 
diversion 		ontspanning 
divert 		besighou 
divide 		afskei afsonder 
divorced 		geskei 
do 		bedryf bedrywe begaan doen maak pleeg vervaardig 
doctor 		arts dokter 
document 		akte bedryf 
dog 		hond 
doll 		pop 
domestic 		binnelands inheems 
donate 		begiftig 
donkey 		donkie esel groutjie 
door 		deur 
dot 		punt 
doubt 		ambigeer twyfel 
down 		afwaarts ondertoe 
downstairs 		benede onderaan 
dozen 		dosyn 
do 		afruim afskaf 
draft 		konsep 
drag 		trek 
drain‐cock 		aftapkraan 
drain‐pipe 		afvoerbuis 
drain 		aftap afwater 
draining 		afwatering 
drama 		drama 
draw 		aanlok bekoor 
drawer 		laai 
draw 		aandag vestig 
draw 		ontlok uithaal 
draw 		aansit 
dreadful 		afskuwelik 
dreary 		aaklig onaangenaam 
dress 		beklee bekleed klee pas 
dresser 		aanreg 
dressing 		bemesting bemisting 
drift 		dryf 
drink 		drink suip 
drink 		drink suip 
drip 		drup 
drive 		aandryf aandrywe dryf 
drive 		afry 
drive 		afry 
drive 		aandryf aandrywe dryf 
drive 		ontlok uithaal 
drive 		bery 
drive 		aandryfas 
driving‐licence 		rybewys 
driving 		aandryfas 
driving 		agteruitkykspieël 
drizzle 		motreën 
drizzling 		motreën 
dromedary 		dromedaris 
droop 		hang 
drop 		val afval 
drop 		afval 
drug 		artseny medisyne 
drugstore 		apteek 
drum 		trommel 
drunk 		beskonke dronk 
drunkenness 		beskonkenheid 
dry‐nurse 		baker 
dry 		dor droog 
dryness 		droogte 
duck 		eend 
dull 		afstomp 
dung 		akka 
dunning‐letter 		aanmaningsbrief 
during 		gedurende terwyl tydens vir 
during 		bedags 
during 		snags 
dusk 		aandgrou aandskemering skemer 
dust 		afstof 
duty‐free 		belastingvry 
duty 		plig verpligting 
dwarf 		dwerg 
dwell 		woon 
dwelling 		woning 
dye 		kleur 
dyspnea 		aamborstigheid 
dyspnoea 		aamborstigheid 
décor 		dekor 
each 		alleman almal elke elkeen 
each 		mekaar 
eager 		begerig belus gretig 
eagerness 		begerigheid 
eagle 		adelaar arend 
eaglet 		arendsjong 
eaglewood 		aalwynhout 
ear 		oor 
early 		vroeg vroegtydig 
earn 		behaal verdien wen 
earth 		aanerd 
earthen 		aards 
earthly 		aards 
earthquake 		aardbewing aardskudding aardtrilling 
earthquake 		aardskok 
earth 		aanerd 
east 		ooswaarts 
eastern 		oostelik 
eastward 		ooswaarts 
eastwards 		ooswaarts 
eastward 		beooste 
east 		beooste 
easy 		maklik 
eat 		verorber 
echo 		eggo 
economical 		ekonomies 
ecstasy 		ekstase 
edelweiss 		edelweiss 
edge 		rand 
edging 		rand 
edition 		uitgawe 
educate 		oplei 
education 		opleiding 
eel‐fishing 		aalvissery 
eel‐like 		aalagtig 
eel‐pie 		aalpastei 
eel‐pot 		aalfuik 
eel‐shaped 		aalvormig 
eel‐trap 		aalfuik 
eel 		aal paling 
eelmonger 		aalverkoper 
eelskin 		aalsvel 
effect 		effek indruk 
effigy 		beeldenaar 
effluent 		afvalwater 
effort 		poging 
efforts 		bemoeienis 
egg 		ei 
eggfruit 		brinjal eiervrug 
eggplant 		brinjal eierplant 
eight 		ag 
eighteen 		agtien 
eighteenth 		agtiende 
eightfold 		agtvoudig agvoudig 
eighth 		agste 
eighth 		agste agtste 
eighty 		tagtig 
eland 		eland 
elder 		vlierboom 
elect 		kies verkies 
election 		keuse 
electric 		elektries 
electricity 		elektrisiteit 
electron 		elektron 
elegant 		elegant 
elegy 		elegie 
element 		beginsel 
elemental 		elementêr 
elementary 		elementêr 
elements 		abc alfabet 
elephant 		olifant 
elevator 		hyser 
eleven 		elf 
elf 		elf 
elk 		eland 
elm 		iep olm 
else 		ander 
elsewhere 		elders 
embalm 		balsem 
embarrassment 		benardheid 
embassy 		ambassade 
embodiment 		beliggaming 
embody 		beliggaam 
emerge 		verskyn 
emergency 		krisis 
emigrate 		emigreer 
emotion 		aandoening emosie 
emphasize 		benadruk 
employ 		benut benuttig gebruik 
employee 		werknemer 
employer 		werkgewer 
empty 		pap 
enchanter 		towenaar 
encounter 		ontmoet sien 
encourage 		aanmoedig bemoedig 
encouragement 		aanmoediging bemoediging 
end 		afsluit beëindig eindig 
ending 		beëindiging einde 
endive 		andyvie 
endow 		bedeel begiftig 
endure 		staan uithou 
end 		aanland beland 
enemy 		vyand 
energy 		energie 
engine 		masjien 
engineer 		ingenieur 
enjoy 		geniet 
enjoyable 		aangenaam behaaglik heerlik lekker 
enormous 		enorm 
enormously 		deeglik 
enough 		genoeg 
entangle 		verwar 
enter 		insit 
enterprise 		bedryf onderneming 
entertain 		besighou 
entertaining 		amusant 
entertainment 		amusement vermaak 
enthusiasm 		besieling geesdrif 
enthusiastic 		besield geesdriftig 
entice 		bekoor 
entire 		hele volledig 
entirely 		heeltemal 
entomb 		begraaf begrawe 
entrance 		toegang 
entreaty 		bede 
entrust 		aanbetrou vertrouwe stel in 
entrée 		voorgereg 
envious 		afgunstig 
environment 		omgewing 
environs 		omgewing 
envy 		beny 
epoch 		tydperk 
equality 		gelykheid 
equally 		ewe 
equilibrium 		balans 
equipment 		akkomodasie uitrusting 
era 		tydperk 
errand 		opdrag 
erroneous 		onjuis verkeerd 
error 		abuis fout 
erysipelas 		belroos 
escape 		ontkom aan ontsnap 
escort 		akkompanjement begeleiding 
especially 		veral 
essay 		stelling 
estate 		plaas boereplaas 
esteem 		ag 
estimate 		begroting 
estimates 		begroting 
etc. 		ens. 
eternal 		ewig 
et 		ensovoorts 
evade 		vermy 
even 		selfs 
evening‐school 		aandskool 
evening 		aand awend 
evening 		aandskool 
evening 		aandkostuum 
evening 		aandjapon 
evening 		aandjapon 
evening 		aandete 
evening 		aandblad aandkoerant 
event 		gebeurtenis 
even 		alwas 
ever 		eendag eers 
everlasting 		altyddurend 
every 		alleman almal elke elkeen 
everybody 		alleman almal elke elkeen 
everyone's 		aller almal se 
everything 		alles al's 
everywhere 		allerweë alom oral 
every 		allerhande allerlei 
every 		alleman almal elke elkeen 
ever 		sedert 
evolution 		evolusie ontwikkeling 
ex‐ 		voormalige vroeëre 
exact 		akkuraat 
exactitude 		akkuraatheid 
exactly 		presies 
examination 		eksamen navorsing ondersoek 
examine 		ondersoek 
example 		voorbeeld 
except 		behalwe 
exceptional 		uitsonderlik 
except 		behalwe 
excessive 		ekstreem 
exchange 		sentrale 
excise‐duty 		aksyns 
excise 		aksyns 
excitement 		opwinding 
exclude 		uitsluit 
exclusive 		uitgesluit 
exclusively 		alleen net pas slegs 
excrement 		akka 
excursion 		uitstappie 
excuse 		verskoon my 
exercise 		oefen 
exert 		beoefen 
exhausted 		uitgeput 
exhibit 		belig 
exhibition 		uitstalling 
exhortation 		aanmaning 
exile 		balling banneling 
exist 		bestaan 
existence 		aansyn 
exit 		uitgaan 
expect 		verwag wag wag vir 
expectation 		afwagting 
expedite 		afwikkel beklink 
expenses 		besteding 
expensive 		duur 
experience 		belewenis belewing ervaring ondervinding 
experienced 		bedrewe 
experiment 		eksperiment 
expert 		bedrewe 
expertness 		bedrewenheid 
expire 		eindig ophou 
explain 		verduidelik 
explanation 		verduideliking 
exploration 		navorsing ondersoek 
explore 		ondersoek 
explosion 		ontploffing 
export 		uitvoer 
exposition 		uitstalling 
exposure 		beligtingsmeter 
exposure 		beligtingsduur beligtingstyd 
express 		uitdruk 
expression 		uitdrukking 
extend 		grootte 
extensive 		uitgestrek 
exterminate 		uitroei 
extinguish 		blus doodmaak 
extortioner 		afsetter 
extra 		ekstra 
extract 		aftreksel 
extreme 		ekstreem 
extremely 		deeglik 
eye 		oog 
eyebrow 		wenkbrou 
fabricate 		aanmaak vervaardig 
face 		gesig 
facile 		maklik 
facilitate 		fasiliteer 
fact 		feit 
factory 		fabriek 
fade 		verbleik 
fail 		afsterf afsterwe 
failure 		bankrot 
fail 		agterweë bly 
faint 		swak 
fair 		basaar bazaar mark 
fairly 		taamlik 
fairy 		fee 
faith 		vertroue 
falcon 		valk 
fall 		val afval 
fallacious 		bedrieglik 
fall 		afval 
fall 		agteroorval 
false 		vals 
fame 		beroemdheid 
familiarity 		bekendheid 
family 		familie gesin 
family 		genealogie 
famous 		befaamd beroemd 
fan 		aanblaas 
fancier 		amateur 
fancy 		verbeeld hom 
far 		ver 
farewell 		adieu 
farm 		plaas boereplaas 
farmer 		agrariër boer landbouer 
farming 		akkerbou landbou 
far 		ver 
fascinate 		fassineer 
fashion 		mode 
fast 		haastig vinnig 
fasten 		aanbind 
fat 		vet vetterig 
fate 		lot 
father 		pa vader 
fatty 		vet vetterig 
favor 		begunstig 
favour 		begunstig 
favourable 		gunsteling‐ 
fear 		angst 
fearful 		angstig 
feather 		veer 
feel 		voel 
feel 		... voel 
feel 		beroue 
feldspar 		veldspaat 
fellow 		aaneen‐ 
felspar 		veldspaat 
female 		vroulik 
female 		ambassadrise 
female 		kapster 
female 		arbeidster 
female 		slavin 
female 		damestudent 
female 		onderwyseres 
femal 		arbeidster 
femal 		arbeidster 
feminine 		vroulik 
fence 		afsluiting 
fence 		afsluit 
fertile 		vrugbaar 
fertilization 		bemesting bemisting 
fertilize 		bemes 
festival 		party 
fetch 		aanbring aandra aandraag bring 
feudal 		feodaal 
fever 		koors 
feverish 		koorsig 
fewer 		minder 
fewest 		minste 
fiancée 		verloofde 
field 		akker veld 
field 		ambulans 
fifteen 		vyftien 
fifth 		vyfde 
fifty 		vyftig 
fight 		veg 
figure 		syfer 
file 		tou 
fill 		invul vol maak 
fill 		invul vol maak 
fill 		invul vol maak 
film 		film prent rolprent 
filthy 		vuil 
finally 		uiteindelik 
find 		merk 
find 		verkeer voorkom 
find 		hoor 
fine 		deftig mooi 
finger 		vinger 
finish 		afwerk 
finished 		bereid gereed klaar 
finishing 		afwerking 
finish 		afstudeer 
finnish 		afwikkel beklink 
fir 		den denneboom 
fire 		afvuur 
fire 		beskiet 
fire 		afvuur 
fire 		beskiet 
firing 		beskieting 
firm 		firma 
firm 		beginselvas 
firm 		beginselvas 
first 		eerste 
firstly 		eers 
first 		noodhulp 
first 		voornaam 
first 		eers 
fiscal 		belastingstelsel 
fiscal 		belastingjaar 
fish 		visvang 
fisherman 		visser 
fishing 		hengel 
fist 		vuis 
fit 		aanpas adapteer 
fitting 		behoorlik 
fit 		pas 
five 		vyf 
fix 		aanpas adapteer 
fixing 		bepaling 
fix 		bedissel beredder beskik reël 
flag 		vlag 
flake 		afskilfer 
flame 		vlam 
flare 		flikker 
flare 		flikker 
flat 		appartement woonstel 
flatter 		aai vlei 
flavour 		aroma 
flaw 		bars 
flay 		afstroop 
flee 		ontkom aan ontsnap 
fleece 		afset 
fling 		swaai 
fling 		afwerp 
float 		dryf 
flock 		kudde trop 
flood 		oorstroom 
floor 		verdieping 
flow 		loop vloei stroom 
flower 		blom 
flow 		afvloei 
flow 		afvloei 
flu 		griep 
flute 		fluit 
fly 		vlieg 
foam 		skuim 
fog 		mis 
follow 		volg 
following 		aanhang 
fondle 		aai 
food 		kos 
fool 		bedot beethê beetneem 
foolish 		dom 
foot 		poot voet 
football 		sokker 
for 		gedurende terwyl tydens vir 
forbidding 		afskrikwekkend 
force 		dwing verplig 
fore 		voorgrond 
forecast 		voorspelling 
foreground 		voorgrond 
forehead 		voorkop 
foreign 		vreemd 
foreigner 		anderlander 
foreign 		anderland buiteland 
forest 		bos 
forever 		ewig 
foreward 		voort vorentoe 
foreword 		voorwoord 
forget 		vergeet 
forgive 		begenadig vergeef 
fork 		vurk 
forks, 		skottelgoed 
form 		vorm 
formal 		formeel 
former 		voormalige vroeëre 
formerly 		voorheen vroeër 
forsake 		verlaat 
forswear 		afsweer 
fortunate 		gelukkig 
fortune 		lot 
forty 		veertig 
for 		aaneen agtereen 
for 		geruime tyd lank 
for 		ewig 
for 		begryplikerwys begryplikerwyse 
for 		weens 
for 		merendeels 
for 		merendeels 
for 		aangesien deurdat omdat 
for 		tydelik 
fossil 		fossiel 
foster‐child 		pleegkind 
foster‐father 		pleegvader 
foster‐mother 		pleegmoeder 
foster‐parents 		pleegouers 
foster‐son 		pleegseun 
foundation 		agtergrond 
fountain 		bron 
four 		vier 
fourteen 		veertien 
fourth 		vierde 
fowl 		hen 
fracture 		beenbreuk 
fragile 		breekbaar 
fragment 		item 
frame 		raamwerk 
framework 		raamwerk 
fraud 		bedrieër 
free 		gratis 
freedom 		vryheid 
freeze 		vries 
freezer 		vrieshok 
frequently 		dikwels 
fresh 		vars 
fresh 		vars water 
friend 		vriendin 
friendly 		vriendelik 
fright 		angst 
fringe 		rand 
frog 		padda 
from 		aan af deur sedert van vanaf 
from 		... a 
from 		hiervandaan 
from 		daarvandaan 
from 		waarvandaan 
frontier 		grens 
frosted 		beryp 
froth 		roer 
frowsy 		bedompig 
frozen 		bevrore 
fruit 		vrug 
fry 		bak 
frying‐pan 		pan 
frying 		pan 
fuck 		neuk 
fuel 		brandstof 
full‐grown 		volwasse 
full 		vol 
fully 		vol 
full 		beeldryk 
fun 		amusement vermaak 
function 		loop werk 
fund 		fonds 
funeral 		begrafnis begrawing 
funeral 		begrafnisstoet 
funny 		amusant 
furlough 		verlof 
furnish 		lewer aflewer inlewer 
furniture 		ameublement 
further 		meer 
futile 		vrugteloos 
future 		toekoms 
gain 		behaal verdien wen 
gallery 		galery 
game 		wedstryd 
gang 		bende skare 
garage 		garage motorhawe 
garden 		tuin 
gardening 		tuinmaak 
gargle 		afspoel spoel 
garrison 		besetting 
gas 		gas 
gasolene 		bensien bensine petrol 
gasoline 		bensien bensine petrol 
gas 		bensienreservoir bensinereservoir 
gather 		bymekaarbring uithaal versamel 
gathering 		vergadering 
gaunt 		maer skraal 
gay 		vrolik 
gazette 		koerant 
gear‐box 		ratkas 
gear‐case 		ratkas 
gem 		juweel 
genealogical 		genealogies 
genealogist 		genealoog 
genealogy 		genealogie 
general 		generaal 
generality 		algemeenheid 
generally 		in die algemeen 
generalship 		beleid 
generation 		generasie geslag geslaglys geslagregister stamboom 
genre 		genre 
gentle 		lieflik soet 
gentleman 		heer Meneer Mnr. 
genuinely 		darem regtig 
genuinly 		darem rektig sowaar werklik 
geographer 		aardrykskundige 
geographic 		aardrykskundig geografies 
geographical 		aardrykskundig geografies 
geography 		aardrykskunde 
geological 		aardkundig 
geologist 		aardkundige 
geology 		aardkunde 
get 		behaal verwerf 
get 		koud word 
get 		trou 
get 		beskimmel 
get 		afgaan afstap 
get 		afklim 
get 		afklim 
get 		afwen 
get 		afruim afskaf 
get 		opstaan 
ghastly 		aaklig onaangenaam 
gherkin 		agurk agurkie 
ghost 		gees spook 
giant 		reus 
gift 		donasie geskenk 
gifted 		begaaf 
giraffe 		kameelperd 
girder 		balk 
girdle 		gordel 
girl 		dogter meisie 
give 		begiftig 
give 		meld 
give 		aanbel bel 
give 		terugbesorg 
give 		afstaan afstand doen van 
give 		aandien aankondig aansê adverteer annonseer meld 
give 		bedroewe bedroef 
give 		aandoen berokken veroorsaak 
give 		afstaan afstand doen van 
give 		ontlok uithaal 
give 		afstaan afstand doen van 
glad 		bly 
gladness 		vreugde 
glamor 		gesag 
glamour 		gesag 
glass 		glas 
glasses 		bril 
glide 		gly 
globe 		aardbol aardkloot 
glorify 		prys 
glorious 		beroemd 
glory 		beroemdheid 
glue 		plak 
gnome 		aardgees aardmannetjie 
gnu 		wildebees 
go 		begeef hom begewe hom gaan 
goal 		doel oogmerk 
goblet 		beker 
goblin 		aardgees aardmannetjie 
god 		god 
going 		agteruitgang 
gold‐mine 		goudmyn 
gold 		goue 
golden 		goue 
golden 		goudgeel 
goldfish 		goudvis 
golf 		gholf 
good‐bye 		afskeid 
good‐natured 		vriendelik 
good 		gaaf goed 
goodbye‐ 		afskeids‐ 
goodbye 		adieu 
goods 		ware 
good 		middag goeiemiddag 
good 		beskaafdheid 
good 		naand goeienaand 
good 		goeiemôre 
good 		goeienag 
goose 		gans 
gossip 		klets 
gourd 		pampoen 
govern 		in bedwang hou 
government 		regering 
go 		afdwaal 
go 		aftrek vertrek 
go 		agteruitgaan 
go 		agteruitgaan 
go 		bederf bederwe 
go 		oorskry oorsteek 
go 		bankrot raak 
go 		daal 
go 		gou maak haas 
go 		wandel 
go 		uitgaan 
go 		beleef belewe deurmaak 
go 		fliek 
go 		fliek 
go 		opstaan styg 
go 		saamgaan 
grab 		bemagtig gryp 
grade 		graad 
gradually 		allengs allengskens stadigaan 
gram 		gram 
grammar 		grammatika 
gramme 		gram 
grand‐nephew 		agterneef 
grand‐niece 		agternig agterniggie 
grandchild 		kleinkind 
granddad 		oupa 
granddaughter 		kleindogter 
grandfather 		grootvader 
grandmother 		grootmoeder 
grandparents 		grootouers 
grandson 		kleinseun 
granny 		ouma 
grape 		druif 
grapple 		beetgryp beetneem beetpak beetvak 
grasp 		bemagtig gryp 
grass 		gras 
grasshopper 		sprinkaan veldsprinkaan 
grass 		grasgroen 
grate 		rooster 
grave 		benouend 
graveyard 		begraafplaas begraafplek 
gravy 		sous 
grease 		vet 
greasy 		vet vetterig 
great 		kostelik puik 
greatgrandchild 		agterkleinkind 
greatgranddaughter 		agterkleindogter 
greatgrandson 		agterkleinseun 
greediness 		begerigheid 
greedy 		begerig belus gretig 
green 		groen 
greet 		begroet groet 
greeting 		begroeting 
grey 		grys 
grid 		rooster 
grief 		bedroefdheid 
grieve 		bedroewe bedroef beproef beproewe 
grill 		rooster 
grip 		bemagtig gryp 
gripped 		geïnteresseerd 
grisly 		aaklig onaangenaam 
grotto 		grot 
ground‐floor 		benedeverdieping 
ground 		agtergrond 
group 		klomp kudde skare skool trop 
grow 		raak word 
gruesome 		afskuwelik 
guarantee 		waarborg 
guard 		behoed 
guardian 		beskermengel 
guess 		meen vermoë veronderstel 
guest 		gas 
guide 		bestuur rig 
guidebook 		gids 
guiltless 		onskuldig 
guilty 		skuldig 
guinea‐pig 		malmokkie marmotjie 
gulf 		afgrond 
gunner 		artilleris 
gusto 		animo bedrywigheid 
gymnastics 		gimnastiek 
gypsy 		sigeuner 
habit 		gebruik gewoonte 
haemorhoids 		aambeie 
haemorrhoid 		aambei 
haggle 		afding beknibbel 
hail 		hael 
hair 		hare 
hairdresser 		kapster 
hairs 		hare 
hairy 		behaard 
half‐brother 		halfbroer 
half‐sister 		halfsuster 
halt 		gaan staan stilhou 
hamburger 		burger hamburger 
hamper 		bemoeilik 
hand 		arbeider werker 
handbook 		gids 
handicap 		belemmering 
handicraft 		ambag bedryf beroep 
handle 		hanteer 
handsome 		deftig mooi 
handy 		geskikt 
hand 		inlewer oordra 
hang 		hang 
hang 		hou behou vashou 
happen 		raak word 
happiness 		geluk 
happy 		gelukkig 
harbor 		hawe 
harbour 		hawe 
hard 		moeilik 
hardly 		amper ampertjies bekwaald skaars 
hardworking 		arbeidsaam 
hardy 		aambeeldbeitel 
hare 		haas 
harm 		benadeel 
harrier 		kuikendief 
harry 		afstroop 
harvest 		afoes 
haste 		haas 
hat 		hoed 
hate 		haat 
haul 		trek 
have 		hê 
have 		beklaag beklae 
have 		aanbetrou vertrouwe stel in 
have 		vertrouwe stel in 
have 		vertrouwe stel in 
have 		gelukkig wees 
have 		hê 
have 		beethê 
have 		neuk 
have 		mag 
have 		behoor behoort moet 
haze 		bedil 
he 		hy 
head 		lei 
headache 		hoofpyn 
header 		rubriek 
heading 		graad 
headquarters 		hoofkwartier 
head 		in bedwang hou 
health 		gesondheid 
healthy 		fiks gesond 
heap 		akkumuleer 
hear 		hoor 
hearsay 		befaamdheid 
heart‐ 		innig 
heart 		hart 
hearty 		innig 
heat 		hitte 
heath 		heide 
heaven 		hemel 
heavy 		swaar 
hell 		hel 
hello 		allo 
helmet 		helm 
help 		assisteer help 
helper 		assistent 
helpful 		behulpsaam 
helpfulness 		behulpsaamheid 
hemorrhoid 		aambei 
hen 		hoender 
hence 		hiervandaan 
her 		haar 
herb 		gras 
herd 		klomp kudde skare skool trop 
here 		hierheen 
hero 		held 
heroic 		heldhaftig 
heroin 		heroïen heroïne 
heroine 		heldin 
hers 		hare 
herself 		self 
hidden 		verborge verhole verskole weggesteek 
hideous 		afskuwelik 
hill 		aanerd 
hill 		aanerd 
him 		hom 
himself 		self 
hind 		agterste 
hinder 		bemoeilik 
hindmost 		agterste 
hindrance 		belemmering belet beletsel 
hind 		agteras 
hind 		agterent 
hind 		agterwiel 
hint 		wenk 
hinterland 		agterland 
hip 		heup 
hippo 		seekoei 
hippopotamus 		seekoei 
hire 		huur 
hirsute 		behaard 
his 		syne 
history 		geskiedenis verhaal 
hit 		klap 
hither 		hierheen 
hoar 		beryp 
hoax 		bedot beethê beetneem 
hockey 		hokkie 
hog 		swyn vark 
hogweed 		beerklou bereklou 
hold 		hou behou vashou 
holder 		houer 
hold 		agterhou 
hole 		sloot 
home 		huis toe 
honest 		eerlik 
honey 		heuning 
honor 		huldig 
honour 		huldig 
hood 		apache 
hook 		angel 
hooker 		hoer 
hooter 		toeter 
hope 		hoop 
hope 		aansoek doen ambieer 
horn 		horing 
horrible 		afskuwelik 
horror 		aakligheid afgryse afskrik 
horse 		perd 
hospitable 		gasvry 
hospital 		hospitaal 
hospitality 		gasvryheid 
hostile 		vyandelik 
hotchpotch 		allegaartjie 
hotel 		hotel 
hour 		uur 
house 		huis 
housed 		behuis 
housefly 		vlieg 
house 		bedehuis 
how 		hoe 
however 		egter maar nietemin 
how 		hoe gaan dit met u? 
how 		hoe gaan dit met u? 
how 		hoe ver 
how 		hoeveelste 
how 		hoeveel 
hue 		skakering 
huge 		geweldig enorm 
human 		menslik 
human 		mens mensekind 
humiliating 		beskamend 
hundred 		honderd 
hungry 		honger 
hunt 		jaag 
hunter 		jager 
hunt 		ten doel hê 
hunt 		ten doel hê 
hurried 		haastig 
hurry 		gou maak haas 
hurt 		seer wees 
husband 		eggenoot man 
husk 		skil 
hyaena 		hiëna strandwolf 
hygienic 		higiënies 
hypothesize 		veronderstel 
ibex 		alpbok 
ice 		ys 
icecream 		ys 
iconoclasm 		beeldestorm beeldstorm 
iconoclast 		beeldestormer beeldstormer 
idea 		begrip benul idee opvatting 
ideal 		ideaal 
idiom 		idioom 
idol 		afgod 
if 		as indien 
ignore 		ignoreer 
ill 		siek 
illiterate 		analfabeet 
illness 		kwaal siekte 
illuminate 		belig 
illusion 		begoëlsing begogelsing 
ill 		lot 
image 		beeld beeltenis 
imagination 		verbeelding 
imagine 		verbeeld hom 
imitate 		agternadoen 
immediately 		dadelik 
immense 		geweldig enorm 
immigrate 		immigreer 
immune 		onvatbaar 
impatient 		ongeduldig 
impediment 		belemmering 
impel 		aandryf aandrywe dryf 
impetus 		aandrif 
implicate 		verwar 
imply 		beteken 
import 		invoer 
important 		belangrik erg ernstig 
imposter 		bedrieër 
impress 		beïndruk 
impressible 		sensitief 
impression 		effek indruk 
impulse 		aandrif 
in 		in binne op per 
inaccessible 		ongenaakbaar 
incinerate 		verbrand 
incite 		agiteer beroer 
inclination 		lus 
inclined 		geneig 
include 		behels bevat 
including 		insluitend 
inclusively 		insluitend 
inconvenient 		moeilik 
incorrect 		onjuis 
increase 		styg 
incubate 		broei 
incus 		aambeeld aambeeldbeentjie 
indeed 		tog 
independant 		onafhanklik 
index 		indeks 
indicate 		aandui aantoon 
indication 		aanduiding beduidenis 
indicative 		aantonende wys 
indicative 		aantonende wys 
indigence 		behoeftigheid 
individual 		individueel persoonlik 
inducement 		aanleiding 
industry 		industrie nywerheid 
inebriety 		beskonkenheid 
inexpensive 		goedkoop 
infant 		kind 
inference 		gevolgtrekking 
influence 		beïnvloed 
influenza 		griep 
inform 		in kennis stel 
information 		informasie 
infusion 		aftreksel 
inhale 		inasem 
inherit 		aansterf beërf beërwe erf 
inhibit 		belemmer 
initial 		voorletter 
initial 		aanvangsnelheid beginsnelheid 
inject 		inspuit 
injection 		inspuiting 
injure 		bederf beskadig 
injury 		wond 
innocent 		onskuldig 
inordinate 		ekstreem 
inorganic 		anorganies 
inquiry‐office 		inligtingskantoor 
inquisitive 		nuuskierig 
insane 		bedol besete mal 
insanity 		besetenheid 
insert 		insit 
inside 		in binne op per 
insist 		aandring 
insistence 		aandrang 
inspector 		inspekteur 
inspiration 		begeestering besieling 
inspire 		begeester besiel 
inspiring 		besielend 
instalment 		annuïteit 
instant 		oomblik rukkie 
instantly 		dadelik 
institute 		inrigting instituut 
instruction 		instruksie 
instructor 		onderwyser 
insubordinate 		opstandig 
insulate 		afsonder 
insulation 		isolasie 
insult 		beledig 
insulting 		beledigend 
insurance 		assuransie versekering 
insure 		assureer verseker 
intellect 		gees 
intelligent 		intelligent 
intelligibility 		begryplikheid 
intend 		bedoel beoog 
intense 		intens 
intensive 		intens 
intention 		bedoeling plan 
inter 		begraaf begrawe 
intercessor 		advokaat 
interchange 		inruil wissel 
interest 		belangstelling 
interested 		geïnteresseerd 
interesting 		belangwekkend interessant 
interfere 		hom bemoei met 
interment 		begrafnis begrawing 
intermission 		pouse 
international 		internasionaal 
interpret 		vertolk 
interpretation 		vertolking 
interview 		onderhoud 
intimate 		innig 
into 		in binne op per 
intone 		aanhef 
intoxicated 		beskonke dronk 
intrigue 		bekonkel 
introduce 		aanbied 
introduction 		inleiding 
invent 		uitvind 
invest 		belê beleg 
investigate 		ondersoek 
investigation 		eksamen navorsing ondersoek 
investor 		belêer belegger 
invitation 		uitnodiging 
invite 		nooi uitnooi 
invite 		aanbestee 
invoice 		rekening 
invoke 		aanroep oproep 
in 		aktief 
in 		allesins 
in 		in elk geval 
in 		asof 
in 		kontant 
in 		benard benepe verlëe 
in 		bemiddeld 
in 		allesins 
in 		allesins 
in 		jeens teen vir 
in 		sowaar 
in 		voor 
in 		om te vir 
in 		betrokke 
in 		karig 
in 		ten spyte van 
in 		aanvanklik 
in 		bedags 
in 		saans 
in 		intusse solank tegelyk 
in 		smôrens 
in 		agteraan 
in 		betyds op tyd 
in 		hoe 
in 		waarin 
in 		bedryfsklaar 
iron 		yster 
irrigate 		begiet 
island 		eiland 
isn't 		nè 
isn't 		nè 
isolate 		afsonder 
isolated 		afsonderlik 
isolation 		isolasie 
issue 		uitgee 
it 		dit 
item 		item 
its 		haar hulle sy 
itself 		self 
ivory 		ivoor 
jackal 		jakkals 
jacket 		baadjie 
jealous 		jaloers 
jeer 		beskimp 
jeer 		beskimp 
jester 		nar 
jewel 		juweel 
jeweller 		juwelier 
job 		arbeid werk 
jog 		aanstoot 
join 		aansluit toetree tot 
joining 		aansluiting 
journal 		koerant 
journalist 		joernalis 
journey 		reis 
joy 		vreugde 
judge 		oordeel 
judgment 		oordeel 
jug 		pot 
juice 		sap 
jump 		spring 
jump 		afspring 
junction 		aansluiting 
junto 		kliek 
jurisprudence 		reg 
jurist 		prokureur 
just 		billik regverdig 
justice 		geregtigheid 
just 		net nou net so net 
kangaroo 		kangeroe 
karma 		karma 
keen 		lewendig 
keep 		aanhou teel 
keeper 		argiefbewaarder argivaris 
keepsake 		aandenking 
keep 		agterhou 
kerchief 		kopdoek 
kernel 		pit 
key 		sleutel 
kick 		skop 
kidney 		nier 
kilo 		kilogram 
kilometre 		kilometer 
kind 		vriendelik 
kindle 		aan die brand steek 
kindness 		vriendelikheid 
king 		dam 
kingdom 		koninkryk 
kirk 		bedehuis kerk 
kiss 		soen 
kiss 		afsoen 
kitchen 		kombuis 
kite 		kuikendief 
klaxon 		horing 
knee 		knie 
knife 		mes 
knock 		klap 
knot 		knoop 
know 		ken 
knowledge 		bekendheid kennis 
know 		weet 
kopje 		koppie 
laboratory 		amanuensis 
laborer 		arbeider werker 
labor 		arbeidsmark 
labourer 		arbeider werker 
labour 		arbeidsmark 
lad 		seun 
laddie 		seun 
lady 		dam 
lady 		assistente 
laggard 		agterblyer 
laid 		bedlêend 
lake 		meer pan 
lamb 		lam 
lamp 		lamp 
land 		aanlê 
landing‐stage 		aanlegplek aanlêplaas aanlêplek 
landscape 		landskap 
landslide 		aardverskuiwing 
language 		taal 
lapsed 		aftandig aftands 
larch 		lork lorkboom 
large 		groot 
lass 		dogter meisie 
last 		voormalige vroeëre 
lasting 		aanhoudelik aanhoudend permanent vas 
late 		laat 
later 		later 
later 		later 
laud 		prys 
laugh 		lag 
laurel 		lourier 
law 		reg 
lawsuit 		proses 
lawyer 		advokaat 
lay‐by 		parkeerplek 
layer 		laag 
layman 		leek 
lay 		plaas sit 
lay 		neem oppik optel vat 
lazy 		lui 
lead 		lei 
leader 		baas 
leaflet 		brosjure 
lean 		maer skraal 
leap 		spring 
leap 		afspring 
learn 		leer 
learn 		hoor 
least 		minste 
leather 		leer 
leather 		leerware 
leave 		aftrek vertrek 
leave 		agterlaat 
leave 		agterweë laat 
leave 		ignoreer 
leaving 		eindeksamen 
lectern 		lessenaar 
lector 		lektor 
lecturer 		lektor 
left 		linkerkant 
left 		linkerkant 
leg 		been 
legend 		legende 
lemming 		bergmuis lemming 
lemon 		suurlemoen 
lemon 		suurlemoensap 
lend 		uitleen 
length 		lengte 
leopard 		luiperd tier 
less 		minder 
lessen 		verminder 
lesser 		akkerwinde 
lesson 		les 
let 		laat 
letter 		brief 
lettuce 		blaarslaai kropslaai 
let 		bekendmaak bekendstel meedeel meld 
let 		afskiet 
lever 		optrek 
librarian 		bibliotekaris 
library 		biblioteek 
licence 		lisensie 
license 		lisensie 
lie 		lê 
lie 		kampeer 
life 		lewe 
lift 		optrek 
light 		aan die brand steek 
lighter 		aanbrandsteker aansteker 
lighting 		beligting 
like 		as hoe so lyk soos 
likewise 		ook 
like 		also so 
lily 		lelie 
limb 		lid 
lime‐tree 		lindeboom 
limit 		begrens bepaal beperk 
limitation 		begrensing beperking 
limited 		begrens 
linden‐tree 		lindeboom 
line 		lyn 
lineage 		herkoms 
linguist 		linguïs 
linguistic 		linguïsties 
link 		skakel 
lion 		leeu 
liquid 		vloeistof 
liquidate 		afwikkel beredder 
list 		lys 
listen 		beluister luister luister naar 
listener 		beluisteraar 
liter 		liter 
literature 		letterkunde literatuur 
litre 		liter 
litter 		baar draagbaar 
little 		klein 
little 		allengs allengskens stadigaan 
live 		woon 
liver 		lewer 
livestock 		vee 
live 		beleef belewe deurmaak 
live 		beleef belewe deurmaak 
living‐room 		sitkamer 
lizard 		akkedis akkeldis akkerdis 
load 		belaai belas laai 
loaf 		brood 
loan 		lening 
lobster 		kreef 
local 		plaaslik 
locate 		plaas 
location 		plek 
loch 		meer pan 
lock 		afsluit 
locust 		sprinkaan veldsprinkaan 
logical 		logies 
logical 		rede 
lonely 		eensaam 
long 		lang 
long 		verlang 
look 		lyk 
look 		behartig 
look 		aankyk ag besien kyk kyk na 
look 		soek 
lord 		heer Meneer Mnr. 
lorry 		vragmotor 
lose 		afval 
lose 		afval 
lose 		afval 
lose 		verdwaal 
loss 		verlies 
loud 		hard 
lovable 		beminlik beminnenswaardig 
love 		bemin liefhê 
loved 		beminde geliefde 
lovely 		aangenaam behaaglik heerlik lekker 
lover 		geliefde 
love 		naasteliefde 
lowering 		verlaging 
lower 		benedeloop 
lower 		abdomen agterlyf 
low 		bas‐relief 
luck 		geluk 
luggage 		bagasie 
lump 		stuk 
lunacy 		besetenheid 
lunatic 		besetene 
lung 		long 
lupine 		lupien lupine 
lure 		lok 
luxurious 		luukse 
luxury 		weeldeartikel 
lynx 		rooikat 
lyric 		teks 
macaw 		arapapegaai 
machine 		masjien 
mad 		bedol besete mal 
madam 		dame Mev. Mevrou 
madness 		besetenheid 
magazine 		koerant 
magic 		tower‐ 
magician 		towenaar 
maid 		bediende 
mainland 		vasteland 
mainly 		hoofsaaklik veral 
maintain 		argumenteer 
maintenance 		behoud 
maize 		mielies 
major 		hoofweg 
make‐up 		grimering 
make 		afstewen 
make 		aanbied 
make 		beraam 
make 		skoonmaak 
make 		aanlonk 
make 		bepaal vasmaak vasstel 
make 		grimeer 
make 		benut benuttig 
make 		oorlog voer 
make 		bekryg beoorlog beoorloog 
make 		bekryg beoorlog beoorloog 
making 		aanmaak 
male 		manlik 
mammal 		soogdier 
man 		beman 
manage 		administreer 
management 		administrasie beheer kontrole 
manager 		administrateur bedryfsleier bestuurder 
manganese 		mangaan 
mango 		mango veselperske 
manifacture 		aanmaak 
manipulate 		hanteer 
manner 		wys wyse 
manufacture 		aanmaak vervaardig 
manuring 		bemesting bemisting 
many 		baie party 
map 		kaart 
maple 		ahorn 
march 		stap 
march 		sterf 
mark 		seël 
market 		basaar bazaar mark 
marketplace 		mark 
mark 		bekruis 
marriage 		huwelik 
married 		getroud 
marry 		trou 
marten 		marter 
marvel 		verbaas hom 
marvel 		verbaas hom 
masculine 		manlik 
mask 		bemantel 
mass 		massa menigte skare stapel 
master 		baas 
master 		aannemer 
match 		vuurhoutjie 
material 		materieel 
materials 		benodigdhede 
mathematical 		wiskundig 
mathematics 		wiskunde 
matrimony 		huwelik 
matter 		affêre affêring ding saak 
mature 		beleë ryp 
maximum 		maksimum 
may 		mag 
maybe 		aans aansies allig altemit altemits altemitters miskien 
mayhap 		aans aansies allig altemit altemits altemitters miskien 
me 		aan my my 
meager 		maer skraal 
meal 		ete maaltyd 
mealies 		mielies 
mean 		gemiddeld medium 
meander 		kronkel 
meaning 		bedoeling plan 
meanwhile 		intusse solank tegelyk 
measurement 		afmeting dimensie 
meat 		vleis 
mechanic 		werktuigkundige 
meddler 		bemoeial 
meddlesome 		bemoeisiek bemoeisugtig 
meddlesomeness 		bemoeigees bemoeisug 
mediation 		bemiddeling 
medical 		medies 
medicine 		artseny medisyne 
medly 		allegaartjie 
meet 		saamgaan 
meeting 		vergadering 
melody 		wys wysie 
member 		lid 
membership 		lidmaatskap 
memento 		aandenking 
memory 		herinnering 
menace 		bedreig 
mendicant 		bedelbroeder bedelmonnik 
mendicant 		bedelorde 
mentally 		agterlik 
mention 		noem vermeld 
menu 		spyskaart 
merchant 		handelaar sakeman 
merciful 		barmhartig 
merit 		verdien 
merry 		vrolik 
message 		boodskap 
metaphor 		beeld beeldspraak 
metre 		meter 
metropolis 		hoofstad 
midday 		dinee middagete 
middle 		gemiddeld medium 
middleclass 		burger 
midget 		dwerg 
migrate 		swerf 
mile 		myl 
milk 		melk 
millimetre 		millimeter 
million 		miljoen 
mind 		gees 
mine 		myne 
mineral 		mineraal 
mingle 		meng 
minimum 		minimum 
mining 		mynbou 
minister 		minister 
minute 		minuut 
minutes 		boetekaartjie 
miracle 		wonder 
miraculous 		wonderbaarlik 
miscarriage 		aborsie 
miscellaneous 		allerhande allerlei 
miserable 		beklaaglik beklaenswaardig beklagenswaardig 
misfeasance 		ampsmisdryf 
mission 		opdrag 
missionary 		sendeling 
mist 		mis 
mistake 		abuis fout 
mistaken 		onjuis verkeerd 
mix 		meng 
mixture 		allegaartjie mengsel 
mockery 		aanfluiting 
mode 		wys wyse 
model 		skema 
moderate 		besadig beskeie matig 
modern 		modern 
modest 		beskeie 
modesty 		beskeidenheid 
mole 		mol 
moment 		oomblik rukkie 
momentarily 		ewe 
money 		geld 
money 		poswissel 
monk 		monnik 
monkey‐like 		aapagtig 
monkey 		aap 
monkshood 		akoniet 
monologue 		alleenspraak 
monopoly 		alleenhandel alleenverkoop 
monster 		monster 
month 		maand 
monthly 		baker 
monument 		monument 
moon 		maan 
moor 		aanbind 
moorage 		ankerplek 
mooring 		ankerplek 
moose 		eland 
moral 		moreel 
more 		meer 
more 		oor 
morphology 		morfologie 
morsel 		hap 
mortician 		begrafnisondernemer 
most 		meeste 
mostly 		merendeels 
most 		alleraardigst 
motel 		motel 
moth 		mot nagvlinder 
mother‐in‐law 		skoonma skoonmoeder 
mother 		ma moeder 
motion 		film prent rolprent 
motive 		aanleiding 
motor‐cyclist 		motorfietsryer 
motorcycle 		motorfiets 
motorist 		motoris 
motorway 		deurpad 
motor 		deurpad 
mouldy 		beskimmeld 
mount 		aanpas adapteer 
mountable 		beklimbaar 
mountain 		berg 
mountaineer 		alpinis bergbeklimmer 
mountainous 		bergagtig 
mountain 		berglug 
mountain 		bergreeks 
mountain 		alpinis bergbeklimmer 
mountain 		bergengte 
mountain 		bergpunt bergspits bergtop 
mountain 		bergreeks 
mountain 		bergkam 
mountain 		berghelling 
mountain 		bergpunt bergspits bergtop 
mounted 		berede 
mounting 		beklimming 
mourn 		bejammer 
mouse 		muis 
mouth 		mond 
mouthful 		hap 
move 		aangry 
movement 		beweging 
movie 		film prent rolprent 
movie 		bioskoop fliekhuis 
moving 		aandoenlik 
much 		baie 
mud‐stained 		bemodderd 
muddy 		bemodderd 
multitude 		massa menigte skare stapel 
munition 		ammunisie 
murderer 		moordenaar 
museum 		museum 
music 		musiek 
musical 		musiekinstrument 
musical 		beleid 
must 		behoor behoort moet 
mutineer 		rebel 
mutton 		skaapvleis 
my 		my 
myself 		myself 
mysterious 		misterieus 
mystification 		beetnemery 
mystify 		bedot beethê beetneem 
myth 		mite 
nail‐varnish 		naelpolitoer 
nail 		nael 
name 		benaming naam 
nameless 		anoniem 
namely 		naamlik 
napkin 		servette 
narrate 		verhaal vertel 
narrative 		storie verhaal 
narrow 		bekrompe 
nasty 		antipatiek 
national 		nasionaal 
nationality 		nasionaliteit 
native 		inheems 
natural 		natuurlik 
naturally 		natuurlik van nature 
natural 		aardgas 
nature 		aard karakter 
near 		aan by langs naby 
nearby 		aan by langs naby 
nearer 		nader 
nearest 		eerskomende naaste 
nearly 		alhaas amper byna 
near 		aan by langs naby 
neat 		netjies 
necessaries 		benodigdhede 
necessary 		benodig nodig 
neck 		hals nek 
necktie 		das 
need 		behoef nodig hê 
needless 		onnodig 
needy 		behoeftig berooid 
neglect 		afstel 
negligence 		agteloosheid agtelosigheid 
negligent 		agteloos agtelosig agterlosig 
neighbour 		buurman 
neighbouring 		naburig 
neighbour 		benedebuur benedebuurman 
neither 		niemand nie 
nematode 		aaltjie aalwurm 
nephew 		broerskind neef susterskind 
net 		netjies 
nevertheless 		egter maar nietemin 
new 		nuut 
news 		nuus 
newspaper 		koerant 
next 		eerskomende naaste 
next 		aan by langs naby 
nice 		aangenaam behaaglik heerlik lekker 
nickname 		bynaam 
niece 		broerskind nig niggie susterskind 
night‐school 		aandskool 
night 		nag 
night 		nagklub 
night 		aandgebed 
night 		nagklub 
nine 		nege 
nineteen 		negentien 
ninety 		negentig 
no‐one 		niemand nie 
no 		nee 
nobility 		adel 
noble 		edel 
nobody 		niemand nie 
node 		knoop 
noise 		lawaai ophef 
nomad 		benoeming 
nominate 		benoem 
nomination 		benoeming 
non‐alcoholic 		alkoholvry 
non‐attendance 		absensie afwesigheid 
none 		niemand nie 
nonsense 		absurditeit 
norm 		standaard 
normal 		normaal 
north 		noordwaarts 
northern 		noordelik 
northward 		noordwaarts 
northwards 		noordwaarts 
nose 		neus 
not 		nie 
note 		kaartjie 
nothing 		niks niks nie 
notice‐board 		aanplakbord 
notice 		aanplakbiljet 
notification 		advies 
notion 		begrip 
notwithstanding 		ten spyte van 
not 		niks 
not 		aikôna allesbehalwe a nee a glad nie 
not 		nog niet 
nourishment 		kos voedsel 
novel 		nuut 
novelty 		nuus 
novice 		nuweling 
now 		toe 
nowhere 		nêrens nie 
nuance 		skakering 
nucleus 		pit 
nudge 		aanstoot 
number 		aantal 
number 		agtal agttal 
numeral 		syfer 
nurse 		verpleeg 
nursery 		kleuterskool 
nuts 		bedol besete mal 
oak 		akker akkerboom eik 
oath 		eed 
oath 		ampseed 
obey 		gehoorsaam 
objection 		bedenking 
obligation 		plig verpligting 
obliging 		bereidvaardig bereidwillig 
oblique 		skeef 
observation 		berisping 
observe 		bedryf bedrywe begaan 
obstacle 		belemmering 
obstruct 		afsluit afsper 
obtain 		behaal verwerf 
occasion 		keer maal 
occiput 		agterhoof 
occupation 		ambag bedryf beroep 
occupy 		beklee 
occur 		gebeur geskie plaatsvind 
occurence 		gebeurtenis insident voorval 
ocean 		oseaan 
octagon 		aghoek agthoek 
octal 		agtallig agttallig 
octopus 		agarm agtarm 
octuple 		agtvoudig agvoudig 
odd 		eienaardig 
odor 		geur reuk 
odour 		geur reuk 
of 		aan af deur sedert van vanaf 
offence 		aanstoot 
offend 		beledig 
offensive 		beledigend 
offer 		aanbied 
office 		kantoor 
official 		amptelik 
officialdom 		amptenaredom amptenary 
official 		ampswoning 
official 		ampsgeheim 
offset 		afstand 
offspring 		nakomelingskap 
often 		dikwels 
of 		... a 
of 		allerhande allerlei 
of 		natuurlik 
of 		berug 
of 		adelik 
of 		allesbeheersend 
of 		sonnig 
of 		geskikt 
of 		wie se 
ogle 		aanlonk 
oh 		a aag aai ag 
oil 		olie 
okay 		gaaf goed 
old‐fashioned 		ouderwets oudmodies outyds 
old 		bejaard oud 
old 		ouer 
omit 		afstel 
omnibus 		bus 
omnipotence 		almag alvermoë 
omnipresent 		alomteenwoordig alteenwoordig 
omniscient 		alwetend 
on 		voort vorentoe 
once 		alweer weer 
one 		iemand enigiemand 
onerous 		swaar 
one 		mekaar 
one 		honderd 
one 		duisend 
onion 		ui 
only 		alleen net pas slegs 
only 		amper ampertjies bekwaald skaars 
on 		weens 
on 		aaneen agtereen 
on 		te voet 
on 		agteroor 
on 		daarom 
on 		inteendeel 
on 		links 
on 		aan die ander kant 
on 		regs 
on 		akkuraat 
on 		bo 
on 		boonop 
open 		oopmaak 
openly 		openlik 
open 		oopmaak 
opera 		opera 
operate 		loop werk 
operation 		operasie 
operative 		arbeider werker 
opine 		ag dink 
opinion 		mening opinie opvatting visie 
opportune 		geskikt 
opportunity 		gebeurtenis insident voorval 
opposed 		jeens teen vir 
opposite 		oorkant 
opposition 		teenstelling 
oppress 		druk 
oppressed 		beklemd 
oppression 		bedruktheid beklemdheid beklemming 
oppressive 		benoud benouend 
opprobrious 		beledigend 
option 		alternatief 
or 		of 
orange‐coloured 		oranje 
orange 		lemoen 
orbit 		baan 
orchard 		boord 
orchestra 		orkes 
orchid 		orgidee 
order 		bestel 
ordinarily 		gewoonlik 
ordinary 		gewoon 
organization 		organisasie 
organize 		organiseer 
origin 		herkoms oorsprong 
original 		oorspronklik 
originally 		oorspronklik 
originate 		afstam 
ornament 		sieraad 
orphan 		ouerloos 
or 		nè 
ostrich 		volstruis 
other 		ander 
otherwise 		inteendeel 
other 		behalwe 
ouch 		ai au 
ought 		behoor behoort moet 
our 		ons 
ours 		ons s'n 
outfit 		pak klere 
outing 		uitstappie 
outlet‐pipe 		afvoerbuis 
outline 		skets 
outside 		buite 
outside 		buite 
outstanding 		agterstallig 
out 		uit van ... af 
out 		beleefdheidshalwe 
out 		ouderwets oudmodies outyds 
out 		stukkend 
out 		beleefdheidshalwe 
over 		oor 
overall 		totaal 
overcoat 		jas 
overdue 		agterstallig 
overflowing 		oortollig 
overgrow 		begroei 
overhaul 		verbysteek 
overhead 		bo 
overlay 		beklee bekleed 
overlook 		agterweë laat 
overpower 		bemeester 
overtake 		verbysteek 
over 		daar gunder ginder ginds 
ow 		ai au 
owe 		skuld 
owing 		weens 
own 		besit 
owner 		eienaar 
o'clock 		uur 
pack 		pak 
package 		pak 
packet 		pakkie 
pad 		blok 
padre 		aalmoesenier 
page 		bladsy 
pain 		pyn 
painful 		seer 
paint 		afskilder 
painting 		skildery 
paint 		beskilder 
pal 		makker 
palladium 		palladium 
pamphlet 		brosjure 
pancreas 		alvleesklier 
papaw 		papaja 
papaya 		papaja 
paper‐hanger 		behanger 
paper 		beskeid dokument 
paperback 		brosjure 
paperer 		behanger 
parade 		appèl 
paradise 		paradys 
paragraph 		alinea 
parapet 		balustrade 
parasite 		parasiet 
parcel 		pakkie 
pardon 		begenadig 
parent 		ouer 
parenthesis 		hakie 
parents‐in‐law 		skoonouers 
parents 		ouers 
parings 		afval 
park 		parkeer 
parking 		parkeerplek 
parking 		parkeerplek 
parking 		parkeerplek 
parrot 		papegaai 
part 		aandeel deel gedeelte stuk 
partially 		deels gedeeltelik 
participate 		deelneem 
particle 		item 
particular 		afsonderlik afsydig apart 
partition 		afskeiding 
partly 		deels gedeeltelik 
party 		aanhang 
pass 		verbysteek 
passable 		berybaar 
passenger 		passasier 
passer‐by 		verbyganger 
pass 		sterf 
pass 		verbygaan 
past 		verlede 
pastor 		dominee predikant 
pate 		kop 
path 		baan 
patience 		geduld 
patient 		geduldig 
patriarch 		aartsvader 
patron 		beskermheer 
pattern 		skema 
pauper 		aalwyntapper arme 
pause 		pouse 
pavement 		trottoir 
pavilion 		pawiljoen 
paw 		been poot 
pawn 		beleen 
pawning 		belening 
pay 		betaal 
pay 		ag slaan op oppas 
pay 		ag slaan op oppas 
pay 		spandeer 
pay 		bekostig 
pea 		ertjie 
peace 		vrede 
peaceful 		vreedsaam 
peaceloving 		vreedsaam 
peach 		perske 
peal 		beier 
pear 		peer 
peculiar 		eienaardig 
pedigree 		genealogie 
peel 		afskil 
peel 		afskilfer 
peep 		beloer 
peep 		begluur 
peep 		beloer 
pelvis 		bak bekken 
peninsula 		skiereiland 
penitent 		berouhebbend berouvol 
pension 		pensioen 
pensioner 		pensioentrekker pensionaris 
penury 		behoeftigheid 
pepper 		peper 
per 		in binne op per 
perceive 		merk 
percent 		persent 
percentage 		persent 
perchance 		aans aansies allig altemit altemits altemitters miskien 
perform 		verskyn 
perfume 		parfuum 
perhaps 		aans aansies allig altemit altemits altemitters miskien 
period 		punt 
periodical 		koerant 
perishable 		bederfbaar bederflik 
permanent 		aanhoudend permanent vas 
perplexed 		bedremmeld deurmekaar verbysterd verward 
perplexity 		benardheid 
persecute 		agtervolg 
person 		persoon 
personal 		persoonlik 
personality 		aard karakter 
persuade 		bepraat 
petrol 		bensien bensine petrol 
petrol 		bensienreservoir bensinereservoir 
pettiness 		benepenheid 
phantom 		gees spook 
pharmaceutical 		artseny medisyne 
phase 		fase 
photograph 		foto 
physician 		arts dokter 
piano 		klavier piano 
pick 		afruk afskeur aftrek 
pick 		kies verkies 
pick 		bymekaarbring uithaal versamel 
picnic 		piekniek hou 
picture 		beeld beeltenis 
picturesque 		skilderagtig 
picture 		poskaart 
pie 		tert 
piece 		stuk 
piece 		meubel 
pier 		aanlegplek aanlêplaas aanlêplek 
pig 		swyn vark 
pigeonhole 		afdeling vak 
piglet 		varkie 
pigmy 		dwerg 
pile 		massa menigte skare stapel 
pile 		aambeipoeier 
pile 		akkumuleer 
pilgrimage 		bedevaart 
pill 		pil 
pillar 		kolom 
pillow 		beddekussing bedkussing 
pimple 		puisie 
pine‐tree 		den masboom pyn 
pine 		den masboom pyn 
pineapple 		ananas pynappel 
pink 		angelier 
pinnacle 		bergpunt bergspits bergtop 
pioneer 		baanbreker 
pious 		godsdienstig 
pipe 		pyp 
pit 		sloot 
pitch 		pikswart 
pitiful 		beklaaglik beklaenswaardig beklagenswaardig 
pity 		beklaag beklae 
placard 		aanplak 
place 		aanpas adapteer 
place 		toevlugsoord 
place 		bedehuis 
plain 		helder 
plan 		bedoeling plan 
plane 		vliegtuig 
plant 		plant 
plantation 		plantasie 
planting 		beplanting 
plaster 		bepleister 
plastic 		plastiek 
plate 		plak 
platform 		leiding 
platitude 		banaliteit 
plausible 		aanneemlik 
play 		speel 
playground 		baan 
plea 		argument 
plead 		bepleit 
pleasant 		aangenaam behaaglik heerlik lekker 
pleasantly 		lekker 
pleasantness 		behaaglikheid 
please 		asjoublief asseblief belief 
pleased 		tevrede 
pleasing 		behaaglik 
pleasure 		behae 
plenty 		baie party 
plough 		beploe beploë beploege 
pluck 		afruk afskeur aftrek 
plume 		veer 
plus 		plus 
pocket 		sak 
poem 		gedig 
poet 		digter 
poetry 		poësie 
point 		punt 
point 		aandui toon vertoon wys 
point 		bleik 
poisonous 		giftig 
police‐station 		polisiestasie 
police 		polisie 
policeman 		agent poliesman 
policy 		beleid 
polite 		beleef 
politeness 		beleefdheid 
political 		politiek polities 
politician 		politikus 
politics 		beleid 
pony 		ponie 
pool 		aansluit 
poop 		agterboeg agterskip agtersten agterstewe 
poopdeck 		agterboeg agterskip agtersten agterstewe 
poor 		beklaaglik beklaenswaardig beklagenswaardig 
poor 		aalwyntapper 
poor 		aalwyntapper arme 
pope 		pous 
poplar 		populier 
popular 		gewild populêr 
population 		bevolking 
porch 		stoep 
port 		hawe 
portal 		toegang 
porter 		kruier 
portrait 		beeltenis 
port 		aanleghawe aanlêhawe aanloophawe 
port 		bakboord 
position 		houding posisie 
possess 		besit 
possession 		besit besitting 
possibility 		moontlikheid 
possible 		moontlik 
possibly 		aans aansies allig altemit altemits altemitters miskien 
post 		aanplak 
postage 		posgeld 
postcard 		briefkaart 
poster 		aanplakbiljet 
postulate 		vereis 
post 		poskantoor 
post 		aanplak 
pot 		pot 
potato 		aartappel 
potato 		aartappelmeel 
pour 		giet 
poverty 		armoede 
powder 		bepoeier 
power 		mag 
power 		sentrale 
practicable 		berybaar 
practical 		prakties 
practice 		toepas 
practise 		oefen 
practised 		bedrewe 
practitioner 		beoefenaar 
praise 		prys 
prawn 		garnaal 
pray 		bid 
prayer 		gebed 
preacher 		predikant 
precipice 		afgrond 
precise 		netjies 
precision 		akkuraatheid 
predominating 		allesbeheersend 
preface 		inleiding 
preferably 		liewer sommer 
pregnant 		in die ander tyd swanger 
prejudice 		benadeel 
prejudicially 		nadelig 
premium 		agio 
preparation 		bereiding 
prepare 		bedissel berei voorberei 
prescription 		resep 
presence 		aansyn teenwoordigheid 
present‐day 		aktueel 
present 		aktueel 
presentation 		aanbieding opvoering vertoning 
present 		aanbied 
preservation 		behoud 
preserve 		behoed 
president 		voorsitter 
press 		pers 
pressing 		dringend 
pressure 		aandrang 
press 		aandruk 
prestige 		gesag 
presume 		meen vermoë veronderstel 
pretty 		aardig 
prevail 		bemeester 
prevent 		belemmer 
previous 		voormalige vroeëre 
previously 		voorheen vroeër 
previous 		alvorens voor dat 
price 		prys 
pricey 		duur 
primary 		laerskool 
primitive 		primitief 
principally 		hoofsaaklik veral 
principle 		beginsel 
print 		bedruk 
prior 		voormalige vroeëre 
prisoner 		arrestant 
private 		privaat privaat‐ 
privilege 		voorreg 
probably 		seker waarskynlik 
problem 		probleem 
process 		proses 
proclaim 		afkondig bekendmaak bekendstel 
proclamation 		verklaring 
produce 		afwerp oplewer produseer 
product 		produk 
production 		produksie 
profess 		beken 
profession 		bedryf beroep 
professional 		beroeps‐ professioneel 
professor 		professor 
profile 		deursnee 
profit 		profyt 
profound 		diep 
prognosis 		voorspelling 
programme 		program 
project 		beraming konsep plan projek 
promise 		beloof belowe 
promote 		bevorder 
promotion 		bevordering promosie 
prompt 		akkuraat 
promulgate 		afkondig 
pronunciation 		uitspraak 
proof 		bewys 
proper 		behoorlik 
properly 		behoorlik behoorlikheidshalwe na behore 
property 		plaas boereplaas 
prophecy 		voorspelling 
proportion 		verhouding 
prosecute 		agtervolg 
proselyte 		bekeerling 
prosper 		floreer 
prosperity 		welvaart 
protect 		behoed 
protection 		beskerming 
protest 		protesteer 
protocol 		boetekaartjie 
protégé 		beskermeling beskermling 
proud 		trots 
prove 		aantoon 
provided 		as indien 
province 		provinsie 
provisional 		tydelik 
prudence 		beleid 
prudish 		preuts 
psychiatrist 		psigiater 
psychologist 		sielkundige 
pub 		drinkpan 
puberty 		puberteit 
public 		publiek 
publish 		uitgee 
publisher 		uitgewer 
pudding 		poeding 
pull 		trek 
pull 		ontlok uithaal 
pump 		pomp 
pumpkin 		pampoen 
punctual 		akkuraat 
punishment 		straf 
puppet 		pop 
purchase 		aankoop 
pure 		suiwer 
purge 		skoonmaak 
puritan 		puriteins 
purpose 		doel oogmerk 
pursue 		ten doel hê 
put 		plaas sit 
putrefy 		bederf bederwe 
puttee 		beenwindsel 
put 		bêre wegsteek 
put 		bekruis 
put 		plaas sit 
put 		aandag vestig op 
put 		insit 
put 		beredder 
put 		afhaal afsit 
put 		aktiveer 
put 		aanbied 
put 		blus doodmaak 
put 		aanbestee 
put 		verstel 
put 		beskaam 
put 		aanpas adapteer 
put 		staan uithou 
puzzle 		verwar 
qualification 		kwalifikasie 
qualify 		bepaal 
quarrel 		kwessie 
quarter 		kwartier 
quash 		afwys 
quay 		perron 
queen 		dam 
quell 		onderdruk 
question 		kwessie vraag navraag 
quibble 		bedil 
quick 		haastig vinnig 
quickly 		gou in alleryl vinnig 
quiet 		kalm 
quinsy 		angina 
quit 		aftree bedank 
quite 		nogal taamlik 
quiver 		beef 
quotation 		aanhaling 
quotation 		aanhalingstekens 
quote 		aanhaal 
quotes 		aanhalingstekens 
rabbi 		rabbi 
rabbit 		konyn 
race‐course 		baan 
race 		jaag spoed 
rack 		arak 
radio 		radio 
radium 		radium 
rag 		flard 
railing 		balustrade 
rain 		reën 
rainbow 		reënboog 
raise 		aanhou teel 
raise 		alarmeer 
ram 		ram 
ranch 		plaas boereplaas 
rand 		bergreeks 
range 		bereik 
rank 		tou 
rapid 		haastig vinnig 
rare 		skaars 
raspberry 		framboos 
rat 		rot 
rate 		verhouding 
ratepayer 		belastingbetaler belastingpligtige 
rather 		nogal taamlik 
ratification 		bekragtiging 
ratify 		bekragtig 
rattle 		klik 
ravage 		afstroop 
ravine 		kloof 
raw 		rou 
ray 		radio 
reach 		behaal bereik presteer 
react 		reageer 
read 		lees 
readiness 		behulpsaamheid 
ready 		bereid gereed klaar 
real 		effektief 
reality 		waarheid 
realization 		benul besef insig 
realize 		begryp besef verstaan 
really 		darem regtig 
realm 		staat 
rear‐exit 		agteruitgang 
rear‐lamp 		agterlamp agterlig 
rear‐light 		agterlamp agterlig 
rear 		agterhoede 
rearguard 		agterhoede 
rear 		agteras 
rear 		agterbalkon 
rear 		agterbank 
rear 		agterwiel 
rear 		agterraam 
reason 		rede 
reasonable 		besadig beskeie matig 
reason 		beredeneer 
reason 		beredeneer 
rebate 		afslaan aftrek 
rebel 		rebel 
rebellious 		opstandig 
rebound 		afstuit 
rebuke 		berispe 
recall 		onthou 
recede 		agteruitboer agteruitgaan 
receive 		aanneem aanvaar aksepteer neem 
recent 		vars 
recently 		'n rukkie gelede onlangs 
receptionist 		ontvangsdame 
recess 		pouse 
recipe 		resep 
recline 		lê 
recognize 		herken 
recollect 		onthou 
recollection 		herinnering 
recommend 		aanbeveel aanprys 
recommendable 		aanbeveelbaar aanbevelenswaardig 
recommendation 		aanbeveling aanprysing 
recommended 		aanbevole 
record 		plaat skyf 
recovery 		behoud behoudenis berging verlossing 
rector 		prinsipaal 
red 		rood 
redemption 		amortisasie 
reduce 		afslaan 
red 		aalbessie 
reference 		verwysing 
refined 		delikaat teer 
refinement 		beskaafdheid 
reflect 		bedink hom besin oorweeg 
refusal 		afwysing bedanking weiering 
refuse 		afval 
regard 		agting 
region 		gebied streek 
register 		aanteken registreer 
registered 		aanbevole 
registered 		aandeel op naam 
regret 		bejammer jammer wees 
regrettable 		bejammerenswaardig 
regrettably 		a foei tog jammer 
regular 		reëlmatig 
regularly 		dikwels 
regulation 		bepaling voorskrif 
reign 		beheersing 
reject 		afslaan afwimpel afwys bedank 
rejection 		afwysing bedanking 
rejoice 		geniet 
relate 		verhaal vertel 
related 		geparenteer verwant 
related 		aangetroud 
relation 		verband 
relationship 		verwantskap naverwantskap verwantskapsbetrekking 
relative 		familielid verwant bloedverwant 
relatively 		taamlik 
release 		laat 
religion 		godsdiens 
religious 		godsdienstig 
relinquish 		afstaan afstand doen van 
rely 		vertroue stel in 
remain 		agterbly 
remainder 		afval res 
remark 		berisping 
remember 		onthou 
remit 		afsê annulleer kanselleer 
remote 		ver 
remotely 		ver 
remote 		afstandsbediening afstandsbeheer 
remove 		afruim afskaf 
rendezvous 		afspraak 
renegade 		afvallige 
renegate 		afvallige 
renounce 		afsweer 
renown 		beroemdheid 
renunciation 		afswering 
repair 		regmaak 
repayment 		annuïteit 
repeat 		herhaal 
repellent 		afstootlik 
repelling 		afstootlik 
repent 		beroue 
repentance 		berou 
repentant 		berouhebbend berouvol 
repent 		beroue 
replace 		vervang 
reply 		antwoord 
report 		in kennis stel 
repose 		rus 
represent 		uitbeeld 
representation 		beeld 
representative 		verteenwoordiger 
reproach 		berispe 
reproof 		berisping 
reprove 		berispe 
reptile 		reptiel 
republic 		republiek 
repulsive 		afstootlik 
repute 		befaamdheid 
request 		vra 
require 		behoef nodig hê 
requisite 		vereiste 
requisites 		benodigdhede 
rescue 		behou 
research 		ondersoek 
reserve 		bespreek 
reservoir 		bassin 
residence 		woning 
resign 		abdikeer 
resignation 		aftreding 
resign 		berus 
respect 		respekteer 
respectable 		agbaar agtenswaard agtenswaardig 
respiration 		ademhaling 
respond 		reageer 
responsible 		verantwoordelik 
rest 		afval res 
restrain 		bedwing 
restrained 		beheers 
restrict 		begrens bepaal beperk 
restricted 		begrens 
restriction 		begrensing beperking 
restrictive 		beperkend 
result 		afstam 
resumé 		oorsig 
retardation 		vertraging 
retarded 		agterlik 
retention 		behoud 
retire 		aftree 
retired 		pensioentrekker pensionaris 
retiree 		pensioentrekker pensionaris 
retirement 		pensioen 
retreat 		sterf 
return‐ticket 		retoerkaartjie 
return 		terugbesorg 
reveal 		afkondig 
reverse 		teenoorgesteld 
reversed 		teenoorgesteld 
revise 		nasien 
revolver 		rewolwer 
revue 		tydskrift 
reward 		beloon 
rezignation 		berusting 
rhino 		renoster 
rhinoceros 		renoster 
rhodium 		rodium 
rhododendron 		alperoos 
rhyme 		berym 
rice 		rys 
rich 		ryk 
rickety 		aftandig aftands 
ride 		ry 
ride 		perdry 
ride 		bery 
ridiculous 		belaglik 
right‐angle 		reghoekig 
right‐hand 		regterkant 
right 		regs 
righteous 		billik regverdig 
righteousness 		geregtigheid 
right 		almeteens dadelik 
right 		almeteens dadelik 
rim 		rand 
ring 		ring 
ring 		aanbel bel 
rinse 		afspoel spoel 
riot 		lawaai 
ripe 		beleë ryp 
rise 		opstaan 
rite 		ritus 
river 		rivier 
road 		baan 
roam 		swerf 
roast 		braai 
rob 		beroof berowe 
robber 		berower 
robbery 		berowing 
robes 		ampsgewaad 
robot 		robot 
robust 		ferm stewig 
rock‐crystal 		bergkristal 
rock 		rots 
roe 		ree 
rogue 		ploert 
role 		rol 
roll‐call 		appèl 
roll 		rolletjie 
roll 		afwentel 
room 		kamer vertrek 
rooster 		haan 
root 		wortel 
rose 		roos 
rot 		bederf bederwe 
rotten 		bedorwe 
rough 		rou 
rough 		konsep 
round 		rond 
round 		afrond 
route 		roete 
row 		tou 
rower 		roeier 
rub 		vryf 
rubbish 		absurditeit 
rubble 		afval 
ruby 		robyn 
rudiments 		abc alfabet 
ruffian 		apache 
rule 		beheersing 
ruler 		beheerser 
rumor 		befaamdheid 
rumour 		befaamdheid 
rump 		agterent agterste 
run 		aanloop 
running 		baan 
run 		tref 
run 		agternagaan 
run 		vlug 
run 		aansoek doen 
rural 		plattelands 
rush 		gou maak haas 
rye 		rog 
régime 		regime 
rôle 		rol 
sack 		ontslaan 
sad 		bedruk 
saddle 		saal 
sadness 		bedroefdheid 
safe 		behoue veilig 
safety 		sekerheid veiligheid 
sagacious 		intelligent 
sage 		wys 
sail 		seil 
salad 		slaai 
salamander 		salamander salmander 
salary 		salaris 
sale 		afset aftrek 
salesman 		verkoopsman 
sales 		afsetgebied 
salt 		sout 
salutation 		begroeting 
salute 		begroet groet 
salvage 		bergloon 
salvage 		bergingsmaatskappy 
salvage 		bergloon 
salvation 		behoud behoudenis berging verlossing 
sample 		monster 
sanctify 		heilig 
sanction 		bekragtiging beseëling 
sand 		sand 
sandal 		sandaal 
sap 		sap 
sardine 		sardien 
satellite 		trawant 
satisfied 		tevrede 
sauce 		sous 
saucepan 		pan 
sausage 		wors 
save 		behoed 
saw 		saag 
say 		sê 
say 		afskeid neem 
say 		afskeid neem 
say 		bevestig 
scale 		skaal 
scale 		afskilfer 
scandal 		aanstoot 
scanty 		karig 
scarce 		karig 
scarcely 		amper ampertjies bekwaald skaars 
scare 		afskrik 
scatter 		giet 
scene 		toneel 
scenery 		landskap 
scent 		geur reuk 
schedule 		rooster 
scheme 		beraming konsep plan projek 
schism 		afskeuring 
scholary 		rapport 
school 		skool 
school 		lessenaar 
school 		skoolvakansie 
science 		wetenskap 
scissors 		skêr 
scold 		aanmaan 
scoundrel 		ploert 
scrap 		flard 
scratch 		krap 
scream 		skreeu 
screen 		skerm 
screw 		neuk 
script 		skrif 
scrupulous 		angsvallig 
scuffle 		geveg 
sculptor 		beeldhouer 
sculpture 		beeldhouwerk 
sea‐anemone 		aktinie seeanemoon 
sea‐dog 		rob seehond 
sea 		see 
seal 		rob seehond 
search 		afsoek 
seaside 		kus 
seat 		sitplek 
seaweed 		alg alge 
secede 		afval 
seclude 		afsonder 
secluded 		afsonderlik 
second 		tweede 
secondary 		sekondêr 
second 		agternig agterniggie 
secret 		geheim 
secretary 		sekretaresse 
secrete 		afskei 
secretion 		afskeiding 
section 		afdeling vak 
sector 		sektor 
secure 		bepaal vasmaak vasstel 
security 		sekerheid veiligheid 
security 		sekuriteitsbeampte 
see 		ontmoet sien 
seed 		saad 
seek 		soek 
seem 		lyk skyn 
seemly 		geskikt 
seize 		bemagtig gryp 
seizure 		apopleksie beroerte 
seldom 		selde 
self‐conscious 		bedees 
self‐interested 		baatsugtig 
self‐possessed 		beheers 
self 		self 
selfinterest 		baatsug baatsugtigheid 
selfish 		baatsugtig 
selfishness 		baatsug baatsugtigheid 
selfless 		aanhanklik 
sell 		verkoop 
send 		oorsend stuur 
sender 		afsender 
send 		afskeep 
send 		ontbied 
send 		afsend 
sense 		benul besef insig 
sensitive 		sensitief 
sentence 		sin 
separate 		afsonderlik afsydig apart 
separation 		afskeiding 
serious 		belangrik erg ernstig 
serpent 		slang 
servant 		bediende 
serve 		bedien voorsit 
service 		erediens 
set 		apparaat toestel 
settle 		afwikkel beklink 
settlement 		kolonie 
set 		beding bepaal 
seven 		sewe 
seventeen 		sewentien 
seventh 		sewende 
seventy 		sewentig 
several 		verskeie 
several 		somtyds 
sew 		naaldwerk doen 
sex 		geslag 
shack 		barak 
shade 		skakering 
shadow 		afskaduwing 
shake 		skok 
shake 		afskud 
shame 		beskaamtheid skaamte 
shampoo 		sjampoe 
shanty 		barak 
shape 		vorm 
share‐capital 		aandelekapitaal 
share 		aandeel 
shareholder 		aandeelhebber aandeelhouer aksionaris 
shark 		haai 
sharp 		skerp 
sharpen 		aanskerp 
shave 		afskeer 
shave 		afskeer 
she‐bear 		beerwyfie berin 
she‐wolf 		wolvin 
she 		haar sy 
sheaf 		bondel 
shear 		sny 
shed 		barak 
sheep 		skaap 
sheet 		bedlaken laken 
shelf 		rakkie 
shell 		afskil 
shelter 		toevlugsoord 
shepherd 		herder 
sherry 		sjerrie xeres 
ship 		afsend 
shirt 		hemp 
shiver 		beef 
shock 		skok 
shoe 		skoen 
shoo 		aandryf aandrywe dryf 
shoot 		doodskiet 
shoot 		afskiet 
shop 		winkel 
shore 		kus 
short 		kort 
shorten 		bekort 
shortness 		aamborstigheid asma 
should 		behoor behoort moet 
shoulder 		berm 
shout 		skreeu 
show 		aandui toon vertoon wys 
shower 		stort 
show 		venster winkelvenster 
shrink 		ineenkrimp 
shrub 		struik 
shuffle 		meng 
shut 		toemaak 
shut 		afsit 
shy 		bedees 
shyness 		bedeesheid 
sick 		siek 
side‐whiskers 		bakbaard bakkebaard 
side 		kant 
sideboard 		kas 
sidewalk 		trottoir 
siege 		beleëring beleg 
sight 		aanblik aansien aansig air aspek 
sightseeing 		uitstappie 
sign 		bewys 
signal 		teken 
signalman 		baanwagter 
signature 		handtekening 
significant 		betekenisvol 
signify 		beteken 
silently 		stilswygend 
silicon 		kiesel silicium 
silver 		silwer 
sin 		oortree 
since 		sedert 
sincere 		innig 
sing 		sing 
singer 		sanger 
single 		ongetroud 
sink 		aanboor 
sir 		heer Meneer Mnr. 
sister 		suster 
sit 		broei 
sitting‐room 		sitkamer 
situation 		situasie toestand 
sit 		aansit 
six 		ses 
sixteen 		sestien 
sixth 		sesde 
sixty 		sestig 
sizable 		aanmerklik behartigenswaardig 
size 		grootte 
skeleton 		geraamte 
sketch 		skets 
ski 		ski 
skilful 		bedrewe 
skilfulness 		bedrewenheid 
skill 		bedrewenheid 
skilled 		bedrewe 
skillful 		bedrewe 
skillfulness 		bedrewenheid 
skim 		afroom 
skimpy 		maer skraal 
skin 		vel 
skinny 		maer skraal 
skirt 		rok romp 
sky 		hemel 
slab 		plak 
slander 		beklad belaster beskinder 
slanting 		skeef 
slaughter 		slag 
slaughterhouse 		abattoir 
slave 		slavin 
sledge 		slee 
sleep 		slaap 
sleigh 		slee 
slender 		dun maer 
slice 		plak skyf sny 
slim 		skraal 
slip 		gly 
slot 		gleuf 
sloth 		ai 
slothful 		lui 
slum 		agterbuurt agterwyk 
sly 		slim 
small‐mindedness 		benepenheid 
small‐time 		amateuragtig 
small 		klein 
small 		aambeeldvoël 
smart 		slim 
smell 		ruik 
smell 		beruik 
smile 		glimlag 
smoke 		rook 
snake 		slang 
snap 		afsnou 
snarl 		afsnou 
sniff 		beruik 
snow 		sneeu 
snow 		sneeuwit spierwit 
snub 		afsnou 
so 		dus gevolglik 
soak 		week 
sober 		besadig 
sobriquet 		bynaam 
soccer 		sokker 
social 		sosiaal 
society 		klub 
sock 		sokkie 
socket 		houer 
sofa 		sofa 
soft 		lieflik soet 
soften 		week 
soil 		aarde grond 
soiled 		vuil 
solair 		sonnig 
soldier 		soldaat 
sole 		alleen allenig enigste 
sole 		aleenverteenwoordiger 
solicitor 		advokaat 
solid 		ferm stewig 
soliloquy 		alleenspraak 
solitary 		alleen allenig enigste 
solution 		oplossing 
solve 		oplos 
some 		nogal taamlik 
somebody 		iemand enigiemand 
someone 		iemand enigiemand 
something 		iets enigiets 
something 		nuus 
sometime 		eendag eers 
sometimes 		somtyds 
somewhat 		nogal taamlik 
somewhere 		êrens 
some 		iemand enigiemand 
son‐in‐law 		skoonseun 
son 		seun 
soon 		alhaas alras netnou nou‐nou 
soothe 		kalmeer 
sorcerer 		towenaar 
sorrow 		bedroefdheid 
sort 		soort 
soul 		animo gees 
sound 		klink lui 
sound 		alarmeer 
source 		bron 
south 		suidelik 
southern 		suidelik 
southward 		suidwaarts 
southwards 		suidwaarts 
souvenir 		aandenking 
sovereign 		beheerser 
sow 		sog 
so 		so ... soos 
so 		tot siens 
spa 		badplaas 
spacious 		uitgestrek 
spare 		spaar bespaar 
sparrow 		mossie 
speak 		gesels praat 
special 		afsonderlik afsydig apart 
speciality 		afdeling vak 
specific 		spesifiek 
specimen 		monster 
spectacles 		bril 
spectator 		aankyker kyker toeskouer 
speed‐limit 		snelheidsgrens 
speed 		spoed 
speedy 		haastig vinnig 
speed 		snelheidsgrens 
spell 		begoëlsing begogelsing 
spend 		spandeer 
sperm 		sperma 
spinster 		juffrou Mej. Mejuffrou 
spiral 		spiraal 
spirit 		gees 
spit 		spuug 
split 		bars 
split 		afsplits 
spoil 		bederf beskadig 
spoiled 		bedorwe 
sponger 		klaploper rugryer tafelskuimer 
spool 		spoel 
spoon 		lepel 
sport 		sport 
sports 		sportgrond 
spot 		plek 
spread 		afgee 
spring 		bron 
springtime 		lente 
spruce‐fir 		denneboom 
spruce 		denneboom 
spy 		begluurder 
spy 		beloer 
square 		reghoekig 
square 		are 
squash 		pampoen 
squat 		hurk 
squeeze 		druk 
squeeze 		pars 
squirrel 		eekhoring eekhorinkie 
stack 		akkumuleer 
staff 		staf 
stage 		leiding 
staid 		besadig 
stain 		beklad 
staircase 		trap 
stairs 		trap 
stale 		benoud 
stallion 		hings stalhings 
stamp 		afstempel 
stand 		opstaan 
standard 		standaard 
stand 		opstaan 
stand 		aandurf 
staple 		hakie 
star 		ster 
stare 		aanlonk 
start 		aktiveer 
starting 		beginpunt 
start 		vat 
state 		verklaar 
statement 		aangifte 
statement 		beginselverklaring 
station 		stasie 
statue 		beeld standbeeld 
stay 		verblyf 
stay 		afwag 
stay 		agterbly 
stay 		aanbly bly 
steak 		kruisskyf 
steal 		steel 
steel 		staal 
steer 		bestuur rig 
steering 		leiding 
stem 		stam 
stencil 		patroon 
step‐brother 		stiefbroer 
step‐child 		stiefkind 
step‐daughter 		stiefdogter 
step‐father 		stiefvader 
step‐mother 		stiefmoeder 
step‐sister 		stiefsuster 
stern 		agterboeg agterskip agtersten agterstewe 
stick 		stok 
stick 		aanbrand 
stiffling 		benoud benouend 
still 		nog 
sting 		angel 
stipulate 		beding bepaal 
stipulation 		beding bedinging bepaling 
stir 		aangry 
stir 		agiteer beroer 
stocking 		kous 
stodgy 		vervelig 
stomach 		maag 
stop 		gaan staan stilhou 
storage 		akkumulator battery 
storage 		bêreplek pakplek 
store 		winkel 
storey 		verdieping 
story 		verdieping 
stow 		bêre wegsteek 
straggler 		agterblyer 
straight 		direk 
straight 		reguit aan 
straight 		reguit aan 
straight 		verby 
straigh 		regop 
strained 		gespanne strak 
straitened 		benard 
strange 		vreemd 
strangulated 		beklemde breuk 
strategic 		strategies 
strawberry 		aarbei 
strawberry 		aarbeiboom 
stray 		afdwaal 
stream 		beek 
strech 		opwen 
strecher 		baar draagbaar 
street 		straat 
strength 		krag mag 
stress 		aksentueer beklemtoon 
stretcher 		draagbaar 
strike 		aanboor 
strike 		afsluit 
strip 		band 
stroke 		apopleksie beroerte 
stroke 		apopleksie beroerte 
stroll 		wandel 
stroller 		stapper voetslaner wandelaar 
strong 		sterk 
structure 		struktuur 
struggle 		veg 
student 		damestudent 
studio 		ateljee 
study 		bestudeer 
stuffy 		bedompig 
stupid 		dom 
sturdy 		ferm stewig 
style 		styl 
subject 		onderwerp 
subject 		behoudens 
subject 		belasbaar 
subscriber 		abonnee abonnent 
subscription 		abonnement 
subsequently 		daarna later 
subsidy 		subsidie 
substitute 		vervang 
subtract 		aftrek 
subtraction 		aftrekking 
subtraction 		aftreksom 
subtrahend 		aftrekgetal aftrekker 
suburb 		voorstad 
succeed 		slaag 
success 		welvaart 
successor 		afstammeling 
such 		so 'n 
such 		as hoe so lyk soos 
such 		as hoe so lyk soos 
suddenly 		skielik 
suffer 		staan uithou 
sufficient 		genoeg 
sufficiently 		nogal taamlik 
suffocate 		onderdruk 
sugar‐cane 		suikerriet 
sugar 		suiker 
suggest 		aandui aantoon 
suggestion 		suggestie 
suit 		pas 
suitable 		behoorlik 
sultan 		sultan 
sultry 		benoud benouend 
sum 		bedrag 
summer 		somer 
summery 		oorsig 
summons 		dagvaarding 
sun‐ 		sonnig 
sun 		sonnig 
sunshine 		son 
superfluous 		oortollig 
supermarket 		supermark 
supersign 		aksent aksenteken 
supervise 		kontroleer 
super 		deurpad 
supper 		aandete 
supplication 		bede 
supply 		lewer aflewer inlewer 
support 		ondersteun 
supporter 		lid 
supporters 		aanhang 
suppose 		meen vermoë veronderstel 
suppress 		onderdruk 
surely 		tog 
surgeon 		chirurg 
surgical 		operasie 
surmise 		meen vermoë veronderstel 
surname 		agternaam van 
surplus 		surplus 
surprise 		verrassing 
surroundings 		omgewing 
survive 		beleef belewe deurmaak 
suspicion 		agterdog 
suspicious 		agterdogtig 
sustain 		ondersteun 
sustained 		aanhoudend permanent vas 
swallow 		sluk 
swan 		swaan 
swap 		inruil wissel 
swarm 		swerm 
swear 		sweer 
swear 		afsweer 
sweeper 		baanveër 
sweet 		lieflik soet 
sweetheart 		beminde geliefde 
sweetness 		beminlikheid beminnenswaardigheid 
swift 		haastig vinnig 
swiftly 		gou in alleryl vinnig 
swim 		dryf swem 
swimming‐bath 		swembad 
swimming‐pool 		swembad 
swindle 		afsettery 
swindler 		afsetter 
swindling 		afsettery 
swine 		swyn vark 
swing 		swaai 
switch 		aanskakel 
switch 		afsit 
switch 		aanskakel 
swoon 		flou word 
swotch 		aktiveer 
sycamore 		ahorn 
syllable 		lettergreep 
symbol 		simbool 
sympathy 		simpatie 
symphony 		simfonie 
system 		stelsel 
system 		belastingstelsel 
table‐cloth 		tafeldoek 
table 		tafel 
tact 		beleid 
tail‐light 		agterlamp agterlig 
tail 		stert 
taint 		bederf 
take 		aanneem aanvaar aksepteer neem 
take 		aandag gee aan bekreun hom 
take 		ageer optree 
take 		meebring saambring 
take 		belangstel in 
take 		beneem 
take 		oppas 
take 		bekommer hom bekreun hom 
take 		aanneem aanvaar aksepteer neem 
take 		aandag gee aan bekreun hom 
take 		afskeid neem 
take 		afskeid neem 
take 		afhaal afsit 
take 		aankoop aanskaf koop 
take 		deelneem 
take 		vervang 
taking 		aankoop 
taking 		aankoop 
tale 		storie verhaal 
talent 		begaafdheid 
talented 		begaaf 
talisman 		amulet 
talk 		gesels praat 
tangle 		baaierd chaos 
tank 		tenk 
tap 		aanboor 
tape 		band 
tapestry 		behang behangsel behangselpapier 
tardy 		laat 
target 		doel oogmerk 
tart 		tert 
task 		taak 
taskmaster 		balju 
taste 		smaak 
tasty 		smaaklik 
taunt 		beskimp 
tax‐collector's 		belastingkantoor 
tax‐free 		belastingvry 
tax 		belas 
taxi‐driver 		taxibestuurder taxidrywer 
taxi 		huurmotor taxi 
taxidriver 		taxibestuurder taxidrywer 
taxpayer 		belastingbetaler belastingpligtige 
tax 		belastingverlaging belastingvermindering 
tax 		belastingdruk 
tax 		belastingverhoging 
tax 		belastingverhoging 
tax 		belastingverlaging belastingvermindering 
tax 		belastingverlaging belastingvermindering 
tax 		belastingstelsel 
tea 		tee 
teach 		afwen 
teacher 		onderwyseres 
tear 		traan 
tear 		afruk afskeur aftrek 
tease 		pla 
technical 		tegnies 
technology 		tegnologie 
teetotaller 		afskaffer 
telegram 		telegram 
telegraph 		telegrafeer 
telephone 		skakel 
television 		beeldradio televisie TV 
television 		televisiestel 
tell 		sê 
temperate 		besadig 
temperature 		temperatuur 
template 		patroon 
temple 		tempel 
templet 		patroon 
temporarily 		provizore 
temporary 		tydelik 
tempt 		bekoor 
temptation 		bekoring versoeking 
ten 		tien 
tendency 		lus 
tender 		aanbesteding 
tend 		verpleeg 
tennis 		tennis 
tenor 		altviool 
tension 		spanning 
tent 		tent 
tented 		kamp 
term 		term 
terminate 		afsluit beëindig eindig 
terms 		beding bedinging bepaling 
terrestrial 		aards 
terrible 		afskuwelik 
test 		eksamen navorsing ondersoek 
testimony 		sertifikaat 
text 		teks 
than 		as 
thank 		bedank dank 
thankful 		dankbaar 
thankless 		ondankbaar 
thanks 		dankie 
thanks 		danksy 
thank 		dankie 
that 		dat 
that 		die daardie daardie een 
that 		so 'n 
that 		die daardie daardie een 
that 		die daardie daardie een 
that 		dit dit daardie 
that 		also so 
the 		die 
theatre 		teater 
thee 		jou 
thee 		jy‐en‐jou 
their 		hulle 
theirs 		hulle s'n 
them 		hulle aan hulle 
theme 		onderwerp 
then 		dan destyds toe 
thence 		daarvandaan 
there 		daar daarso 
thereby 		daarmee 
therefore 		daarom 
these 		dit dit hierdie 
thesis 		stelling 
they 		hulle 
the 		Antarktika 
the 		Noordpool 
the 		Transvaal 
the 		Oekraine 
the 		Vatikaan 
the 		eergister 
the 		suggestie 
the 		dieselfde 
thief 		dief 
thin 		maer skraal 
think 		ag dink 
think 		bedink hom besin oorweeg 
think 		antisipeer 
think 		ag 
third 		derde 
thirsty 		dors 
thirteen 		dertien 
thirty 		dertig 
this 		dit dit hierdie 
this 		vanmiddag 
this 		vanaand 
this 		dit dit hierdie 
this 		hierheen 
those 		dit dit daardie 
thou 		jy 
though 		alhoewel 
thought 		gedagte 
thousand 		duisend 
thrash 		afros 
threat 		bedreiging dreigement 
threaten 		belaag belae 
three‐toed 		ai 
three 		drie 
throat 		keel 
through 		deur met per 
throughout 		dwarsdeur 
throw‐back 		atavisme 
throw 		gooi 
throw 		afwerp 
thumb 		duim 
thus 		dus gevolglik 
thwart 		bemoeilik 
ticket 		kaartjie 
tick 		bekruis 
tidbit 		lekkers 
tidy 		beredder 
tie 		aanbind 
tie 		aanbind 
tie 		bind 
tiger 		tier Indiese tier 
tighten 		aandraai 
till 		tot tot by totdat 
tillage 		akkerbou landbou 
timber 		hout 
time‐table 		rooster 
time 		keer maal 
time 		bedenktyd 
timid 		benepe 
timidity 		bedeesheid 
tin 		blik 
tint 		skakering 
tin 		blik 
tip 		wenk 
tipsy 		aangeskote beneweld 
tire 		band 
tired 		moeg 
tired 		bekaf 
tiresome 		vervelig 
title 		graad 
to 		aan na na ... toe toe vir 
toad 		padda 
toast 		braai 
tobacco 		tabak twak 
today 		vandag 
toe 		toon 
together 		aaneen bymekaar saam 
together 		benewens saam met 
toilet 		toilet 
token 		bewys 
tomato 		tamatie 
tomorrow 		môre 
tomorrow 		môreaand 
tomorrow 		môreoggend 
tone 		toon 
tongue 		taal 
too 		ook 
toothache 		tandpyn 
too 		te 
top 		vermink 
topic 		onderwerp 
topical 		aktueel 
topicality 		aktualiteit 
tortoise 		skilpad 
total 		totaal 
total 		afskaffer 
touch 		aanraak 
touching 		aandoenlik 
touch 		beroer 
tourist 		toeristeburo 
tournament 		toernooi 
tow 		sleep 
toward 		aan na na ... toe toe vir 
towards 		aan na na ... toe toe vir 
tower 		toring 
town 		stad 
to 		haar 
to 		hom 
to 		aan my my 
to 		nogal taamlik 
to 		eintlik 
to 		jou 
to 		hulle aan hulle 
to 		beooste 
to 		links 
to 		regs 
to 		ons 
to 		jou 
track 		baan 
trade 		handel 
tradition 		tradisie 
traditional 		tradisioneel 
traffic 		verkeer 
traffic 		verkeersknoop 
traffic 		verkeersknoop 
traffic 		verkeersknoop 
traffic 		verkeersreëls 
traffic 		verkeersknoop 
tragedy 		tragedie 
train 		trein 
trajectory 		baan 
tranquil 		kalm 
transfer 		oorskry oorsteek 
transgress 		oortree 
transgression 		oortreding sonde 
translate 		vertaal 
translation 		vertaling 
transmit 		oorsend stuur 
transparant 		transparant 
transport 		vervoer 
travel 		ry 
travelled 		bereisd 
treachery 		verraad 
tread 		begaan opgaan 
treasure 		skat 
treat 		behandel 
treatment 		behandeling 
tree‐trunk 		stam 
tree 		boom 
tremble 		beef 
tribe 		stam 
trick 		bedot beethê beetneem 
trifle 		bagatel bakatel 
trip 		reis 
trite 		alledaags banaal 
triteness 		banaliteit 
triviality 		banaliteit 
tropical 		tropies 
trouble 		moeilikheid 
trout 		forel 
truck 		vragmotor 
true 		reg waar werklik 
truly 		darem regtig 
trump 		aftroef 
truncate 		vermink 
trunk 		stam 
trust 		vertrouwe stel in 
trust 		vertroue stel in 
truth 		waarheid 
try 		aanpak beproef beproewe probeer 
try 		aanpas 
tub 		bak 
tube 		buis 
tug 		trek 
tulip 		tulp 
tumult 		lawaai 
tune 		aanpas adapteer 
tup 		ram 
turkey 		kalkoen 
turn 		afslaan draai 
turnpike 		deurpad 
turn 		afsend wegstuur 
turn 		afsit 
turn 		aktiveer 
turn 		benut benuttig 
tussle 		baklei 
twelve 		twaalf 
twenty‐one 		een en twintig een‐en‐twintig 
twenty 		twintig 
twice 		tweekeer 
twin 		tweeling 
twist 		kronkel 
two 		twee 
type 		blokletter 
typical 		eienaardig tipies 
typist 		tikster 
tyre 		band 
ubiquitous 		alomteenwoordig alteenwoordig 
ugly 		lelik 
ultimately 		uiteindelik 
umbrella 		sambreel 
un‐ 		‐loos 
uncle 		oom 
unclean 		vuil 
uncover 		ontdek 
under 		onder 
underhand 		in die geheim 
underneath 		benede onderaan 
understand 		begryp besef verstaan 
understandable 		begrypbaar begryplik 
understandably 		begryplikerwys begryplikerwyse 
understanding 		verband 
undertaker 		begrafnisondernemer 
undertaker's 		begrafnisonderneming 
undress 		ontklee 
unemployed 		arbeidsloos werkloos 
unemployment 		arbeidsloosheid werkloosheid 
unfaithful 		afvallig 
unfortunately 		a foei tog jammer 
ungrateful 		ondankbaar 
unhappy 		ongelukkig 
uniform 		uniform 
unique 		uniek 
unit 		eenheid 
unite 		aaneenvoeg bymekaarbring 
unity 		eenheid 
universal 		alomvattend 
universality 		algemeenheid 
universe 		heelal 
university 		universiteit 
unlearn 		afwen 
unless 		tensy 
unmarried 		ongetroud 
unmarried 		juffrou Mej. Mejuffrou 
unpack 		uitpak 
unroll 		afwikkel 
unrolling 		afwikkeling 
unsocial 		antisosiaal 
unthankful 		ondankbaar 
until 		tot tot by totdat 
untrue 		verkeerd 
unwind 		afwikkel 
unwinding 		afwikkeling 
up‐to‐date 		aktueel 
upon 		jeens om teen 
upset 		bedremmeld deurmekaar verbysterd verward 
upstairs 		bo 
uranium 		uraan 
urgency 		aandrang 
urgent 		dringend 
us 		ons 
use 		benut benuttig gebruik 
used 		uitgeput 
useless 		vrugteloos 
user 		gebruiker 
use 		verorber 
usual 		gewoon 
usually 		gewoonlik 
uterus 		baarmoeder 
utilize 		benut benuttig 
utter 		ontlok uithaal 
vacant 		vakant 
vain 		vrugteloos 
valerian 		balderja balderjan 
valley 		vlei 
valuable 		waardevol 
value 		waarde 
vampire 		vampier 
variety 		variasie 
vast 		uitgestrek 
vat 		bak 
vegetable 		groente 
vehicle 		voertuig 
vein 		aar 
veldt 		veld 
vend 		verkoop 
venture 		aandurf 
veranda 		stoep 
verb 		werkwoord 
verge 		berm 
verge 		berm 
verify 		kontroleer 
vermin 		ongedierte 
verse 		vers 
version 		versie 
very 		baie 
very 		baie 
very 		gaaf uitstekend 
vessel 		bak boks pot 
vice‐versa 		agterstevoor 
victim 		slagoffer 
victory 		oorwinning 
view 		aanblik aansien aansig air aspek 
viewpoint 		standpunt 
vigour 		aktiwiteit 
village 		dorp 
vinegar 		asyn 
viola 		altviool 
violate 		aanrand 
violet 		pers 
violin 		viool 
viper 		adder 
virus 		virus 
visible 		sigbaar 
visit 		kuier 
visitor 		besoeker 
visitor's 		besoekersboek 
vitamin 		vitamien vitamine 
viz. 		naamlik 
vocabulary 		woordeboek 
voice 		stem 
void 		pap 
volcano 		vulkaan 
voltage 		spanning 
volume 		volume 
volunteer 		vrywilliger 
vote 		wys 
voyage 		reis 
vulture 		aasvoël gier 
wage 		salaris 
wages 		salaris 
wage 		oorlog voer 
wage 		bekryg beoorlog beoorloog 
wage 		bekryg beoorlog beoorloog 
wait 		verwag wag wag vir 
waiter 		kelner 
waiting‐room 		wagkamer 
waiting 		bediening 
waiting 		wagkamer 
wait 		verwag wag wag vir 
waive 		afsien van 
walk 		stap 
walk 		begaan opgaan 
wall 		muur 
wall 		behang behangsel behangselpapier 
wander 		afwyk 
wander 		swerf 
wane 		afneem 
want 		behoefte 
war 		oorlog 
warehouse 		afdelingswinkel 
wares 		ware 
warlock 		towenaar 
warm 		innig 
warn 		waarsku 
warning 		waarskuwing 
warrant 		waarborg 
waste‐pipe 		afvoerbuis 
waste 		afval 
waste 		afvalproduk 
watch 		armhorlosie polshorlosie 
watch 		ag slaan op oppas 
water‐colour 		akwarel 
water‐melon 		waatlemoen 
water 		water 
watercourse 		bedding 
wave 		baar 
wave 		swaai 
wax 		was 
way 		baan 
we 		ons 
weak 		swak 
wealthy 		ryk 
wear 		dra 
wear 		afslyt 
wear 		afslyt 
wear 		afslyt 
weasel 		wesel 
weather 		weer 
week‐end 		naweek 
weekly 		weekliks 
weighing 		baskule 
weight 		balans 
welcome 		welkom 
well‐being 		welvaart 
well‐beloved 		beminde geliefde 
well‐known 		bekend 
well‐mannered 		beleef 
well‐off 		ryk 
well‐read 		belese 
well‐to‐do 		bemiddeld 
well 		goed 
well 		toe 
wench 		dogter meisie 
western 		westelik Westers 
wet 		nat 
whale 		walvis 
wharf 		perron 
what 		wat 
what 		as hoe so lyk soos 
what 		hoekom waarom 
what 		watter soort 
what 		hoeveelste 
what 		watter soort 
what 		hoe laat 
wheel 		wiel 
wheeziness 		aamborstigheid asma 
wheezy 		aamborstig asmaties 
when 		as toe wanneer 
whence 		waarvandaan 
where 		waarheen waar ... heen waarnatoe 
whereas 		gedurende terwyl tydens vir 
whereby 		waarmee 
wherefore 		hoekom waarom 
wherein 		waarin 
where 		waarheen waar ... heen waarnatoe 
which 		watter welke 
whichever 		enige 
which 		wie se 
while 		gedurende terwyl tydens vir 
whilst 		gedurende terwyl tydens vir 
whimstone 		basalt 
whip 		roer 
whirl 		roer 
whiskers 		bakbaard bakkebaard 
whiskey 		whisky 
whisky 		whisky 
white 		wit 
white 		blanke witmens 
whither 		waarheen waar ... heen waarnatoe 
who 		wie 
whoever 		enige 
whole 		hele volledig 
wholly 		heeltemal 
whom 		aan wie 
whore 		hoer 
whose 		wie se 
why 		hoekom waarom 
wide 		uitgestrek 
widely‐travelled 		bereisd 
widow 		weduwee 
widower 		wewenaar 
width 		baan 
wife 		gade vrou 
wildebeest 		wildebees 
wild 		wilde vark 
will 		wil 
willing 		bereidvaardig 
willingly 		graag 
willingness 		wil 
willow 		wilgerboom 
win 		behaal verdien wen 
wind 		wind 
windfall 		afval 
window 		venster 
wind 		kronkel 
wind 		afwikkel 
wind 		opwen 
wine 		wyn 
wing 		vleuel 
winged 		aangeskote 
winter 		winter 
win 		verslaan 
wipe 		afvee afveeg afwis 
wipe 		afvee afveeg afwis 
wipe 		uitroei 
wireless 		radio 
wisdom 		wysheid 
wise 		wys 
wisent 		Europese bison 
wish 		begeer verlang 
witch 		heks 
with 		met saam met 
withdraw 		sterf 
withhold 		agterhou 
within 		in binne op per 
without 		sonder 
without 		anoniem 
without 		dadelik 
without 		beslis definitief 
without 		behoudens 
with 		in verband met ten opsigte van 
with 		beset bevrug dragtig gedek swanger 
witness 		bywoon 
wizard 		towenaar 
woe 		aag ag o wêreld 
wolf 		wolf 
wolverine 		veelvraat 
woman 		vrou 
womb 		baarmoeder 
wonder 		wonder 
wonderful 		wonderbaarlik 
wood 		hout 
woods 		bos 
wool 		wol 
word 		woord 
work‐room 		ateljee 
work 		loop werk 
worker 		arbeider werker 
workhouse 		aalmoeseniershuis 
working 		bedryfskapitaal 
working 		werkersklas 
working 		werkersklas 
working 		arbeider werker 
workman 		arbeider werker 
workshop 		ateljee 
work 		afwerk 
world 		wêreld 
worldglobe 		aardbol aardkloot 
worldwide 		alomvattend 
worm 		wurm 
worn 		bekaf 
worry 		sorg 
worship 		aanbidding 
worshipper 		aanbidder 
worship 		erediens 
worth 		waarde 
worth 		besienswaardig 
wound 		wond 
wounded 		aangeskote 
wrangle 		rusie maak 
wrap 		pak 
wreck 		afwys 
wrench 		sleutel 
wretched 		beroerd 
wrist‐watch 		armhorlosie polshorlosie 
write 		skryf 
writer 		skrywer 
write 		afskryf 
writing 		skrif 
written 		skriftelik 
wrong 		onjuis verkeerd 
xylophone 		xilofoon 
yacht 		jag 
yard 		yard 
ye 		julle 
year 		jaar 
yearly 		jaarliks 
yearn 		verlang 
yell 		gil 
yellow 		geel 
yes 		ja 
yesterday 		gister 
yet 		nog 
yew‐tree 		taksisboom 
yield 		afstaan afstand doen van 
yoghourt 		yoghurt 
yoghurt 		yoghurt 
yon 		daar gunder ginder ginds 
yonder 		daar gunder ginder ginds 
you 		u jou julle 
young 		kind 
youngster 		jongmens 
your 		jou 
yours 		joune 
yourself 		uself 
youth 		jongmens 
ytterbium 		ytterbium 
zebra 		sebra 
zest 		animo bedrywigheid 
zirconium 		zirkonium 
zone 		aardgordel 
zoo 		dieretuin 
