〃 		знак "то же самое" 
○ 		круг ноль 
ＣＤプレーヤー 		CD плеер проигрыватель компакт-дисков 
明白 		очевидный 
明白 		очевидный 
彼処 		там (место удалённое от всех участников беседы) 
彼の 		тот (предмет удалённый от всех участников беседы) 
あの人 		он она тот человек 
あの方 		он она тот человек 
あべこべ 		наоборот 
否々 		никоим образом ни в коем случае 
いそいそ 		радостно в предвкушении 
いらっしゃいませ 		"добро пожаловать" (приветствие в магазинах к покупателю, и т. п.) 
いらっしゃる 		идти приходить находиться 
うん 		да 
ええ 		да 
おおい 		"эй!" 
お蔭 		благодаря 
お休みなさい 		"спокойной ночи" 
お宮 		синтоистский храм 
お金 		деньги 
お兄さん 		старший брат 
お見えになる 		приходить прибывать 
お姉さん 		старшая сестра 
お辞儀 		поклон 
お手洗い 		туалет уборная 
お嬢さん 		(1) дочь (2) девушка 
お前 		ты 
お祖父さん 		дедушка 
お祖母さん 		бабушка 
お早うございます 		"доброе утро" 
お茶 		чай (зелёный) 
お土産 		подарок сувенир 
お父さん 		отец 
お風呂に入る 		принимать ванну 
お腹 		желудок живот 
お母さん 		мать 
お話し中 		занято (телефонный сигнал) 
からから 		пересохший 
きらきら 		искриться 
ぎこちない 		неуклюжий неестественный 
けど 		однако но 
こそ 		именно 
こんにちわ 		"добрый день" (искажённое написание и произношение) "добрый день" (искажённое написание) 
此れから 		после этого сейчас теперь (о предстоящем действии) 
こんな 		такой 
ご心配なく 		"не беспокойтесь" 
さえ 		даже 
さん 		-сан (суффикс уважительного обращения после имени, должности или рода занятий) господин госпожа уважаемый 
屡々 		часто 
じゃが芋 		картофель 
ずっと 		(1) гораздо значительно (2) всё время непрерывно 
そう 		да так 
其処 		там (место рядом с собеседником) 
然して 		и затем 
漫ろに 		невольно почему-то как-то 
そぞろ歩き 		(бесцельная) прогулка 
其の 		этот (рядом с собеседником) тот 
その上 		кроме того в дополнение 
その他 		прочее и так далее 
その内 		как-нибудь тем временем 
そよ風 		ветерок 
其れ 		это (рядом с собеседником) то 
其れから 		затем 
たった 		только 
だから 		потому поэтому 
丈 		только 
ちゃんこ鍋 		обед для набора веса борца сумо 
序でに 		кстати вскользь 
では 		итак тогда в таком случае 
として 		в качестве как 
迚も 		очень 
如何 		как 
どうやって 		каким образом 
どう致しまして 		"не стоит благодарности" 
何方も 		оба 
どの位 		сколько примерно как далеко как долго какого размера 
何れ 		который какой 
ニヤニヤ 		ухмылка 
のに 		хотя 
のみ 		только 
のみならず 		не только 
のろのろ 		(крайне) медленно 
はい 		да "слушаюсь" 
只管 		настойчиво 
ひょっとすると 		может быть быть может 
ぴかぴか 		сверкание блеск 
ぺこぺこ 		сильно проголодаться 
ペテン師 		мошенник 
ほら 		"смотри!" 
もう 		уже 
若しかしたら 		может быть быть может 
若しかすると 		может быть быть может 
もしもし 		"алло" 
もっと 		более ещё 
やくざ 		якудза 
やり方 		путь метод подход 
遣る 		делать давать 
ゆっくり 		медленно не торопясь 
らしい 		похожий 
アーカイブ 		архив архивный 
アーキテクチャ 		архитектура 
アーチェリー 		стрельба из лука (en: archery) 
アーティフィシャルインテリジェンス 		искусственный интеллект 
アイシャドウ 		тени для век (en: eye shadow) 
アイス 		лёд 
アイスクリーム 		мороженое 
アイスホッケー 		хоккей на льду 
アイソトープ 		изотоп 
アイヌ 		айну 
アイボリー 		слоновая кость 
アイメイト 		собака-поводырь (en-trans: eye mate) 
アイロニー 		ирония 
アイロン 		(1) утюг (2) железо 
アインスタイニウム 		эйнштейний (Es) 
アウトバーン 		автострада автомагистраль автобан 
アウトロー 		(1) преступник (2) объявленный вне закона изгнанник (en: outlaw) 
アウラ 		аура 
アカシア 		акация 
アコースティック 		акустический 
アクシデント 		(1) случайность (2) несчастный случай (en: accident) 
アクセス 		доступ 
アクセル 		акселератор 
アクセラレータ 		акселератор 
アクセント 		акцент 
アクトレス 		актриса 
アクリル 		акриловый 
アクロバット 		акробат 
アグレッシブ 		агрессивный 
アコーディオン 		аккордеон 
アゴラフォビア 		агорафобия 
アシスタント 		ассистент 
アシスト 		помощь содействие ассистирование 
アジト 		(1) укрытие секретная база (2) агитпункт 
アスタチン 		астат (At) 
アストロロジー 		астрология 
アスピリン 		аспирин 
アスファルト 		асфальт 
アスファルトジャングル 		асфальтовые джунгли 
アスベスト 		асбест 
アスリート 		атлет спортсмен 
アセチルコリン 		ацетилхолин 
アセトン 		ацетон 
アタック 		атака 
アダージョ 		адажио 
アダプター 		адаптер 
アダルト 		взрослый совершеннолетний 
アップデート 		обновление (en: update) 
アト 		атто- 10^-18 
アトム 		атом 
アド 		реклама (en: ad) 
アドバイス 		совет 
アドバタイジング 		рекламирование 
アドバタイズメント 		реклама 
アドレス 		адрес 
アドレナリン 		адреналин 
アナーキー 		анархия 
アナーキスト 		анархист 
アナーキズム 		анархизм 
アナウンサー 		диктор (en: announcer) 
アナリスト 		аналитик 
アナログ 		аналог 
アナログ計算機 		аналоговая вычислительная машина аналоговый компьютер 
アナロジー 		аналогия 
アニマル 		животное (en: animal) 
アニメ 		анимация 
アニメーション 		анимация 
アニメーター 		аниматор 
アノニマス 		аноним анонимный 
アノニム 		аноним 
アパート 		(1) жилой дом (многоквартирный) (2) квартира (в большом доме) 
アパルトヘイト 		апартеид 
アフォリズム 		афоризм 
アブソリューティズム 		абсолютизм 
アベニュー 		авеню 
アベレージ 		средний  
アマ 		неспециалист непрофессионал любитель (en: amateur) 
アマチュア 		неспециалист непрофессионал любитель (en: amateur) 
アミ 		друг 
アミノ酸 		аминокислота 
アミューズメント 		развлечение (en: amusement) 
アムール 		любовь 
アムネスティ 		амнистия помилование 
アメーバ 		амёба 
アメフト 		американский футбол 
アメラグ 		американское регби 
アラー 		Аллах 
アラブ 		араб 
アリーナ 		арена 
アリア 		ария 
アリストクラシー 		аристократия 
アリバイ 		алиби 
アルカイズム 		архаизм 
アルカリ 		щёлочь (en: alkali) 
アルカリ性 		щелочной 
アルコーブ 		альков 
アルコール 		алкоголь 
アルゴリズミック 		алгоритмический 
アルゴリズム 		алгоритм 
アルバトロス 		альбатрос 
アルバム 		альбом 
アルピニスト 		альпинист 
アルファベット 		алфавит 
アルプス 		Альпы 
アルミ 		алюминий (Al) 
アルミニウム 		алюминий (Al) 
アル中 		алкоголизм 
アレイ 		массив матрица (en: array) 
アレキサンドライト 		александрит 
アレルギー 		аллергия 
アワー 		час 
アングラ 		подполье подземелье андеграунд 
アンケート 		анкета 
アンサンブル 		ансамбль 
アンソロジー 		антология 
アンダーグラウンド 		подполье подземелье андеграунд 
アンダーライン 		подчёркивание 
アンチテーゼ 		антитеза антитезис полная противоположность 
アンテナ 		антенна 
アントニム 		антоним 
アンド 		и (en: and) амперсанд 
アンドウトラワ 		раз, два, три (fr: un, deux, trois) 
アンドロイド 		андроид 
アンペア 		ампер 
イーグル 		орёл 
イージー 		лёгкий несложный (en: easy) 
イースター 		пасха 
イースト 		восток (en: east) 
イエロー 		жёлтый 
英吉利 		Англия 
イクラ 		икра 
イグアナ 		игуана 
イコン 		икона 
イスタンブール 		Стамбул 
イスラム 		ислам 
イズム 		-изм 
イデオローグ 		идеология 
イデオロギー 		идеология 
イニシアティブ 		инициатива 
イブニング 		вечер (en: evening) 
イミテーション 		имитация 
イメージ 		образ изображение имидж 
イヤリング 		серьга 
イラク 		Ирак 
イラスト 		рисунок иллюстрация 
イラストレーション 		рисунок иллюстрация 
イラストレーター 		художник иллюстратор 
イリーガル 		незаконный нелегальный противозаконный запрещённый (en: illegal) 
イリジウム 		Иридий (Ir) 
イリノイ 		Иллинойс 
イリュージョン 		иллюзия 
イルージョン 		иллюзия 
イレブン 		одиннадцать 
イロコイ 		ирокез 
インク 		чернила 
イングランド 		Англия 
インスリン 		инсулин 
インストラクター 		инструктор 
インセスト 		инцест 
インターナショナル 		интернациональный 
インターフェロン 		интерферон 
インタビュー 		интервью 
インタラクティブ 		интерактивный 
インダストリー 		индустрия 
インダストリアル 		индустриальный 
吋 		дюйм 
インチキ 		мошенничество обман 
インテグレーション 		интеграция 
インディアナ 		Индиана 
インディペンデント 		независимый (en: independent) 
インデックス 		индекс 
インフォメーション 		информация 
インプット 		ввод (en: input) 
インペリアル 		имперский 
インポート 		импорт 
ウーマン 		женщина 
ウィークリー 		недельный еженедельный (en: weekly) 
ウィスキー 		виски 
ウィンター 		зима 
ウィンドウ 		окно 
ウインド 		ветер 
ウィ 		да 
ウィークポイント 		слабое место (en: weak point) 
ウイット 		остроумие (en: wit) 
ウイルス 		вирус 
ウインク 		моргание мигание подмигивание 
ウイング 		крыло 
ウィンドサーフィン 		виндсёрфинг 
ウェイター 		официант 
ウェイトレス 		официантка 
ウエーブ 		волна 
ウエスト 		талия 
ウェディングドレス 		свадебное платье подвенечное платье 
ウェルカム 		добро пожаловать 
ウォッカ 		водка 
ウォン 		вона (корейская денежная единица) 
ウォッチング 		наблюдение (en: watching) 
ウッド 		дерево (en: wood) 
ウムラウト 		умляут 
ウラニウム 		уран (U) 
ウルトラ 		ультра 
ウルフ 		волк 
エーカー 		акр 
エージェント 		агент 
エア 		воздух 
エアコン 		(воздушный) кондиционер 
エアゾール 		аэрозоль 
エアメール 		авиапочта (en: air mail) 
エアライフル 		духовое ружьё пневматическое ружьё (en: air rifle) 
エアロビクス 		аэробика 
エイト 		восемь (en: eight) 
エイリアン 		чужой иностранный (en: alien) 
エクストラ 		экстра 
エキゾチック 		экзотика экзотический 
エクソシスト 		экзорцист 
エコー 		эхо 
エコノミスト 		экономист 
エコロジー 		экология 
エスカレーター 		эскалатор 
エステティック 		эстетический 
エストニア 		Эстония 
エスニック 		этнический 
エスペラント 		эсперанто 
エチケット 		этикет 
エチュード 		этюд 
エチレン 		этилен 
Ｘ線 		рентгеновские лучи 
エナジー 		энергия 
エネ 		энергия 
エネルギー 		энергия 
エピソード 		эпизод 
エプロン 		фартук передник (en: apron) 
エペ 		шпага (fr: epee) 
エホバ 		Иегова 
エボナイト 		эбонит 
エポック 		эпоха 
エミグラント 		эмигрант 
エメラルド 		изумруд 
エラー 		ошибка 
エリート 		элита 
エリア 		зона область 
エレガント 		элегантный 
エレキ 		электрогитара 
エレキギター 		электрогитара 
エレクトロニクス 		электроника электронная аппаратура (en: electronics) 
エレベーター 		лифт 
エレメント 		элемент 
エロ 		эротика эротический 
エンジニア 		инженер 
エンジン 		двигатель мотор (en: engine) 
エンジェル 		ангел 
エンディング 		окончание конец завершение заключительная часть 
エントリー 		(1) вход (2) запись (en: entry) 
エンド 		конец 
エンドレス 		бесконечный (en: endless) 
エンバシー 		посольство 
エンブレム 		эмблема 
エンペラー 		император 
オーク 		орк 
オークション 		аукцион 
オーケストラ 		оркестр 
オーシャン 		океан 
オーダー 		порядок (en: order) 
オーディオ 		(1) звуковой (2) звукозаписывающий звуковоспроизводящий (3) звукозаписывающая аппаратура звуковоспроизводящая аппаратура 
オーデコロン 		одеколон 
オートクチュール 		высокая мода от кутюр 
オートバイ 		мотоцикл (en-trans: auto-bike) 
オーバー 		пальто 
オーバーヒート 		перегрев 
オーブン 		духовка 
オープニング 		начало вступление 
オーボエ 		гобой 
オーラ 		аура 
オールマイティー 		всемогущий 
オアシス 		оазис 
オイディプス 		Эдип 
オカリナ 		окарина 
オカルト 		оккультный 
オクラホマ 		Оклахома 
オケ 		оркестр 
オゾン 		озон 
オゾンホール 		озоновая дыра 
オックスフォード 		Оксфорд 
オハイオ 		Огайо 
オフィシャル 		официальный 
オフィス 		офис 
オフロード 		внедорожник (en: off-road) 
オペラ 		опера 
オペレーター 		оператор 
オランウータン 		орангутанг 
和蘭 		Голландия 
オリエンタル 		восточный азиатский (en: oriental) 
オリオン 		Орион 
オリゴマー 		олигомер 
オルガスム 		оргазм 
オレンジ 		апельсин 
オレンジエード 		оранжад (напиток) 
オレンジジュース 		апельсиновый сок 
オンエア 		в эфире (en: on air) 
オンス 		унция (28.35г) 
オンライン 		онлайн 
カーソル 		курсор 
カーテン 		занавеска штора 
カートリッジ 		картридж 
カーニバル 		карнавал 
カウボーイ 		ковбой 
カウンター 		(1) счётчик (2) контратака (3) стойка отдел 
カウンターアタック 		контратака 
カオス 		хаос 
カクテル 		коктейль 
カジノ 		казино 
カセット 		кассета (en: cassette) 
カタパルト 		катапульта 
型録 		каталог 
カテゴリー 		категория 
カテドラル 		кафедральный собор 
カドミウム 		кадмий (Cd) 
金糸雀 		канарейка 
カバー 		обложка 
カメラ 		камера фотоаппарат 
カメレオン 		хамелеон 
カモフラージ 		камуфляж 
カヤック 		каяк 
カラー 		цвет (en: color) 
空オケ 		караоке 
カラット 		карат 
カリウム 		калий (K) 
カリスマ 		обаяние харизма 
カリフォルニア 		Калифорния 
カリフラワー 		цветная капуста (en: cauliflower) 
カルシウム 		кальций (Ca) 
カルテ 		медицинская карта 
カルテット 		квартет 
カルテル 		картель 
カレンシー 		валюта (en: currency) 
カレンダー 		календарь (en: calendar) 
カロチン 		каротин 
カンガルー 		кенгуру 
カンザス 		Канзас 
ガーゴイル 		горгулья 
ガードマン 		охранник 
ガードレール 		перила ограждение 
ガール 		девушка девочка (en: girl) 
ガイド 		экскурсовод 
ガストアルバイター 		гастарбайтер 
ガスボンベ 		газовая бомба химическая бомба 
ガスマスク 		противогаз 
硝子 		стекло 
ガリウム 		галлий (Ga) 
ガレージ 		гараж 
ガロン 		галлон (мера объёма = 4,54л) 
キー 		(1) ключ (2) клавиша 
キーボード 		клавиатура 
キウイ 		киви 
キオスク 		киоск 
キック 		пинок 
キッチン 		кухня (en: kitchen) 
キット 		набор (инструментов и т. п.) 
キメラ 		химера 
キャタピラー 		гусеница 
キャッシング 		кэширование 
キャビア 		чёрная икра 
キャピタリズム 		капитализм 
キャプテン 		капитан 
キャベツ 		(кочанная) капуста 
キャメル 		верблюд 
キャラクター 		персонаж (en: character) 
キャリア 		карьера 
キャンセル 		отмена 
キャンバス 		канва 
キャンパス 		кампус 
キャンプ 		лагерь 
キュー 		очередь 
キュート 		прелестный очаровательный милый (en: cute) 
キラー 		убийца (en: killer) 
キリスト教 		христианство христианская религия 
キリル 		кириллический 
キリル文字 		кириллический символ 
キロ 		кило- килограмм километр 10^3 
キロワット 		киловатт 
キング 		король (en: king) 
ギガ 		гига- 10^9 
ギター 		гитара 
ギタリスト 		гитарист 
ギプス 		гипс 
ギャルソン 		гарсон 
ギリシャ神話 		греческая мифология 
ギルド 		гильдия 
ギロチン 		гильотина 
クイーン 		королева (en: queen) 
クイック 		быстрый (en: quick) 
クエーサー 		квазар 
クライアント 		клиент 
クラウン 		корона 
クラス 		класс (en: class) 
クラスメイト 		одноклассник (en: classmate) 
クラブ 		клуб (en: club) 
クラン 		клан 
クリーム 		крем 
クリエーター 		создатель 
クリスマス 		рождество 
クリニック 		клиника 
クレー 		глина 
クレジットカード 		кредитная карточка 
クレッシェンド 		крещендо 
クレムリン 		Кремль 
クロークルーム 		гардероб 
クローン 		клон 
クロス 		крест (en: cross) 
クロスワード 		кроссворд 
クロム 		хром (Cr) 
クワイア 		хор 
クワルテット 		квартет 
グアテマラ 		Гватемала 
グライコ 		графический эквалайзер 
グラス 		(1) стекло (2) трава 
グラスノスチ 		гласность 
グラスファイバー 		стекловолокно 
グラチェ 		спасибо (it: grazie) 
グラフィックイコライザー 		графический эквалайзер 
グランプリ 		гран-при 
グリーンティー 		зелёный чай (en: green tea) 
グリーンハウス 		теплица (en: greenhouse) 
グリーンランド 		Гренландия 
グリル 		гриль 
グルー 		клей (en: glue) 
グループ 		группа 
グルジア 		Грузия 
グルメ 		гурман (en: gourmet) 
グレー 		серый серый (en: gray) 
グレート 		великий большой (en: great) 
グレープフルーツ 		грейпфрут 
グローバリズム 		глобализм 
グローバル 		глобальный 
グロテスク 		гротеск 
ケーオー 		нокаут 
ケーキ 		торт пирог 
ケース 		случай обстоятельство (en: case) 
ケーブル 		кабель 
ケチャップ 		кетчуп 
ケベック 		Квебек 
ケミカル 		химический 
ケンタッキー 		Кентукки 
ゲーム 		игра 
ゲシュタポ 		Гестапо 
ゲスト 		гость 
ゲットー 		гетто 
ゲノム 		геном 
ゲリラ 		партизан партизанский 
ゲリラ戦 		партизанская война 
ゲリラ兵 		партизан 
ゲン 		ген 
コース 		курс 
コーディネーター 		координатор 
コード 		(1) код (en: code) (2) провод шнур (en: cord) 
コードレス 		беспроводный 
珈琲 		кофе 
コーポレーション 		корпорация 
コーラ 		кола 
コーラン 		Коран 
コールサイン 		позывной (en: call sign) 
コアラ 		коала 
コイン 		монета (en: coin) 
コカイン 		кокаин 
ココア 		какао 
コスチューム 		костюм 
コスモ 		космос 
コスモス 		космос 
コックピット 		кабина кокпит 
コップ 		стакан 
コテージ 		коттедж 
コネ 		связи 
コバルト 		кобальт (Co) 
コピー 		копия 
コブラ 		кобра 
コペルニクス 		Коперник 
コミック 		комикс 
コミックス 		комикс 
コミンテルン 		Коминтерн 
コムソモール 		Комсомол 
コメント 		комментарий 
コリア 		Корея 
コルホーズ 		колхоз 
コレクション 		(1) коллекция собрание (2) исправление коррекция 
コレステロール 		холестерин 
コロナ 		корона ореол (en: corona) 
コロニー 		колония 
コロラド 		Колорадо 
コンクール 		конкурс 
混凝土 		бетон 
コンゴ 		Конго 
コンサート 		концерт 
コンシューマー 		потребитель (en: consumer) 
コンセント 		(электрическая) розетка (en: concentric (plug)) 
コンソーシアム 		консорциум 
コンタクト 		контакт 
コンテスト 		соревнование (en: contest) 
コントラスト 		контраст 
コントロール 		управление контроль (en: control) 
コンドル 		кондор 
コンパス 		компас 
コンビ 		комбинация (en: combination) 
コンビナート 		комбинат 
コンビニ 		поздно закрывающийся или круглосуточный магазин 
コンビニエンスストア 		поздно закрывающийся или круглосуточный магазин 
コンビネーション 		комбинация (en: combination) 
コンピュータ 		компьютер 
コンピューターグラフィックス 		компьютерная графика 
コンプレックス 		комплекс 
コンプレッサー 		компрессор 
コンボイ 		конвой 
コンマ 		запятая 
ゴースト 		привидение (en: ghost) 
ゴーストタウン 		опустевший город город-призрак (en: ghost town) 
ゴール 		(1) цель (en: goal) (2) гол 
ゴールキーパー 		вратарь голкипер 
ゴールデン 		золотой 
ゴールド 		золото (en: gold) 
蜚蠊 		таракан 
ゴスバンク 		Госбанк 
ゴリラ 		горилла 
ゴルフ 		гольф 
ゴング 		гонг 
サーカス 		цирк 
サーキット 		цепь (электрическая) контур 
サークル 		круг кружок (по интересам) 
サーチ 		поиск 
サーバント 		слуга 
サービス 		(1) обслуживание система обслуживания служба поддержки (2) бесплатные товары или услуги 
セイバー 		сабля 
サイエンス 		наука (en: science) 
サイズ 		размер (en: size) 
サイン 		(1) подпись (2) знак (en: sign) 
サウナ 		сауна 
サウンド 		звук 
サウンドトラック 		звуковая дорожка (en: sound track) 
サクセス 		успех достижение благоприятный исход (en: success) 
サザンクロス 		Южный Крест 
サターン 		Сатурн 
サタン 		сатана 
サッカー 		футбол 
察 		полиция 
サディスティック 		садистский 
サディスト 		садист 
サハラ 		Сахара 
サハラ砂漠 		пустыня Сахара 
サファイア 		сапфир 
サポート 		поддержка (en: support) 
サミズダート 		самиздат 
サモワール 		самовар 
サラダ 		салат 
サラファン 		сарафан 
サンキュー 		спасибо 
サンスクリット 		Санскрит 
サントラ 		звуковая дорожка (en: sound track) 
サンドイッチ 		сэндвич бутерброд 
サンボ 		самбо 
シークレット 		секрет 
シーツ 		простыня (en: sheet) 
シールド 		щит 
シアン 		голубой циан 
シエスタ 		сиеста 
シオニスト 		сионист 
シオニズム 		сионизм 
シカゴ 		Чикаго 
シグナチャー 		подпись сигнатура 
シグナル 		сигнал 
シスター 		сестра 
システム 		система 
シソーラス 		тезаурус 
シチュエーション 		ситуация 
シップ 		корабль судно (en: ship) 
シノニム 		синоним 
シミュレーション 		симуляция имитация моделирование (en: simulation) 
シミュレーター 		симулятор 
シャーマン 		шаман 
シャドー 		тень (en: shadow) 
シャボン玉 		мыльный пузырь 
シャワー 		душ (en: shower) 
三鞭酒 		шампанское 
シャンプー 		шампунь 
シュルレアリスム 		сюрреализм 
シュガー 		сахар (en: sugar) 
ショーウインドー 		витрина 
ショック 		шок 
ショップ 		магазин (en: shop) 
シリウス 		Сириус 
シリンダー 		цилиндр 
シルエット 		силуэт 
シルク 		шёлк 
シロップ 		сироп 
シンドローム 		синдром 
シンボル 		символ 
ジープ 		джип 
ジーン 		ген генный 
ジーンエンジニアリング 		генная инженерия 
ジーンズ 		джинсы 
ジーンバンク 		банк генов 
ジェット 		реактивный 
ジェットエンジン 		реактивный двигатель 
ジェット機 		реактивный самолёт 
ジェノサイド 		геноцид 
ジハード 		джихад  
ジャーナリスト 		журналист 
ジャイアント 		гигант 
ジャイロスコープ 		гироскоп 
ジャガー 		ягуар 
ジャスミン 		жасмин 
ジャズ 		джаз 
ジャパン 		Япония (en: Japan) 
ジャム 		варенье джем 
ジャングル 		джунгли 
ジャンパー 		джемпер 
ジャンプ 		прыжок (en: jump) 
ジュース 		сок фруктовый напиток 
ジュール 		джоуль 
ジュピター 		Юпитер 
ジョイスティック 		джойстик 
ジラフ 		жираф 
ジレンマ 		дилемма 
スーパー 		(1) супер (2) супермаркет 
スーパーコンピューター 		суперкомпьютер 
スーパースター 		суперзвезда 
スーパーソニック 		сверхзвуковой 
スーパータンカー 		супертанкер 
スーパーマーケット 		супермаркет 
スープ 		суп 
スイッチ 		включатель переключатель (en: switch) 
スカート 		юбка (en: skirt) 
スカイ 		небо (en: sky) 
スキー 		лыжи 
スキャナー 		сканер 
スキン 		кожа (en: skin) 
スクール 		школа 
スクエア 		квадрат (en: square) 
スクリーン 		экран 
スケート 		коньки 
スケジュール 		расписание программа (поездки, пребывания и т. п.) 
スケルトン 		скелет 
スコール 		шквал 
スター 		звезда 
スターズアンドストライプス 		"звёзды и полосы" государственный флаг США (en: Stars and Stripes) 
スタート 		старт 
スタイル 		стиль 
スチーム 		пар (en: steam) 
スチュワーデス 		стюардесса бортпроводница 
スチュワード 		стюард 
ステーキ 		бифштекс 
ステージ 		сцена 
ステータス 		статус 
スティック 		(1) палка (en: stick) (2) джойстик 
ステレオ 		стерео 
ステレオタイプ 		стереотип 
ステロイド 		стероид 
ステンレス 		нержавеющий (en: stainless) 
ステンレススチール 		нержавеющая сталь (en: stainless steel) 
スト 		забастовка 
ストーム 		шторм 
ストイチズム 		стоицизм 
ストックホルム 		Стокгольм 
ストライキ 		(1) забастовка (2) удар 
ストライク 		(1) забастовка (2) удар 
ストレス 		стресс 
ストローハット 		соломенная шляпа 
ストロベリー 		клубника земляника (en: strawberry) 
ストロンチウム 		стронций (Sr) 
スノー 		снег (en: snow) 
スパーク 		искра 
スパイ 		шпион 
スパイダー 		паук (en: spider) 
スパイラル 		спираль 
スパイ行為 		шпионаж 
スパゲティ 		спагетти 
スピード 		скорость 
スピリット 		дух (en: spirit) 
獅子女 		сфинкс 
スプーン 		ложка 
スペシャル 		специальный особый (en: special) 
スポーツ 		спорт 
スポーツウーマン 		спортсменка 
スポーツマン 		спортсмен 
スポンサー 		спонсор 
スポンジ 		губка (en: sponge) 
スマイル 		улыбка 
スモッグ 		смог 
スラローム 		слалом 
スレイブ 		раб 
スローガン 		лозунг 
スロバキア 		Словакия 
スロベニア 		Словения 
ズボン 		брюки 
セーター 		свитер 
セーブ 		спасение сохранение (на электронный носитель) 
セールス 		продажи (en: sales) 
セクター 		сектор 
セシウム 		цезий (Cs) 
セピア 		сепия 
セブン 		семь (en: seven) 
セミナー 		семинар 
セメント 		цемент 
セラミック 		керамика 
セリウム 		церий (Ce) 
セルフ 		сам само- (en: self) 
セルフサービス 		самообслуживание 
セルロイド 		целлулоид 
セレモニー 		церемония 
センサー 		сенсор 
センター 		центр 
センチ 		сантиметр санти- 10^-2 
センチメートル 		сантиметр 
仙 		цент 
ゼロックス 		Ксерокс 
ソーセージ 		колбаса сосиска 
ソックス 		носки (en: socks) 
ソナタ 		соната 
ソファ 		диван софа 
ソフトウェア 		программное обеспечение (en: software) 
ソプラノ 		сопрано 
ソユーズ 		Союз (название космического корабля) 
ソロ 		соло 
ソ連 		Советский Союз 
ゾーン 		зона 
ゾンビ 		зомби 
ターバン 		тюрбан 
タービン 		турбина 
ターボ 		турбо 
タイピング 		набор (на клавиатуре, печатной машинке и т. д.) 
タイプライター 		пишущая машинка 
タイマー 		таймер 
タイム 		время 
タイムマシン 		машина времени 
タオル 		полотенце 
タクシー 		такси 
タッチ 		прикосновение 
タリウム 		таллий (Tl) 
タワー 		башня (en: tower) 
タンカー 		танкер 
タンザニア 		Танзания 
ダーク 		тёмный (en: dark) 
ダイアグラム 		диаграмма 
ダイオード 		диод 
ダイナマイト 		динамит 
ダイヤモンド 		алмаз бриллиант (en: diamond) 
ダメージ 		повреждение 
ダンサー 		танцор (en: dancer) 
ダンス 		танец 
チーズ 		сыр 
チーム 		команда 
チームワーク 		сыгранность (en: teamwork) 
チェーン 		цепь (en: chain) 
チェス 		шахматы (en: chess) 
チェックイン 		регистрация 
チェックサム 		контрольная сумма 
チェリー 		вишня (en: cherry) 
チケット 		билет 
チタン 		титан (Ti) 
チャーチ 		церковь 
チャイナ 		Китай 
チャネル 		канал (en: channel) 
チャンピオン 		чемпион 
チョーク 		мел 
チョコレート 		шоколад 
チルダ 		тильда 
ツール 		инструмент приспособление 
ツアー 		экскурсия 
テーゼ 		тезис 
テーブル 		стол 
テープレコーダー 		магнитофон 
ティー 		чай 
テキサス 		Техас 
テキスト 		текст 
テク 		технология 
テクスチャ 		текстура 
テクノロジー 		технология 
テスター 		тестер испытатель 
テスト 		тест 
テニス 		теннис 
テラス 		терраса 
テレカンファレンス 		телеконференция 
テレグラフ 		телеграф 
テレビ 		телевизор телевидение 
テレビジョン 		телевидение 
テレビ局 		телекомпания телестанция 
テレフォンカード 		телефонная карта 
テレホン 		телефон 
テレホンセックス 		секс по телефону 
テロリスト 		террорист 
テロリズム 		терроризм 
テンソル 		тензор 
テンダーロイン 		вырезка филей 
テント 		палатка 
テンポラリー 		временный 
データ 		данные 
データバンク 		банк данных 
データ処理 		обработка данных 
デーモン 		демон 
デーリー 		ежедневный (en: daily) 
ディクショナリ 		словарь 
ディスク 		диск 
ディスクジョッキー 		диск-жокей 
ディスプレイ 		дисплей 
ディバイス 		устройство 
ディメンション 		измерение 
デコーダ 		дешифровщик декодер 
デザート 		(1) десерт (2) пустыня 
デザイナー 		дизайнер 
デザイン 		дизайн 
デシ 		деци- 
デシベル 		децибел 
デジタル 		цифровой 
デジタルスピードメーター 		цифровой спидометр 
デジタルテレビ 		цифровое телевидение 
デッド 		мёртвый 
デノミ 		деноминация 
デバイス 		устройство 
デパート 		универмаг 
デパートメントストア 		универмаг 
デビュー 		дебют 
デビュタント 		дебютант 
デビル 		дьявол (en: devil) 
デモクラシー 		демократия 
デモクラット 		демократ 
デンバー 		Денвер 
トーナメント 		турнир 
トイレ 		туалет 
トイレット 		туалет 
トイレットペーパー 		туалетная бумага 
トポロジー 		топология 
トマト 		помидор 
トマホーク 		томагавк 
トライアスロン 		триатлон 
トライアングル 		треугольник 
トラック 		(1) грузовик (2) беговая дорожка 
トラップ 		ловушка (en: trap) 
トリウム 		торий (Th) 
トリニティー 		троица 
トリニトロトルエン 		ТНТ тринитротолуол 
トリプル 		тройной 
トレードマーク 		торговая марка (en: trademark) 
トレーナー 		тренер 
トレーニング 		тренировка 
トロント 		Торонто 
ドア 		дверь (en: door) 
ドイツ人 		немец 
ドイツ民主共和国 		Германская Демократическая Республика ГДР 
ドクター 		доктор 
ドクトリン 		доктрина 
ドナー 		донор 
ドライクリーニング 		химчистка сухая очистка 
ドラゴン 		дракон 
ドラマ 		драма 
ドレス 		платье (en: dress) 
ナース 		медсестра (en: nurse) 
ナイジェリア 		Нигерия 
ナイト 		(1) ночь (en: night) (2) рыцарь (en: knight) 
ナイトクラブ 		ночной клуб (en: nightclub) 
ナイフ 		нож 
尼羅 		Нил 
ナイロン 		нейлон 
ナイン 		(1) нет (2) девять 
ナチズム 		нацизм 
ナトリウム 		натрий (Na) 
ナノ 		нано- 10^-9 
ナプキン 		салфетка 
ナルシシズム 		нарциссизм 
ナンバー 		номер (en: number) 
ニコチン 		никотин 
ニコニコ 		улыбка 
ニッケル 		никель (Ni) 
ニュー 		новый новинка 
ニュース 		новости 
ニュートン 		Ньютон 
ネーム 		имя 
ネット 		сеть 
ネバダ 		Невада 
ノート 		тетрадь 
ノーベル賞 		Нобелевская премия 
ノイズ 		шум (en: noise) 
ノックダウン 		нокдаун 
ノミネーション 		выдвижение номинация 
ノミネート 		выдвигать номинировать 
ハート 		сердце 
ハイエナ 		гиена 
ハイクオリティ 		высокое качество 
ハイテク 		высокотехнологичный 
ハイドロプレーン 		гидроплан гидросамолёт 
ハイドロポニック 		гидропоника 
ハイブリッド 		гибрид 
ハイヤー 		машина напрокат 
ハム 		ветчина 
ハラショー 		хорошо 
ハングル 		хангыль (корейская письменность) 
ハンター 		охотник 
ハンバーガー 		гамбургер 
ハンマー 		молот молоток 
バー 		бар 
バージョン 		версия 
バースデー 		день рождения 
バーチャル 		виртуальный 
バーチャルリアリティ 		виртуальная реальность 
バーテン 		бармен 
バーミューダトライアングル 		Бермудский треугольник 
バーミンガム 		Бирмингем 
バイアスロン 		биатлон 
バイオテクノロジー 		биотехнология 
バイキング 		шведский стол 
バイブル 		библия 
バカンス 		выходной отпуск каникулы отдых 
バクテリア 		бактерия 
バグダッド 		Багдад 
バケツ 		ведро (en: bucket) 
バス 		(1) автобус (en: bus) (2) ванна (en: bath) (3) бас (en: bass) (4) окунь (en: bass) 
バスケット 		корзина 
バスケットボール 		баскетбол 
バスルーム 		ванная 
バス停 		автобусная остановка 
バス発着場 		автобусное депо 
バター 		масло 
バタフライ 		бабочка (en: butterfly) 
バッグ 		(1) ошибка (в программе или электронике) (2) сумка (3) жучок (подслушивающее или следящее устройство) (4) жук 
バドミントン 		бадминтон 
バナナ 		банан 
バベルの塔 		вавилонская башня 
バラード 		баллада 
バランス 		баланс равновесие 
バリウム 		барий (Ba) 
バリケード 		баррикада 
バルコニー 		балкон 
バルセロナ 		Барселона 
バレー 		(1) залп (2) долина (3) балет 
バレエ 		балет 
バレリーナ 		балерина 
バロメーター 		барометр 
バロン 		барон 
バンク 		банк 
バンクーバー 		Ванкувер 
バンコク 		Бангкок 
パーセント 		процент 
パーツ 		детали комплектующие 
パイロット 		пилот 
パゴダ 		пагода 
パスポート 		паспорт 
パスワード 		пароль (en: password) 
パソコン 		ПК персональный компьютер 
パトリオティズム 		патриотизм 
パトロール 		патруль 
パノラマ 		панорама 
パラシュート 		парашют 
パラソル 		зонт 
パラドックス 		парадокс 
パラボラ 		парабола 
パルス 		пульс 
パレード 		парад 
パレスチナ 		Палестина 
パン 		хлеб 
パンダ 		панда 
パンフレット 		брошюра 
ヒーロー 		герой 
ヒエラルキー 		иерархия 
ヒッピー 		хиппи 
ヒマラヤ 		Гималаи 
ヒューマニズム 		гуманизм 
ヒューリスティック 		эвристический 
ヒロイズム 		героизм 
ヒロイン 		героиня 
ビーチ 		пляж берег 
ビーナス 		Венера 
ビーム 		луч 
ビキニ 		бикини 
ビクター 		победитель 
ビクトリー 		победа 
ビクトリア 		Виктория 
ビザ 		виза 
ビジター 		посетитель 
ビジネス 		бизнес 
ビジュアル 		визуальный 
ビタミン 		витамин 
ビッグ 		большой (en: big) 
ビデオ 		видео 
ビデオテープ 		видеоплёнка 
ビニール 		винил 
ビバーク 		бивак 
ビューロー 		бюро 
ビュッフェ 		буфет 
ビリヤード 		бильярд 
ビルマ 		Бирма 
ピーチ 		персик 
ピーマン 		перец 
ピアニスト 		пианист 
ピアノ 		пианино 
ピオニール 		пионер 
ピケ 		пикет 
ピコ 		пико- 10^-12 
ピストル 		пистолет 
ピラニア 		пиранья 
ピラミッド 		пирамида 
ピン 		булавка 
ファー 		шерсть мех (en: fur) 
ファイア 		огонь 
ファイル 		файл 
ファシスト 		фашист 
ファシズム 		фашизм 
ファンクラブ 		фан-клуб 
ファントム 		фантом 
フィールド 		поле (en: field) 
フィッシュ 		рыба 
フィニッシュ 		финиш окончание 
フィルム 		(кино или фото) плёнка 
フェデレーション 		федерация 
フェニックス 		феникс 
フェミニズム 		феминизм 
フェロモン 		феромон 
フォーク 		вилка 
フォーマット 		формат 
フォーラム 		форум 
フォト 		фотография 
フォント 		шрифт 
フットボール 		футбол 
フットライト 		рампа свет рампы (en: footlight) 
フュージョン 		синтез слияние сплав (en: fusion) 
フライト 		рейс самолёта 
フライトコントロール 		(1) управление полётом (2) служба управления полётами 
フラッグ 		флаг 
フランス語 		французский язык 
フリー 		свободный 
フリーマーケット 		свободный рынок (en: free market) 
フル 		полный 
フレアー 		вспышка 
フレッシュ 		(1) свежий (en: fresh) (2) плоть (en: flesh) 
フロリダ 		Флорида 
ブーケ 		букет 
ブーメラン 		бумеранг 
ブイ 		буй 
ブック 		книга 
伯剌西爾 		Бразилия 
ブラチスラバ 		Братислава 
ブラック 		чёрный (en: black) 
ブラックコーヒー 		чёрный кофе (en: black coffee) 
ブラックコメディ 		чёрная комедия (en: black comedy) 
ブラックペッパー 		чёрный перец (en: black pepper) 
ブラックホール 		чёрная дыра (en: black hole) 
ブラックボックス 		чёрный ящик (en: black box) 
ブラックマーケット 		чёрный рынок (en: black market) 
ブラックマジック 		чёрная магия (en: black magic) 
ブラックユーモア 		чёрный юмор (en: black humor) 
ブラックリスト 		чёрный список (en: blacklist) 
ブリュッセル 		Брюссель 
ブルー 		синий голубой (en: blue) 
ブルキナファソ 		Буркина-Фасо 
ブルジョワジー 		буржуазия 
ブルジョワ 		буржуа 
ブレーカー 		разрушитель уничтожитель 
ブレード 		лезвие клинок полотнище (пилы) лезвие клинок (en: blade) 
ブレスト 		Брест 
ブレスレット 		браслет 
ブローチ 		брошь 
ブロック 		блок 
ブロンズ 		бронза 
プール 		бассейн 
プラーグ 		Прага 
プラカード 		плакат транспарант 
プラグ 		(электрическая) вилка (en: plug) 
プラス 		плюс 
プラスチック 		пластик 
プラスチックモデル 		пластиковая модель 
プラズマ 		плазма 
プラチナ 		платина (Pt) 
プラットホーム 		платформа 
プラネタリウム 		планетарий 
プラモデル 		пластиковая модель 
プラン 		план 
プランクトン 		планктон 
プリズム 		призма 
プリンス 		принц 
プリンセス 		принцесса 
プリンター 		принтер 
プルトニウム 		плутоний (Pu) 
プレーヤー 		(1) игрок (2) устройство воспроизведения проигрыватель (en: player) 
プレジデント 		президент 
プログラマー 		программист 
プログラム 		программа 
プロジェクト 		проект 
プロセス 		процесс 
プロセッサー 		процессор 
プロダクション 		продукция производство 
プロダクト 		продукт 
プロデューサー 		продюссор 
プロトアクチニウム 		протактиний (Pa) 
プロパガンダ 		пропаганда 
プロパン 		пропан 
プロペラ 		пропеллер 
プロペラ機 		винтовой самолёт 
プロレタリアート 		пролетариат 
ヘクタール 		гектар 
ヘクト 		гекто- 10^2 
ヘッド 		голова (en: head) 
ヘモグロビン 		гемоглобин 
ヘリ 		вертолёт геликоптер 
ヘリウム 		гелий (He) 
ヘリコプター 		вертолёт геликоптер 
ヘリポート 		вертодром вертолётная площадка (en: heliport) 
ヘルシンキ 		Хельсинки 
ヘルプ 		помощь (en: help) 
ヘルメット 		шлем каска 
ヘロイン 		героин 
ベース 		база 
ベイルート 		Бейрут 
ベオグラード 		Белград 
ベクトル 		вектор 
ベッド 		кровать (en: bed) 
ベテラン 		ветеран 
越南 		Вьетнам 
ベランダ 		веранда 
ベル 		звонок 
ベルファスト 		Белфаст 
ペーパー 		бумага 
ペシミスティック 		пессимистичный 
ペレストロイカ 		перестройка 
ペン 		ручка перо 
ペンキ 		краска 
ペンギン 		пингвин 
ペン先 		перо кончик пера, ручки 
ホーム 		(1) платформа (2) дом 
ホール 		зал 
ホッケー 		хоккей 
ホテル 		отель гостиница 
ホノルル 		Гонолулу 
ホリゾント 		горизонт 
ホルモン 		гормон 
ホログラム 		голограмма 
ホワイト 		белый (en: white) 
ホンジェラス 		Гондурас 
ボーカリスト 		вокалист 
ボート 		лодка 
ボーナス 		премия 
ボールペン 		шариковая ручка 
ボイコット 		бойкот 
ボイス 		голос 
ボストン 		Бостон 
ボスニア 		Босния 
ボツワナ 		Ботсвана 
ボディー 		тело 
ボディービル 		бодибилдинг 
ボルシチ 		борщ 
ボルト 		вольт 
ボン 		Бонн 
ポーター 		швейцар носильщик 
ポスト 		почтовый ящик 
ポストオフィス 		почтовое отделение 
ポリネシア 		Полинезия 
ポリマー 		полимер 
マーキュリー 		Меркурий 
マージ 		маг 
マーブル 		мрамор (en: marble) 
マーメイド 		русалка (en: mermaid) 
マイアミ 		Майями 
マイク 		микрофон 
マイクロコンピューター 		микрокомпьютер 
マイクロスコープ 		микроскоп 
マイクロフォン 		микрофон 
マイル 		миля (en: mile) 
マウンテン 		гора 
マカロニ 		макароны 
マグネシウム 		магний (Mg) 
マグネット 		магнит 
マグマ 		магма 
マジック 		магия 
マゾ 		мазохист 
マッサージ 		массаж 
マットレス 		матрац 
マップ 		карта 
マトリックス 		матрица 
マニキュア 		маникюр 
マネー 		деньги 
マネキン 		манекен 
マハラジャ 		махараджа магараджа 
マフィア 		мафия 
マヨネーズ 		майонез 
マルコフ過程 		Марковский процесс 
満俺 		марганец (Mn) 
マンション 		многоквартирный дом 
マンドレーク 		мандрагора 
マンモス 		(1) мамонт (2) гигантский 
木乃伊 		мумия (pt: mirra) мумия 
ミクロン 		микрон 
ミシガン 		Мичиган 
ミスター 		мистер 
ミニスカート 		мини-юбка 
ミネラル 		минерал 
ミュージック 		музыка 
ミラー 		зеркало 
ミラージュ 		мираж 
ミリ 		милли- 10^-3 
ミリオン 		миллион 
ミリグラム 		миллиграмм 
粍 		миллиметр 
ミルク 		молоко 
ムーン 		луна 
メーカー 		производитель 
メール 		почта электронная почта 
メカ 		(1) механический (2) механизм (3) механик 
メカニズム 		механизм 
メガ 		мега- 10^6 
メガヘルツ 		мегагерц MHz 
メガホン 		мегафон 
メタノール 		метанол 
メダル 		медаль 
メチル 		метил 
メッカ 		Мекка 
メッセージ 		сообщение 
メディア 		носитель информации (en: media) 
メトロ 		метро 
メトロノーム 		метроном 
メニュー 		меню 
メモリー 		память 
メラニン 		меланин 
メルシー 		спасибо 
メルボルン 		Мельбурн 
メロン 		дыня 
メンシェヴィキ 		меньшевики 
メンソール 		ментол 
メンバー 		член (en: member) 
メンフィス 		Мемфис 
モーター 		мотор 
モーターサイクル 		мотоцикл 
モーツァルト 		Моцарт 
モーニング 		утро (en: morning) 
モアレ 		муар 
モサド 		Моссад 
モザイク 		мозаика 
モーテル 		мотель 
モノ 		моно монофонический 
モノクロ 		одноцветный монохромный 
モノラル 		монофонический 
モノレール 		монорельс 
モノローグ 		монолог 
モヘア 		мохер 
モラトリアム 		мораторий 
モラル 		мораль 
モルグ 		морг 
モルヒネ 		морфий 
モンスター 		монстр 
ユー 		ты (en: you) 
ユーザー 		пользователь 
ユーザーインターフェイス 		пользовательский интерфейс 
ユージェニックス 		евгеника 
ユートピア 		утопия 
ユーモア 		юмор 
ユーレカ 		эврика 
ユニコーン 		единорог (en: unicorn) 
ユマニスム 		гуманизм 
ヨーガ 		йога 
ヨーグルト 		йогурт 
ヨット 		яхта 
ライオン 		лев 
ライス 		рис 
ライセンス 		лицензия 
ライター 		писатель (en: writer) (1) зажигалка (en: lighter) (2) писатель (en: writer) 
ラジアン 		радиан 
ラジウス 		радиус 
ラジウム 		радий (Ra) 
ラジオ 		радио 
ラジカセ 		кассетный магнитофон с радиоприёмником 
ラテン語 		латинский язык 
ラトビア 		Латвия 
ラドン 		радон (Rn) 
ラビリンス 		лабиринт 
ラブレター 		любовное письмо (en: love-letter) 
ララバイ 		колыбельная (en: lullaby) 
ランジェリー 		женское бельё 
ランディング 		посадка 
ランデブー 		встреча 
ランプ 		лампа 
リース 		венок гирлянда 
リーダー 		лидер 
リーフ 		(1) лист (2) риф 
リアクション 		реакция 
リアリズム 		реализм 
リキュール 		ликёр 
リスボン 		Лиссабон 
リチウム 		литий (Li) 
リットル 		литр 
リップ 		губа (en: lip) 
リニア 		линейный (en: linear) 
リネーム 		переименование (en: rename) 
リベラリズム 		либерализм 
リペア 		починка ремонт 
リミット 		лимит предел граница 
リュックサック 		рюкзак 
リライト 		перезапись 
リリース 		выпуск 
リレー 		эстафета 
リング 		(1) кольцо (2) ринг (3) звонок 
ルーブル 		рубль 
ルーム 		комната 
ルール 		правило 
ルビー 		рубин 
ルポルタージュ 		репортаж 
レート 		соотношение курс (обмена валюты) 
レーン 		дождь 
レイプ 		изнасилование (en: rape) 
レザー 		лазер 
レシート 		(товарный) чек 
レジスタンス 		сопротивление 
レストラン 		ресторан 
レズ 		лесбиянка лесбийский 
レセプト 		рецепт (от врача) 
レター 		письмо 
レタス 		салат (растение) 
レッスン 		урок (en: lesson) 
レッド 		красный (en: red) 
レベル 		уровень (en: level) 
檸檬 		лимон 
レントゲン 		рентген 
ローカル 		локальный местный 
ローション 		лосьон 
ローズ 		роза 
ロゼ 		роза 
ローダ 		загрузчик погрузчик 
ロープ 		верёвка (en: rope) 
ロシア語 		русский язык 
ロジック 		логика 
ロックンロール 		рок-н-ролл 
ロッド 		(1) жезл (2) прут (en: rod) 
ロビー 		приёмная вестибюль фойе 
ロボット 		робот 
ロング 		длинный (en: long) 
ワード 		слово (en: word) 
ワープロ 		текстовой процессор 
ワーム 		червь 
ワイド 		широкий (en: wide) 
ワイン 		вино 
ワン 		один 
ワンタッチ 		одно прикосновение 
亜鉛 		цинк (Zn) 
亜爾然丁 		Аргентина 
亜米利加 		Америка 
アメリカ合衆国 		Соединённые Штаты Америки 
愛 		любовь 
愛しい 		(1) любимый (2) жалкий 
愛する 		любить 
愛でる 		любить ценить 
愛らしい 		милый прелестный 
愛煙家 		завзятый курильщик 
愛顧 		благосклонность 
愛国 		патриотизм любовь к родине 
愛国心 		патриотизм 
愛児 		любимый ребёнок 
愛情 		любовь привязанность 
愛知県 		Айти (префектура) 
愛読者 		постоянный читатель подписчик 
愛読書 		любимая книга 
愛撫 		нежность ласка забота 
挨拶 		приветствие 
悪い 		плохой скверный 
悪化 		ухудшение 
悪心 		злонравие 
悪性 		злокачественность 
悪性腫瘍 		злокачественная опухоль 
握り 		(1) горсть пригоршня (2) рукоятка 
握り屋 		скупец скряга стяжатель 
握る 		брать схватывать держать сжимать 
握手 		рукопожатие 
旭日 		восходящее солнце 
圧縮 		сжатие 
安い 		дешёвый 
安住 		спокойная жизнь 
安心 		спокойствие 
安全 		безопасность 
安定 		стабильность стабилизация 
安定性 		устойчивость 
安否 		самочувствие положение 
安物 		дешёвка мелкие товары 
暗い 		(1) тёмный мрачный (2) плохо осведомлённый не разбирающийся (в чём-л.) 
暗がり 		темнота потёмки 
暗に 		косвенно намёками 
暗闇 		тьма мрак темнота 
暗雲 		тёмные облака 
暗君 		неумный правитель 
暗合 		совпадение 
暗殺 		убийство (из-за угла) 
暗殺事件 		убийство 
暗示 		намёк 
暗室 		тёмная комната 
暗礁 		подводный камень 
暗中 		в темноте 
暗闘 		скрытая борьба тайная вражда 
暗流 		скрытое течение тайное движение 
案内 		сопровождение 
案内所 		справочное бюро 
闇 		тьма мрак 
以下 		(1) менее (чем) (и) ниже (2) нижеследующее 
以外 		кроме помимо за исключением исключая 
以後 		(1) после спустя (2) впредь 
以上 		(1) свыше сверх больше (2) вышеуказанное вышеупомянутое 
以西 		к западу западнее 
以前 		(1) тому назад до (2) раньше прежде 
以東 		к востоку восточнее 
以内 		в пределах в течение 
以南 		к югу южнее 
以北 		к северу севернее 
以来 		со времени после (чего-л.) 
伊語 		итальянский язык 
伊達 		франтовство щегольство 
伊呂波 		ироха (старинный японский алфавит) 
位 		(1) ранг звание чин положение (2) настолько в такой степени 
位取り 		(1) разряд качество (2) единица измерения 
位相幾何学 		топология 
偉大 		величие 
委員 		член комитета 
意義 		значение смысл 
意見 		мнение взгляд 
意見交換 		обмен мнениями 
意思 		воля намерение 
意味 		значение смысл 
易しい 		лёгкий несложный 
椅子 		стул 
為さる 		делать 
為す 		составлять образовывать 
異同 		различие разница 
緯度 		широта (геогр.) параллель 
胃 		желудок 
衣装 		костюм 
違い 		(1) отличие разница (2) ошибка 
違う 		быть другим отличаться различаться (по чему-л.) расходиться (с чем-л.) 
違える 		изменять перепутывать 
違算 		ошибка в подсчёте 
違式 		нарушение общепринятого порядка 
違背 		нарушение противоречие (чему-л.) 
違反 		нарушение (закона и т. п.) 
違法 		беззаконие незаконный нелегальный 
遺産 		наследство 
遺産相続 		получение в наследство 
医化学 		медицинская химия 
医学 		медицина 
医学用語 		медицинский термин 
医師 		врач доктор 
医者 		врач доктор 
育児 		воспитание детей 
一 		один один (гл. обр. на ценных бумагах и т. п.) 
一つ 		один 
一つ一つ 		один за одним по одному по отдельности 
一握り 		(1) горсть пригоршня (2) кучка горстка 
一億 		100,000,000 сто миллионов 
一階 		(1) один этаж (2) первый этаж 
一興 		развлечение 
一月 		январь 
一月 		один месяц 
一口 		одно слово 
一向 		(с отриц.) нисколько ничуть 
一時 		один час 
一時間 		один час 
一式 		полный комплект 
一室 		одна комната 
一緒に 		вместе 
一心に 		сосредоточенно внимательно всей душой 
一人で 		сам в одиночку 
一寸 		немного слегка чуть-чуть 
一千 		1,000 одна тысяча 
一体 		(1) тело одно целое цельный неразъёмный (2) собственно говоря вообще говоря на самом деле 
一定 		определённый установленный урегулированный 
一滴 		(одна) капля 
１等 		первый класс самый лучший 
一等兵 		рядовой первого класса 
一日中 		целый день весь день 
一年生 		студент первого курса учащийся на первом году обучения 
一年中 		в течении всего года 
一杯 		полный 
一泊 		одна ночёвка 
一番 		(1) самый лучший (2) первый номер 
一分 		одна минута 
一方 		одна сторона 
一枚 		одна страница один лист 
一面 		(1) одна сторона другая сторона (2) вся поверхность (3) первая страница (газеты) 
一目惚れ 		любовь с первого взгляда 
溢れる 		быть переполненным 
稲光 		молния 
稲妻 		молния 
芋蔓式 		один за другим вереницей 
印鑑 		печать штамп 
印刷 		печатанье 
印象 		впечатление 
印象主義 		импрессионизм 
因子 		фактор 
引く 		тянуть тащить 
引っ越す 		переехать 
引証 		ссылка цитата 
引用 		цитирование ссылка 
飲む 		пить 
陰嚢 		мошонка 
陰謀 		заговор интриги 
陰暦 		лунный календарь 
隠し事 		секрет 
隠士 		отшельник 
韻律 		ритм 
右 		правый справа 
右舷 		правый борт судна 
右手 		правая рука 
右翼 		правое крыло правый фланг 
宇宙 		космос 
宇宙服 		космический скафандр 
烏賊 		каракатица 
雨 		дождь 
雨粒 		дождевая капля 
嘘 		ложь 
嘘をつく 		лгать 
鰻 		угорь 
噂 		слухи 
運 		судьба 
運ぶ 		переносить перевозить 
運営 		управление ведение 
運河 		канал (водный) 
運賃 		стоимость доставки стоимость перевозки 
運転 		движение работа вождение (автомобиля и т. д.) 
運転者 		шофёр водитель 
運動 		(1) движение (2) спорт физкультура 
運命 		судьба 
運命論 		фатализм 
運用 		практическое применение 
雲 		облако 
営倉 		гауптвахта 
影響 		влияние эффект воздействие 
映画 		кинофильм 
映画館 		кинотеатр 
栄誉 		слава почёт 
永遠 		вечность 
永住 		постоянное место жительства 
永生 		вечная жизнь 
泳ぐ 		плавать 
英京 		Лондон английская столица 
英語 		английский язык 
英国 		Англия 
英国人 		англичанин 
英和 		английско-японский 
英和辞典 		английско-японский словарь 
衛星 		спутник (астр.) 
衛生 		гигиена 
衛兵 		охранник 
駅 		станция (ж.-д.) вокзал 
駅弁 		обед (обычно коробочный) продаваемый на станциях 
謁見 		аудиенция 
越す 		переправляться переезжать пересекать 
閲兵 		смотр войскам парад 
円 		иена круг 
円心 		центр круга 
円筒 		цилиндр 
沿う 		следовать быть расположенным (вдоль чего-л.) 
沿革 		история развитие эволюция 
沿岸 		побережье 
演説 		речь обращение 
演奏会 		концерт 
炎 		пламя 
煙 		дым 
煙い 		дымный 
煙る 		дымиться 
煙突 		дымовая труба 
燕 		ласточка 
猿 		обезьяна 
縁 		связь отношения родство 
縁 		край кайма 
縁側 		веранда открытый коридор 
遠い 		далёкий 
遠く 		вдали вдалеке далеко 
遠ざかる 		(1) удаляться отдаляться (2) держаться на расстоянии быть в стороне 
遠ざける 		(1) удалять отдалять (2) воздерживаться избегать 
遠因 		косвенная причина 
遠縁 		дальнее родство 
遠隔 		отдалённый удалённый на большом расстоянии 
遠景 		вид издалека вид вдаль 
遠見 		(1) вид вдаль (2) вышка каланча 
遠心 		центробежный 
遠のく 		держаться на расстоянии держаться подальше 
遠大 		грандиозный (о замысле и т. п.) 
遠方 		(1) отдалённая местность даль (2) долгий путь 
遠望 		вид издали перспектива 
遠謀 		дальновидность 
遠慮 		стеснительность затруднение 
遠路 		дальняя дорога 
鉛 		свинец 
鉛筆 		карандаш 
塩っぱい 		солёный 
塩入れ 		солонка 
汚い 		(1) грязный (2) отвратительный низменный 
汚す 		пачкать загрязнять (1) пачкать загрязнять (2) обрастать ракушками или водорослями (о судне) 
汚らわしい 		(1) грязный (2) отвратительный низменный 
汚れる 		загрязняться пачкаться 
汚れる 		загрязняться пачкаться 
汚職 		коррупция продажность 
汚染 		загрязнение 
汚点 		пятно клякса 
甥 		племянник 
凹面 		вогнутость 
凹面鏡 		вогнутое зеркало 
奥さん 		жена супруга 
往診 		визит врача 
往復 		путь туда и обратно билет в оба конца 
往来 		(1) уличное движение (2) улица дорога 
応じる 		отвечать откликаться соответствовать удовлетворять (желания, ожидания и т. п.) 
応接間 		приёмная 
横 		бок поперечник 
横向き 		поворот боком 
横書き 		горизонтальное письмо 
横断 		пересечение 
横断歩道 		пешеходный переход 
王国 		королевство 
黄色い 		жёлтый 
沖 		открытое море 
沖縄 		(остров) Окинава 
荻 		камыш 
億 		100,000,000 сто миллионов 
億万長者 		миллионер богач 
屋根 		крыша 
屋上 		крыша на крыше 
牡丹 		пуговица 
牡蠣 		устрица 
恩愛 		привязанность любовь 
恩給 		пенсия 
恩赦 		амнистия 
恩人 		благодетель 
温泉 		горячий источник 
温度 		температура 
音韻 		фонема 
音韻学 		фонетика 
音楽 		музыка 
音響 		звук шум эхо 
音声 		голос 
音節 		слог 
音波 		звуковая волна 
音符 		(музыкальная) нота 
下 		внизу снизу находящийся внизу нижний низший 
下がる 		(1) свешиваться висеть (2) падать понижаться снижаться 
下げる 		(1) вывешивать (напр. вывеску) (2) носить (орден, саблю, часы и т. п.) (3) опускать понижать 
下げ札 		ярлык бирка 
下げ振り 		(1) маятник (2) отвес 
下げ潮 		отлив 
下さる 		давать (о 2-м и 3-м лице) 
下し 		слабительное очищение желудка 
下らない 		вздорный нелепый пустячный 
下り坂 		спуск склон уклон 
下り列車 		поезд, идущий из столицы (большого города) 
下る 		(1) спускаться сходить (2) быть ниже быть менее чем 
下院 		нижняя палата (парламента) 
下火になる 		(1) догорать (2) выдыхаться терять влияние 
下回り 		подчинённый 
下回る 		быть ниже, чем 
下界 		этот мир земля 
下記 		нижеследующий 
下見 		предварительный осмотр предварительный просмотр 
下弦 		последняя четверть (луны) 
下限 		нижняя грань нижний предел 
下向 		уезжать из столицы 
下向き 		(1) лицом вниз с опущенной головой (2) тенденция к понижению (курса, цен и т. п.) 
下降 		спуск снижение падение 
下座 		последнее (непочётное) место 
下剤 		слабительное 
下四半期 		последний квартал года 
下士官 		унтер-офицер 
下歯 		нижние зубы 
下車 		сходить (с поезда и т. п.) 
下手 		неловкий неумелый неискусный 
下旬 		третья декада последняя декада 
下書き 		черновик 
下女 		служанка 
下水 		(1) грязная вода сточная вода (2) водосток 
下生え 		подлесок 
下相談 		предварительные переговоры 
下駄 		гэта (деревянные тапочки) 
下駄箱 		шкафчик для обуви 
下男 		слуга 
下地 		(1) фундамент основа (2) грунт подмалёвка (3) подготовка 
下着 		нижнее бельё 
下半 		вторая половина нижняя половина 
下卑る 		стать вульгарным 
下品 		низкий вульгарный 
下付 		жаловать предоставлять 
下方 		низ нижняя часть внизу 
下方に 		внизу 
下野 		уход в отставку 
下役 		младший (по чину и т. п.) подчинённый 
下痢 		диарея понос 
下略 		остальное опущено 
下流 		(1) нижнее течение (2) низшие классы низы 
下僚 		подчинённый 
下劣 		низкий вульгарный 
化学 		химия 
化学式 		химическая формула 
化膿 		гноение нарыв 
仮分数 		неправильная дробь 
仮面 		маска 
何か 		что-нибудь 
何気なく 		(1) как ни в чём не бывало (2) без всякого умысла ненамеренно 
何事 		что 
何時 		когда 
何時 		который час 
何時までも 		всегда (о будущем) навсегда 
何者 		кто какой человек 
何者か 		кто-то 
何人 		сколько человек 
何ら 		какой-нибудь любой 
何日 		какой день который день 
何番 		какой номер который номер 
何分 		какой-нибудь тот или другой 
何遍 		сколько раз 
何方 		кто 
価値 		ценность 
加水分解 		гидролиз 
可能性 		возможность потенциал 
可否 		(1) за и против (2) правильность уместность 
夏 		лето 
夏休み 		летний отпуск летние каникулы 
夏至 		летнее солнцестояние 
夏至点 		летнее солнцестояние 
家 		дом 
家 		дом (свой) 
家具 		мебель 
家具屋 		мебельный магазин 
家族 		семья 
家畜 		домашний скот домашние животные 
家長 		глава семьи глава рода 
家庭 		семья семейный круг дом домашнее хозяйство 
家内 		жена 
科学 		наука 
科学者 		учёный 
科学的 		научный 
果たす 		выполнять осуществлять 
果て 		конец край результат 
果てる 		кончаться 
果敢 		смелый решительный предприимчивый 
果汁 		фруктовый сок 
果物 		фрукт 
歌 		песня 
歌劇 		опера 
歌手 		певец 
歌舞伎 		кабуки (японский классический театр) 
河馬 		бегемот гиппопотам 
火 		огонь 
火炎放射器 		огнемёт 
火花 		искра 
火山 		вулкан 
火星 		Марс (планета) 
火星人 		марсианин 
火鉢 		жаровня 
火薬 		порох 
火曜 		вторник 
火曜日 		вторник 
花 		цветок 
花火 		фейерверк 
花束 		букет 
花瓶 		ваза (цветочная) 
花婿 		жених 
茄子 		баклажан 
荷物 		багаж 
菓子 		сладости 
課税 		обложение налогом налогообложение 
課長 		начальник отделения 
過ぎ 		после позже 
過ごす 		проводить 
過去 		прошлое 
過程 		процесс 
我 		я я сам 
我慢 		терпение выносливость 
牙 		клык бивень 
牙城 		крепость цитадель 
画家 		художник 
画廊 		картинная галерея 
蛾 		мотылёк 
会 		(1) заседание собрание съезд (2) общество ассоциация кружок 
会う 		встречать встречаться видеться 
会議 		совет совещание собрание конференция сессия 
会議場 		зал совещаний 
会計 		счёт (за покупку, заказ) 
会合 		встреча сбор 
会式 		богослужение 
会社 		компания фирма корпорация 
会釈 		кланяться приветствовать 
会主 		организатор собрания 
会衆 		участники собрания присутствующие публика 
会場 		зал (собрания) 
会食 		обедать (ужинать и т. п.) вместе с кем-л. 
会戦 		бой сражение 
会葬 		присутствие на похоронах 
会則 		устав общества 
会談 		(1) беседа разговор (2) переговоры 
会長 		(1) председатель собрания (2) президент общества 
会得 		понять уловить смысл 
会費 		членский взнос 
会話 		разговор 
解析 		анализ 
解放 		освобождение 
解剖学 		анатомия 
回教 		ислам мусульманство мусульманская религия 
回折 		дифракция 
壊す 		(1) разрушать разбивать портить (настроение, отношения) 
壊れる 		(1) ломаться разрушаться (2) быть сломанным быть испорченным быть нарушенным 
壊れ物 		бракованный товар 
壊滅 		(полное) уничтожение гибель разгром 
怪我 		рана ушиб 
けが人 		раненый 
懐疑 		скептицизм сомнение недоверие 
懐中電灯 		карманный фонарик 
懐炉 		Каир 
改革 		реформа 
改心 		исправление изменение к лучшему 
改善 		улучшение 
海 		море 
海員 		моряк 
海王星 		Нептун (планета) 
海外 		заграница 
海岸 		морской берег 
海峡 		пролив 
海軍 		морские войска 
海兵 		морская пехота 
海洋 		океан 
海路 		морской путь 
灰 		пепел 
灰皿 		пепельница 
灰色 		серый цвет пепельный цвет 
皆 		все всё 
皆さん 		господа (обращение ко всем одновременно) 
皆無 		полное отсутствие 
絵 		картина 
絵画 		картина живопись 
絵本 		книга с картинками 
辛子 		горчица 
蟹 		краб 
かに座 		Рак (созвездие) 
開く 		открывать раскрывать 
開ける 		открывать 
開墾 		поднятие целины распашка 
開始 		начало открытие 
階 		этаж 
階級 		класс 
階段 		лестница 
外 		снаружи вне на улице 
他 		другой и другие и т. д. другой кроме 
外に 		кроме также 
外科医 		хирург 
外角 		внешний угол 
外交官 		дипломат 
外交的 		дипломатический 
外国 		заграничная страна заграница 
外出 		выход (на улицу) 
外人 		иностранец 
外線 		внешняя телефонная линия 
外来語 		заимствованное слово 
概ね 		большей частью в основном обычно 
概念 		общее понятие концепция 
街 		улица 
街灯 		уличный фонарь 
街道 		шоссе тракт большая дорога 
街路 		улица дорога 
該当 		попадающий соответствующий 
鎧 		латы доспех 
骸骨 		скелет 
蛙の子は蛙 		"яблоко от яблони недалеко падает" "головастик всё равно лягушка" 
柿 		хурма 
各 		каждый все 
各地 		повсеместно 
拡散 		рассеивание диффузия 
拡大 		расширение 
格 		(грам.) падеж 
核反応 		атомная реакция ядерная реакция 
核反応炉 		атомный реактор ядерный реактор 
核兵器 		атомное оружие ядерное оружие 
確信 		убеждение (в чём-л.) 
確認 		одобрение подтверждение 
確率過程 		вероятностный процесс 
確率変数 		случайная величина 
覚える 		запоминать усваивать 
覚ます 		пробудить 
覚める 		проснуться проснуться очнуться 
角 		угол (внешний) 
閣下 		Ваше превосходительство 
革命 		революция 
学ぶ 		изучать (детально) 
学位論文 		диссертация 
学校 		школа 
学士 		выпускник университета 
学者 		учёный 
学生 		учащийся студент 
学生証 		студенческий билет 
学説 		теория учение 
学童 		школьник ученик 
学部 		факультет 
学齢 		школьный возраст 
楽しい 		приятный радостный 
楽譜 		ноты 
額 		лоб 
顎 		подбородок 
掛かる 		висеть требоваться (о времени, ресурсах) 
掛ける 		(1) вешать (2) садиться (3) звонить (по телефону) (4) умножать 
括弧 		скобка 
活気 		оживление живость энергия 
活動 		деятельность активность 
滑る 		скользить 
鞄 		портфель 
蒲公英 		одуванчик 
蒲鉾 		камабоко (паста из варёной рыбы) 
噛む 		жевать кусать 
寒い 		холодный (о погоде, воздухе) 
寒がる 		мёрзнуть страдать от холода 
寒暖計 		термометр 
耐える 		выносить выдерживать 
完成 		завершение 
完全 		совершенство 
完全コピー 		точная копия 
完全主義者 		перфекционист 
官舎 		официальная резиденция 
干渉 		вмешательство 
干天 		засуха 
患者 		пациент 
感じ 		чувство ощущение впечатление 
感じる 		чувствовать испытывать 
感化 		влияние 
感興 		(1) подъём воодушевление (2) интерес удовольствие 
感謝 		благодарность 
感触 		ощущение чувство осязание 
感心 		восхищение восторг 
感染 		(1) подвергаться влиянию перенимать (2) заражаться 
感度 		степень чувствительности чувствительность 
感動 		быть тронутым 
感動詞 		междометие 
感付く 		чуять догадываться 
慣例 		обычай 
換気 		вентиляция 
敢えて 		смело решительно 
敢行 		решительно действие 
汗 		пот 
汗顔 		стыд стеснение 
漢語 		канго (японские слова основанные на китайских корнях) китайские слова 
漢字 		кандзи (kj) канжи иероглиф 
漢文 		(классическая) китайская литература 
甘い 		сладкий 
甘酒 		сладкое сакэ 
監房 		камера (тюремная) 
看護婦 		медсестра 
看板 		вывеска 
管弦楽 		оркестровая музыка 
管理 		управление заведование контроль 
管理人 		управляющий менеджер 
簡単 		простой несложный 
簡略 		упрощённый сокращённый 
簡略化 		упрощение 
緩い 		свободный неплотный слабый 
緩む 		распускаться ослабевать 
緩める 		распускать ослаблять 
緩やか 		мягкий спокойный тихий медленный 
緩衝 		смягчение удара 
緩慢 		медлительный вялый 
緩和 		смягчение успокоение 
缶 		консервная банка 
缶詰 		консервы 
缶切り 		консервный нож 
肝臓 		печень 
艦上 		на борту корабля 
艦長 		капитан (военного корабля) 
観客 		зритель 
観光 		осмотр достопримечательностей 
観点 		точка зрения 
還暦 		шестидесятилетие возвращение календаря (шестидесятилетнего цикла) 
間違い 		(1) ошибка промах (2) недоразумение 
間違える 		ошибаться 
間隔 		промежуток 
関係 		отношение связь 
関心 		интерес 
関西 		Кансай (район) 
韓国 		(Южная) Корея 
丸で 		совершенно совсем 
岸 		берег 
癌 		пистолет ружьё пушка огнестрельное оружие (en: gun) 
眼球 		глазное яблоко 
頑張る 		стараться держаться быть стойким быть упорным 
顔 		лицо 
願い 		желание просьба 
願う 		желать просить 
企てる 		(1) намереваться замышлять строить планы (2) предпринимать 
企む 		замышлять 
企画 		план проект 
企業 		промышленное предприятие 
企図 		замысел план проект 
危険 		опасность 
喜劇 		комедия 
基地 		база 
基本的 		фундаментальный 
奇数 		нечётное число 
寄宿舎 		общежитие 
寄与 		вклад 
岐阜県 		Гифу (префектура) 
希望 		желание стремление намерение 
幾つ 		сколько 
幾つか 		несколько немного 
幾ら 		сколько 
幾らか 		несколько немного 
幾何 		геометрия 
幾何学 		геометрия 
幾分 		как-то 
机 		стол 
旗 		флаг знамя 
旗手 		знаменосец 
既に 		уже 
既婚者 		женатый замужняя 
期間 		срок 
期待 		ожидание 
期日 		срок (исполнения, сдачи и т. п.) 
機械 		машина механизм 
機械化 		механизация моторизация компьютеризация 
機関 		орган учреждение 
機関車 		локомотив 
機構 		(1) устройство механизм (2) организация 
機体 		корпус самолёта фюзеляж 
機内 		внутри самолёта 
帰り 		возвращение (домой) обратный путь 
帰る 		возвращаться уходить уезжать приходить (домой, к прежнему состоянию) 
気がする 		казаться чувствовать 
気に入る 		понравиться прийтись по душе 
気の毒 		сожаление 
気概 		твёрдый дух мужество 
気候 		климат 
気体 		газ 
汽車 		паровоз 
汽船 		пароход 
汽笛 		паровой гудок 
季語 		сезонное слово (в хайку) 
季節 		время года сезон 
紀元 		наша эра 
規模 		масштаб размер 
記憶 		память воспоминания 
記号論理学 		символическая логика 
記事 		заметка (в газете) 
記念日 		годовщина юбилей 
記念碑 		памятник монумент 
記録 		показатель рекорд 
貴重 		ценный драгоценный 
貴重品 		ценности ценные вещи 
貴族 		дворянство 
貴方 		ты вы (ед. ч.) 
貴様 		ты 
起きる 		вставать подниматься 
起こす 		будить поднимать 
起動 		запуск 
飢える 		голодать 
飢餓 		голод 
騎士 		рыцарь 
鬼ごっこ 		догонялки пятнашки 
鬼才 		гений выдающийся талант 
偽る 		лгать обманывать выдавать себя за кого-л. 
偽作 		апокриф 
偽証 		лжесвидетельство 
偽善 		лицемерие 
偽筆 		(1) подделанный почерк подлог (2) подделка (о картине) 
儀仗兵 		почётный караул 
宜しい 		хороший 
技 		умение мастерство ловкость 
技師 		инженер 
技術 		техника (ведения какого-л. дела) 
技量 		способности умение искусство мастерство 
犠牲 		жертва 
犠牲者 		жертва 
疑う 		сомневаться подозревать 
疑わしい 		сомнительный подозрительный 
蟻 		муравей 
蟻酸 		муравьиная кислота 
蟻食い 		муравьед 
蟻塚 		муравейник 
議員 		депутат член парламента 
議会 		(1) парламент (2) сессия парламента 
菊 		хризантема 
吃り 		(1) заикание (2) заика 
吃る 		заикаться 
吃音 		заикание 
吃驚 		поражаться пугаться 
喫煙 		курение 
喫煙者 		курящий 
喫茶店 		кафе 
客 		гость клиент 
客車 		пассажирский вагон 
客体 		объект 
逆数 		обратная величина 
逆説 		парадокс 
逆立ち 		стоять на голове 
久しい 		долгий продолжительный 
仇同士 		взаимные враги 
休み 		отдых 
休む 		отдыхать пропускать (занятия, работу) 
休暇 		выходной отпуск 
休憩 		перерыв 
休養 		отдых 
吸血鬼 		вампир 
宮殿 		дворец 
弓 		лук (оружие) 
弓なり 		дуга дугообразная форма 
弓術 		искусство стрельбы из лука 
急がば回れ 		"тише едешь - дальше будешь" "если спешишь, поезжай в объезд" 
急ぐ 		спешить торопиться 
急行 		скорый поезд 
急行券 		билет на скорый поезд 
救急 		первая помощь 
救急車 		машина скорой помощи 
泣き声 		плачущий голос плач 
泣く 		плакать 
球 		шар сфера 
球体 		шар сферическое тело 
級数 		(мат.) ряд 
給仕 		официант 
給水制限 		ограничение водоснабжения 
牛 		бык корова 
牛肉 		говядина 
牛乳 		(коровье) молоко 
去年 		прошлый год 
居酒屋 		кабак трактир 
居眠り 		дремота 
拒む 		отказывать отвечать отказом 
拒絶 		отказ 
拒否 		отказ отклонение вето 
挙式 		церемония обряд торжество 
虚偽 		ложный подложный 
虚数 		мнимое число 
許す 		разрешать прощать 
距離 		расстояние 
漁村 		рыбачья деревня 
魚雷 		торпеда 
京阪神 		Киото-Осака-Кобэ 
競泳 		соревнования по плаванию 
競争 		соревнование конкуренция 
競走 		соревнование по бегу 
共に 		вместе 
共産主義 		коммунизм 
共産主義者 		коммунист 
共産党 		коммунистическая партия 
共産党中央委員会 		ЦК КП Центральный Комитет Коммунистической Партии 
共同体 		община 
共謀 		заговор сговор 
共和国 		республика 
協会 		общество ассоциация 
協議会 		совещание конференция 
強い 		сильный крепкий 
強さ 		сила мощь 
強調 		подчёркивание выделение 
強盗 		грабёж 
恐怖 		страх испуг ужас 
恭しい 		почтительный подобострастный 
恭賀新年 		"с новым годом!" 
恭順 		верность преданность повиновение 
教える 		преподавать обучать объяснять 
教科書 		учебник 
教会 		церковь 
教師 		учитель (профессия) 
教室 		аудитория 
教授 		профессор преподаватель 
教壇 		кафедра 
橋 		мост 
狂犬 		бешеная собака 
狂犬病 		бешенство (болезнь) 
狭い 		узкий тесный маленький (о помещении) 
狭まる 		суживаться сокращаться 
狭める 		сужать сжимать сокращать 
狭義 		узкий смысл 
狭心症 		грудная жаба 
胸 		грудь 
胸当て 		нагрудник 
興がる 		интересоваться находить удовольствие 
興す 		поднимать возрождать восстанавливать 
興ずる 		развлекаться веселиться 
興る 		быть на подъёме процветать расцветать 
興業 		промышленный 
興国 		расцвет страны 
興趣 		(1) интерес вкус (к чем-л.) (2) прелесть (чего-л.) 
興亡 		процветание и упадок величие и падение судьба 
興味 		(1) интерес вкус (к чем-л.) (2) прелесть (чего-л.) 
蕎麦 		соба (лапша из гречневой муки 
鏡 		зеркало 
響く 		(1) раздаваться звучать (2) отзываться сказываться 
驚く 		удивляться поражаться 
仰っしゃる 		говорить 
業 		(1) дело деяние работа (2) искусство ловкость 
業務 		работа обязанности по работе 
曲 		мелодия мотив музыка музыкальная пьеса 
曲がる 		поворачивать огибать (угол) заворачивать (за угол) 
曲線 		кривая 
玉ねぎ 		лук луковица 
玉蜀黍 		кукуруза 
桐 		павловния 
勤める 		служить 
勤務員 		служащий 
勤労者 		трудящийся рабочий 
均衡 		равновесие баланс 
均整 		симметрия 
均等 		равенство 
錦 		парча 
錦絵 		цветная гравюра 
錦蛇 		питон 
禁じる 		запрещать 
禁ずる 		запрещать 
禁煙 		"не курить!" 
禁煙車 		вагон для некурящих 
禁止 		запрещение 
筋 		линия 
緊急 		срочный чрезвычайный 
緊張 		напряжённость натянутость 
緊迫 		напряжение обострение 
緊密 		строгий тесный 
謹聴 		внимательно слушать почтительно слушать 
近い 		близкий 
近い将来 		ближайшее будущее 
近く 		поблизости вскоре по соседству 
近づく 		приближаться сближаться 
近似 		приближённый приблизительный 
近親相姦 		инцест 
近代 		современность новейшее время (в Японии с 1868 г.) 
近代化 		модернизация 
近代科学 		современная наука 
近代的 		современный 
近東 		Ближний Восток 
近辺 		окрестности 
金 		(1) деньги (2) металл 
金 		золото 
金塊 		золотой слиток 
金銀 		золото и серебро 
金剛石 		алмаз 
金持ち 		богач 
金星 		Венера (планета) 
金属 		метал 
金髪 		светлые (золотистые) волосы 
金曜日 		пятница 
銀河 		Млечный путь галактика 
銀貨 		серебряная монета 
銀行 		банк 
銀行員 		служащий банка 
九つ 		девять 
九九 		таблица умножения 
九月 		сентябрь 
九州 		остров Кюшу южный из четырёх основных островов Японии 
九日 		девять дней девятое (число месяца) 
倶楽部 		клуб 
区域 		район зона территория 
苦い 		горький 
苦しい 		тяжёлый мучительный 
苦しめる 		подвергать страданиям 
苦悶 		страдания тяготы 
空 		небо 
空っぽ 		пустой 
空間 		пространство 
空軍 		воздушные войска 
空港 		аэропорт 
空手 		карате 
空手家 		занимающийся карате каратека 
空想 		мечта фантазия 
偶数 		чётное число 
偶然 		случайно 
偶像 		изображение статуя идол 
偶発 		случайный случайно возникший 
隅 		угол (внутренний) 
櫛 		гребень гребёнка 
屑 		отходы лом 
屑籠 		корзина для бумаг 
屈伸 		эластичность сжимание и вытягивание 
靴 		обувь 
熊 		медведь 
栗 		каштан 
栗鼠 		белка 
鍬 		мотыга 
君 		ты 
君臨 		правление царствование 
群馬県 		Гумма (префектура) 
軍歌 		военная песня фронтовая песня 
軍艦 		военный корабль 
軍事力 		военная мощь 
軍隊 		войска армия 
軍閥 		военщина милитаристская клика 
係数 		коэффициент 
傾向 		склонность тенденция 
兄 		старший брат 
兄さん 		старший брат 
兄貴 		старший брат 
兄弟 		братья и сёстры 
型 		тип форма 
形 		форма фигура 
形而下 		физический материальный 
形而上 		метафизический 
形成 		формирование 
形態 		форма 
形容詞 		прилагательное 
掲示板 		доска объявлений 
携帯電話 		мобильный телефон сотовый телефон 
敬愛 		любовь и уважение 
敬遠 		держаться на почтительном расстоянии 
敬語 		вежливое слово вежливая речь 
景色 		пейзаж вид 
渓谷 		ущелье 
稽古 		упражнение 
系 		система 
経つ 		проходить (о времени) 
経営 		хозяйство управление 
経営学 		экономика 
経験 		опыт 
経済 		экономика 
経文 		сутра 
経路 		путь маршрут 
継ぐ 		следовать (за кем-чем-л.) наследовать 
継続 		продолжение 
継父 		отчим 
継母 		мачеха 
蛍 		светлячок 
計画 		план проект схема 
計量経済学 		эконометрика эконометрия 
警戒心 		бдительность 
警察 		полиция 
警察官 		полицейский (работник) 
警察署 		отделение полиции 
軽い 		лёгкий 
軽震 		слабое землетрясение 
軽蔑 		презрение пренебрежение 
鶏 		курица петух 
鶏舎 		курятник птичник 
鶏卵 		куриное яйцо 
芸者 		гейша 
芸術 		искусство 
芸能 		спектакль сценическое мастерство 
芸名 		сценический псевдоним 
劇 		пьеса 
劇場 		театр (здание) 
激発 		внезапная вспышка 
傑作 		шедевр 
欠陥 		дефект 
欠点 		недостаток 
欠片 		кусок осколок часть 
決して 		ни в коем случае 
決まり文句 		часто используемая фраза клише 
決める 		решать определять устанавливать 
決心 		решимость 
決戦 		решающее сражение 
決定 		решение определение постановление 
結ぶ 		связывать завязывать заключать (договор) 
結果 		результат итог 
結構 		хорошо ладно 
結婚 		свадьба женитьба замужество 
結婚式 		свадьба церемония бракосочетания 
結婚披露宴 		свадебный обед 
結晶 		(1) кристаллизация (2) кристалл (3) (перен.) результат плод (усилий и т. п.) 
結成 		образование формирование организация 
血 		кровь 
血液 		кровь 
血液凝固 		свёртывание крови коагуляция коагулянт 
血液型 		группа крови 
血液循環 		кровообращение 
血管 		кровеносный сосуд 
血族 		кровное родство 
月 		луна месяц 
月下に 		при лунном свете 
月面 		поверхность луны 
月曜日 		понедельник 
強か 		сильно много 
健やか 		здоровый 
健気 		(1) мужественный отважный (2) похвальный (3) усердный старательный 
健脚 		хороший ходок 
健勝 		превосходное здоровье 
健闘 		упорная борьба упорные старания 
健忘 		забывчивость 
健啖 		обжорство 
剣道 		кэндо (яп. фехтование) 
喧嘩 		ссора 
嫌い 		нелюбимый не любить не нравиться 
建てる 		строить сооружать 
建設 		строительство 
建築 		(1) строительство (2) архитектура (здания) (3) здание сооружение 
建物 		здание 
憲法 		конституция 
拳 		кулак 
検挙 		арест 
検尿 		анализ мочи 
権威 		авторитет 
権力 		политическая сила власть 
牽制 		(1) сдерживание остановка ограничение (2) отвлечение внимания диверсия 
犬 		собака 
研究 		исследование изучение 
研究員 		исследователь 
絹 		шёлк 
肩 		плечо 
見える 		виднеться 
見せる 		показывать 
見る 		видеть смотреть 
見事 		красивый превосходный 
見送る 		провожать 
見地 		точка зрения 
見渡す 		окинуть взглядом 
見物 		осмотр (города, достопримечательностей) 
見本 		образец 
謙虚 		скромность 
謙遜 		скромность 
鍵 		ключ 
元気 		бодрость энергия 
原告 		истец 
原作 		оригинал подлинник (произведения) 
原子 		атом 
原子核 		атомное ядро 
原子説 		атомная теория 
原子力 		атомная энергия ядерная энергия 
原子力発電所 		атомная электростанция 
原子炉 		атомный реактор 
原爆 		атомная бомба 
原理 		принцип 
厳か 		торжественный величественный 
厳しい 		строгий суровый 
厳禁 		строгий запрет 
厳守 		строгое соблюдение 
幻想 		иллюзия фантазия 
弦楽器 		струнные инструменты 
減る 		изнашиваться уменьшаться 
減少 		уменьшение 
源 		источник исток 
表す 		выявлять обнаруживать выражать 
現れる 		появляться 
現金 		наличные деньги 
現在 		современность 
現象 		явление феномен 
現像 		проявление (плёнки) 
現代 		современность 
舷側 		борт судна 
言うまでもない 		нечего и говорить и говорить не приходится само собой разумеется 
言語 		язык речь 
言語学 		лингвистика языкознание 
言葉 		слово язык 
諺 		пословица 
限る 		ограничивать ограничиваться 
限界 		лимит граница 
限度 		предел 
個体 		индивидуум особь 
古い 		старый 
古体 		архаический стиль 
古代 		древний 
古典 		классика 
古典文学 		классическая литература 
古墳 		курган древняя могила 
呼び出す 		звать вызывать 
呼び鈴 		звонок 
呼ぶ 		называть звать приглашать 
固有値 		собственное значение 
孤独 		одиночество 
孤立 		изоляция 
孤立化 		изоляция 
孤立主義 		изоляционизм 
戸 		дверь 
故人 		покойный 
枯れ枝 		сухая ветка 
湖 		озеро 
狐 		лиса 
胡座 		поза сидения со скрещенными впереди ногами 
胡桃 		орех 
胡椒 		перец 
虎 		тигр 
誇る 		гордиться (чем-л.) 
鼓 		барабан 
鼓手 		барабанщик 
鼓吹 		внушать воспитывать 
鼓笛 		барабаны и флейты 
鼓動 		биение стук 
鼓舞 		воодушевить вдохновить 
鼓腹 		удовлетворение 
鼓膜 		барабанная перепонка 
五 		пять 
五つ 		пять 
五感 		пять чувств 
五月 		май 
五人組 		пятёрка пять человек 
五日 		пять дней пятое (число месяца) 
五輪大会 		олимпиада 
互恵 		взаимовыгода 
午前 		утро до полудня 
吾人 		мы 
後 		после 
後悔 		раскаяние сожаление 
後継者 		преемник 
御苑 		императорский сад 
御座る 		быть иметься находиться 
御社 		ваша фирма ваша компания 
お日様 		солнце 
ご飯 		(1) рис (варёный) (2) еда 
お目出度う 		"поздравляю!" 
碁 		го (японская игра) 
語 		(1) слово (2) слова речь язык (3) поговорка 
語らう 		(1) разговаривать (2) уговариваться сговариваться 
語り明かす 		проговорить всю ночь 
語る 		говорить рассказывать 
語学 		знание языков изучение языков 
語句 		слова и выражения 
語源 		этимология слова 
語法 		(1) язык манера выражаться (2) законы языка 
誤り 		ошибка 
誤る 		ошибаться заблуждаться 
誤解 		превратное представление заблуждение 
誤差 		ошибка погрешность 
誤植 		опечатка 
乞食 		нищий 
鯉 		карп 
交感 		обоюдная симпатия 
交換 		обмен 
交渉 		переговоры 
交通 		сообщение коммуникация дорожное движение 
交番 		полицейский пост полицейская будка 
交流 		(культурный) обмен связи 
候補者 		кандидат 
光 		свет 
光る 		сверкать блестеть светиться 
光学 		оптика 
光学繊維 		волоконная оптика 
光源 		источник света 
光沢 		блеск глянец 
公園 		парк сад (общественный) 
公会 		открытое собрание 
公使 		 (дипломатический) посланник 
公式 		(1) официальный формальный (2) формула 
公衆電話 		телефон-автомат 
公倍数 		общее кратное 
公分母 		общий знаменатель 
公理 		аксиома 
効果 		результат эффект 
厚い 		толстый (о плоских предметах) добрый сердечный 
口 		(1) рот (2) язык речь 
口径 		калибр 
口語 		разговорный язык 
口紅 		губная помада 
口実 		предлог отговорка 
口付け 		поцелуй 
口付ける 		целовать 
向き 		направленность направление 
向く 		(1) быть обращённым (куда-л.) поворачиваться (2) подходить годиться 
向ける 		поворачивать обращать направлять посылать предназначать 
向こう 		та сторона там они 
向上 		повышение подъём рост улучшение прогресс 
向上心 		честолюбие 
好き 		любимый любить нравиться 
好く 		любить (что-л.) 
好漢 		хороший человек славный парень 
好物 		любимое блюдо любимая еда 
工業 		промышленность индустрия 
工事 		строительные работы 
工兵 		сапёр солдат инженерных войск 
幸福 		счастье 
広い 		широкий просторный 
広告 		реклама 
広州 		Гуанчжоу 
広場 		площадь 
拘束 		ограничение 
攻撃 		атака наступление критика 
攻守 		атака и защита наступление и оборона 
更新 		обновление 
校舎 		здание школы 
構造 		структура 
江 		бухта 
江戸 		Эдо (старое название Токио) 
港 		порт 
皇位 		императорский трон 
皇居 		императорский дворец 
ぬか喜び 		преждевременная радость 
紅茶 		чёрный чай 
綱領 		программа план 
耕す 		возделывать обрабатывать землю 
耕作 		обработка земли земледелие 
耕地 		пахотная земля обрабатываемая площадь 
考える 		думать размышлять 
考古学 		археология 
航空会社 		авиакомпания 
航空機 		летательный аппарат 
航空券 		авиабилет 
行 		линия ряд 
行き先 		направление конечный пункт 
行進 		демонстрация марш 
行列 		матрица 
行列式 		детерминант 
講演 		речь (публичное) выступление 
講演会 		публичная лекция 
講義 		лекция 
講座 		(1) кафедра (2) курс лекций 
講堂 		актовый зал 
郊外 		окрестности города пригород 
鋼 		сталь 
鋼鉄 		сталь 
降る 		идти (о дожде, снеге) 
香港 		Гонконг 
香水 		духи парфюмерия 
高い 		высокий дорогой 
高まる 		подниматься 
高める 		повышать 
高価 		высокая цена 
高血圧症 		гипертония гипотония 
高原 		горная долина плато 
高校 		средняя школа высшей ступени (длится 3 года в Японии) 
高校生 		учащийся средней школа высшей ступени 
高地 		взгорье 
高度 		высота 
高等学校 		средняя школа высшей ступени (длится 3 года в Японии) 
剛体 		твёрдое тело 
号泣 		громкий плач причитание 
合う 		совпадать подходить 
合わせる 		присоединять объединять соединять 
合格 		успех (на экзаменах) 
合気道家 		занимающийся айкидо айкидока 
合計 		итог 
合唱団 		хор 
豪州 		Австралия 
告げる 		сообщать говорить 
告示 		извещение объявление 
告白 		признание признаваться 
告発 		обвинение предъявление обвинения возбуждение дела 
国家 		государство 
国歌 		государственный гимн 
国会 		национальное собрание парламент (в Японии с 1945 г.) 
国旗 		государственный флаг 
国教 		государственная религия 
国語 		(1) национальный язык (2) родной (японский) язык 
国際 		международный 
国際的 		международный 
国璽 		государственная печать 
国籍 		гражданство подданство 
国内 		внутри страны внутренний 
国民 		народ гражданин 
国名 		название страны 
国連 		ООН Организация Объединённых Наций 
穀物 		злаки 
黒い 		чёрный 
黒帯 		чёрный пояс 
黒猫 		чёрная кот чёрная кошка 
黒板 		классная доска 
腰 		талия поясница 
腰掛ける 		садиться (на стул, и т. п.) 
腰掛け 		сиденье 
暈ける 		(1) выцветать бледнеть (2) ослабевать в борьбе 
骨折 		перелом кости 
此処 		здесь (место рядом с говорящим) 
今 		сейчас 
今回 		этот раз на этот раз 
今月 		этот месяц 
今後 		в дальнейшем впредь 
今週 		нынешняя неделя 
今度 		на этот раз теперь 
今日は 		добрый день здравствуйте (дневное приветствие) 
今晩 		сегодняшний вечер 
今晩は 		добрый вечер 
困る 		затрудняться быть в затруднении 
婚約 		обручение 
婚約指輪 		обручальное кольцо 
混ぜる 		смешивать 
混合 		смешение 
混成 		смешивание 
混同 		смешение 
紺 		тёмно-синий 
左 		левый слева 
左舷 		левый борт судна 
左手 		левая рука 
左遷 		понижение в должности деградация 
左足 		левая нога 
左目 		левый глаз 
左翼 		левое крыло левый фланг 
差 		разность 
差し込む 		вкладывать вставлять 
砂糖 		сахар 
詐欺師 		мошенник 
鎖 		цепь цепочка 
座る 		сидеть 
座禅 		дзен медитация 
座談会 		собеседование симпозиум 
座標系 		система координат 
座標軸 		ось координат 
座敷 		гостиная в японском доме 
催す 		устраивать организовывать 
催眠術 		гипноз гипнотизм 
催涙ガス 		слезоточивый газ 
再起動 		перезапуск 
最も 		самый наиболее 
最近 		последнее время недавно 
最後 		конец последний 
最高 		высший верховный 
最初 		вначале сначала 
最新 		новейший самый последний 
最大 		наибольший максимальный 
採択 		принятие утверждение выбор отбор 
歳月 		годы и месяцы время 
歳入 		годовой доход 
歳末 		конец года 
災い 		бедствие катастрофа 
祭壇 		алтарь 
祭日 		праздник праздничный день 
細い 		тонкий (о круглых предметах) узкий 
有る 		быть находиться иметься 
在位 		занимать престол царствовать 
材料 		материал компонент 
財産 		имущество состояние 
財閥 		дзайбацу (финансовая олигархия в Японии) 
財布 		кошелёк 
阪神 		Осака-Кобэ 
咲く 		цвести 
崎 		мыс 
作 		(1) произведение (2) урожай 
作り 		выделка работа 
作り出す 		(1) выделывать изготовлять (2) выдумывать изобретать 
作り声 		чужой голос нарочно изменённый голос 
作り方 		способ изготовления как сделать как сделано как написать как написано (о произведении) 
作意 		(1) намерение (2) замысел (произведения) 
作為 		(1) (юр.) совершение (2) искусственность 
作家 		писатель автор 
作興 		подъём воодушевление 
作業 		работа работы 
作曲 		композиция сочинение музыки 
作曲者 		композитор 
作図 		черчение 
作成 		составление (напр. документа) 
作製 		производить изготовлять 
作戦 		военные действия операция 
作品 		литературное произведение художественное произведение 
作物 		посевы сельскохозяйственные культуры урожай 
作法 		способ изготовления рецепт изготовления приёмы написания поведение манеры 
作用 		действие (на что-л.) процесс 
搾取 		эксплуатация 
昨年 		прошлый год 
索 		верёвка канат 
索引 		указатель индекс 
錯綜 		усложнение 
撮る 		снимать фотографировать 
撮影 		фотосъёмка киносъёмка 
撮影者 		фотограф 
撮要 		краткий очерк 
殺す 		убивать 
殺人者 		убийца 
殺虫剤 		инсектицид 
雑音 		фон шум 
雑巾 		тряпка 
雑誌 		журнал 
五月 		пятый месяц лунного календаря 
皿 		тарелка 
三つ 		три 
三角法 		тригонометрия 
三脚 		тренога 
三月 		март 
三人 		трое три человека 
三人寄れば文殊の知恵 		"одна голова хорошо, а две лучше" 
三人称 		третье лицо 
三千 		три тысячи 
三相 		три фазы 
三相交流 		трёхфазный ток 
三等 		третий класс 
三日 		три дня третье (число месяца) 
傘 		зонт 
傘立て 		подставка для зонтиков 
参る 		приходить идти 
参加 		участие 
参詣 		паломничество 
山 		гора 
山寺 		горный храм 
山猫 		рысь 
山脈 		горный хребет 
山羊 		козёл коза 
散る 		опадать 
散弾銃 		дробовик 
散歩 		прогулка 
散漫 		рассеянный бессвязный отрывочный 
酸っぱい 		кислый 
暫く 		некоторое время момент мгновение 
暫くすると 		через некоторое время 
暫時 		кратковременный преходящий 
暫定 		временный предварительный 
暫定協定 		предварительное соглашение 
暫定政府 		временное правительство 
残る 		оставаться 
残酷 		жестокость 
残忍 		жестокость 
残念 		сожаление 
残念ながら 		к сожалению вынужден сказать (и т. п. вступления) 
仕事 		работа занятие 
仕事日 		рабочий день 
使う 		использовать употреблять 
使徒 		апостол 
史上 		в истории 
四つ 		четыре 
四角形 		четырёхугольник 
四月 		апрель 
四日 		четыре дня четвёртое (число месяца) 
四半期 		квартал года 
四方 		со всех сторон во всех направлениях 
士官 		офицер 
士気 		моральный дух (войска, команды) 
始まる 		начинаться 
始める 		начинать 
姉 		старшая сестра 
姉さん 		старшая сестра 
姉貴 		старшая сестра 
姉上 		старшая сестра 
姿 		внешний вид форма облик 
子音 		согласный звук 
子供 		ребёнок 
子守歌 		колыбельная 
子孫 		потомок 
市 		город 
市外 		за чертой города 
市外電話 		междугородный телефонный звонок 
市街 		улицы города 
市長 		мэр 
市内 		город в черте города 
市民 		горожане граждане 
市役所 		муниципальное управление мэрия 
師団 		дивизия 
思い出す 		вспоминать 
思い当たる 		приходить на ум 
思索 		размышление 
思想 		идея идеология 
指 		палец 
指数 		показатель 
指定 		назначение предназначение 
指定券 		билет на забронированное место 
指定席 		забронированное место 
指摘 		указание 
指導 		руководство 
指導者 		руководитель лидер вождь 
指紋 		отпечатки пальцев 
支持 		поддержка 
支線 		ответвление ветка (ж.-д.) 
施設 		устройство сооружение учреждение заведение 
上手い 		умелый ловкий искусный (1) умелый ловкий искусный (2) успешный удачный 
止まる 		останавливаться оставаться там же 
止む 		прекращаться переставать 
止める 		прекращать переставать бросать отказываться 
死 		смерть 
死ぬ 		умирать 
死刑 		смертная казнь 
死語 		(1) мёртвый язык (2) устаревшее слово 
死人 		мертвец труп умерший 
死体 		труп мёртвое тело 
氏名 		фамилия и имя 
獅子 		лев 
私 		я 
私 		я 
私室 		личная комната 
私塾 		частная школа 
私たち 		мы 
私邸 		особняк 
私的 		частный 
私立大学 		частный университет 
糸 		нить 
紙 		бумага 
紙幅 		выделенное место (под статью и т. п.) ширина бумаги 
紙幣 		банкнот бумажные деньги 
紫 		фиолетовый цвет 
紫外線 		ультрафиолетовые лучи 
紫色 		фиолетовый цвет 
紫水晶 		аметист 
詩人 		поэт 
試験 		экзамен 
試合 		матч встреча (спортивная и т. п.) 
誌上 		на страницах журнала 
諮る 		советоваться консультироваться 
資本主義 		капитализм 
資料 		материал данные 
雌 		самка 
飼う 		выкармливать держать (животных) 
歯ブラシ 		зубная щётка 
歯医者 		зубной врач 
歯科医 		зубной врач 
事 		дело обстоятельство 
事件 		событие происшествие 
事実 		факт реальность 
似せる 		(1) копировать (2) подделывать 
似る 		быть похожим походить 
似寄る 		походить быть аналогичным 
似合う 		быть к лицу быть подходящим идти 
似合わしい 		подходящий идущий к лицу 
似非 		псевдо- квази- лже- 
侍 		самурай 
児童 		ребёнок 
字引 		словарь 
字体 		(1) шрифт печать (2) вид знака 
寺 		храм (буддийский) 
寺院 		храм 
慈悲 		сострадание милосердие 
慈悲心 		сострадание чувство сострадания 
持ち込む 		вносить приносить 
持っていく 		уносить относить брать с собой (что-л.) 
持ってくる 		приносить 
持つ 		держать (в руках) брать (в руки) иметь 
時 		время час 
時間 		время 
時計 		часы 
時刻表 		расписание 
時差 		разница во времени 
時代 		период эра эпоха 
次 		следующий 
次位 		второстепенное положение второе место 
治まる 		стихать улаживаться быть спокойным 
治める 		(1) управлять (2) усмирять улаживать 
治療 		лечение медицинская помощь 
磁気 		магнетизм 
示す 		показывать указывать (на что-л.) 
耳 		ухо 
耳を貸す 		выслушивать обращать внимание 
耳順 		60 лет (возраст) 
耳障り 		неприятный на слух режущий ухо 
耳鼻科 		оторинология 
耳目 		уши и глаза внимание (чьё-л.) 
自衛隊 		силы самообороны (также название японских вооружённых сил) 
自家撞着 		непоследовательность внутреннее противоречие 
自国語 		родной язык (кого-л.) 
自殺 		самоубийство 
自殺未遂 		попытка самоубийства 
自習 		самообучение 
自信 		уверенность в себе 
自然 		природа 
自然数 		натуральное число 
自転車 		велосипед 
自動車 		автомобиль 
自発的 		самопроизвольный спонтанный 
自分 		сам свой 
自由 		свобода 
辞める 		уходить в отставку 
辞職 		отставка 
辞退 		отказ отклонение отвод самоотвод 
鹿 		олень 
式辞 		поздравительный адрес 
式場 		актовый зал место церемонии 
式典 		церемония торжество 
七 		семь 
七つ 		семь 
七月 		июль 
執行 		исполнение приведение в действие 
執念深い 		мстительный 
失業 		безработица 
失業者 		безработный 
失礼 		грубость невежливость 
失恋 		несчастная любовь 
湿度 		влажность уровень влажности 
質問 		вопрос 
実 		правда реальность 
実家 		родительский дом 
実現 		реализация осуществление 
実際に 		на самом деле 
実数 		действительное число вещественное число 
実体 		субстанция 
芝居 		спектакль 
舎営 		расквартировываться 
写実主義 		реализм (направление в литературе, искусстве) 
写真 		фотография 
射影 		проекция 
射撃 		стрельба 
煮る 		тушить (готовить) 
煮沸 		кипячение 
社 		синтоистский храм 
社員 		сотрудник компании 
社会 		общество 
社会主義 		социализм 
社宅 		жильё принадлежащее предприятию 
社長 		президент фирмы 
者 		человек некто 
謝る 		извиняться 
謝罪 		извинение признание своей вины 
車 		машина повозка вагон 
車庫 		гараж 
車掌 		кондуктор (в поезде) 
車道 		проезжая часть улицы мостовая 
車輪 		колесо 
蛇 		змея 
蛇口 		водопроводный кран 
邪魔者 		помеха 
借りる 		брать взаймы брать на время 
爵位 		титул придворное звание 
若い 		молодой юный 
若さ 		молодость 
若者 		молодой человек молодёжь 
弱い 		слабый 
主語 		подлежащее 
主人公 		(1) протагонист герой главный персонаж (2) хозяин глава семьи 
主婦 		домохозяйка 
主役 		главная роль исполнитель главной роли 
取り扱う 		общаться иметь дело (с кем-чем-л.) 
取り入れる 		заимствовать 
取る 		брать получать 
取れる 		добываться получаться 
守る 		защищать охранять соблюдать (правила, обещание и т. п.) 
守衛 		охрана караул 
守護天使 		ангел-хранитель 
手 		рука 
手に入れる 		приобретать получать 
手荷物 		ручной багаж ручная кладь 
手荷物一時預かり所 		камера краткосрочного хранения ручной клади 
手紙 		письмо 
手術 		хирургическая операция 
手術室 		операционная 
手順 		процедура 
手錠 		наручники 
手袋 		перчатка 
手段 		средство меры 
手伝う 		помогать (физически) 
手入れ 		уход содержание (в рабочем состоянии) 
手箱 		шкатулка 
狩り 		охота 
狩る 		охотиться 
狩人 		охотник 
種 		семена 
種類 		вид сорт род 
首にする 		увольнять выгонять с работы 
首都 		столица 
受ける 		получать подвергаться принимать получать 
受け取る 		получать 
受け付ける 		принимать (вещи, документы и т. п.) 
受取り 		(1) квитанция (2) получение (чего-л.) 
受信 		приём (напр. радио) 
受動喫煙 		пассивное курение 
呪い 		проклятие заклятие 
呪う 		проклинать накладывать проклятие 
呪文 		заклинание 
授業 		урок занятия 
収穫 		урожай 
収束 		сходимость 
宗教 		религия 
就く 		приступать (к работе и т. п.) вступать (в должность) 
就ける 		назначать (на должность и т. п.) прикреплять (к наставнику, учителю) 
就職 		поступление на работу 
就任 		вступление в должность 
州 		область штат провинция 
修飾語 		определение 
修繕 		ремонт починка 
修理 		ремонт починка 
秋 		осень 
秋田県 		Акита (префектура) 
秋分 		осеннее равноденствие 
終える 		заканчивать делать до конца 
終始 		(1) начало и конец с начала до конца делать от начала до конца (2) постоянно 
終点 		конечный пункт 
習う 		учиться (чему-л.) 
週 		неделя 
週刊 		еженедельное издание 
週刊紙 		еженедельник (газета) 
週刊誌 		еженедельник 
週間 		неделя 
集まる 		собираться 
集める 		собирать 
集会 		митинг собрание 
集合 		(1) сбор встреча (2) (мат.) множество 
集積 		накопление 
集中 		сосредоточение 
住する 		жить проживать обитать 
住まう 		жить проживать обитать 
住み慣れる 		обжиться (где-л.) 
住み込む 		поступив на работу, поселиться там же 
住み心地 		уют комфорт (в жилом помещении) 
住み心地の良い 		уютный комфортабельный 
住む 		жить проживать обитать 
住所 		местожительство адрес 
住宅 		квартира жилой дом 
住民 		население жители 
充血 		гиперемия 
十一月 		ноябрь 
十月 		октябрь 
十字街 		перекрёсток 
十手 		дзитте (короткая железная дубинка) 
十二月 		декабрь 
十日 		десять дней десятое (число месяца) 
１０分 		10 минут 
十分 		достаточно вдоволь 
従って 		следовательно поэтому 
従兄 		двоюродный брат (старше по возрасту) 
従兄弟 		двоюродный брат 
従姉 		двоюродная сестра (старше по возрасту) 
従姉妹 		двоюродная сестра 
従弟 		двоюродный брат (младше по возрасту) 
従妹 		двоюродная сестра (младше по возрасту) 
汁粉 		шируко (сладкий суп из красных бобов) 
渋い 		(1) терпкий (2) угрюмый 
縦 		длина высота рост 
縦書き 		вертикальное письмо 
重 		слой 
重い 		тяжёлый 
重なる 		быть сложенным лежать грудой громоздиться 
重ねる 		(1) нагромождать наслаивать класть (одно на другое) (2) повторять делать повторно 
重んじる 		придавать значение дорожить 
重んずる 		придавать значение дорожить 
重役 		директор член совета директоров 
重要 		важный серьёзный 
重量 		вес 
重力 		гравитация 
宿題 		домашнее задание 
祝い 		празднование поздравление 
祝う 		праздновать поздравлять с праздником 
祝宴 		(праздничный) банкет 
祝日 		праздничный день 
熟練 		мастерство 
出す 		отправлять сдавать выдвигать 
出る 		выходить 
出迎え 		встреча приветствие приём 
出迎える 		встречать принимать 
出口 		выход 
出向 		идти направляться 
出征 		отправка на фронт 
出張 		командировка 
出発 		отправление 
出発点 		пункт отправления исходная точка 
出来る 		мочь уметь быть готовым 
出来るだけ 		насколько возможно 
出来事 		событие 
出来心 		прихоть фантазия искушение соблазн 
述べる 		выражать 
述語 		сказуемое 
春 		весна 
春分 		весеннее равноденствие 
瞬間 		момент 
旬刊 		выходящее раз в декаду издание 
準備 		подготовка 
盾 		щит 
順位 		место по порядку 
始め 		начало в начале 
初めて 		впервые 
初夏 		начало лета 
初荷 		первая партия товаров в новом году 
初回 		первый раз 
初級 		начальный уровень 
初詣で 		первое посещение храма в новом году 
初婚 		первый брак 
初志 		первоначальное намерение 
初耳 		(что-то) услышанное в первый раз 
初秋 		ранняя осень начало осени 
初出 		первое появление 
初春 		ранняя весна начало весны 
初旬 		первая декада первые десять дней месяца 
初雪 		первый снег 
初冬 		начало зимы 
初等 		первая степень начальный курс 
初日 		первый день 
初日 		утро первого дня года 
初日の出 		первый восход солнца (в первый день нового года) 
初版 		первое издание 
初犯 		первое преступление 
初夜 		(1) первая ночь (2) начало ночи (3) брачная ночь 
初恋 		первая любовь 
所 		место 
所で 		кстати (говоря) 
所以 		(1) причина (2) способ путь 
所詮 		в конце концов 
所有 		собственность 
暑い 		жаркий горячий 
暑さ 		жара 
曙 		рассвет утренняя заря 
緒 		шнур тесьма завязка 
書き込む 		вписывать заполнять (бланк и т. п.) 
書き方 		написание 
書く 		писать рисовать 
書斎 		рабочий кабинет 
書籍 		книги литература 
書体 		каллиграфический стиль 
書店 		книжный магазин 
諸君 		"Господа!" (обращение ко всем одновременно) 
諸国 		все страны разные страны 
諸島 		острова архипелаг 
助ける 		помогать спасать 
助詞 		служебное слово частица (часть японской речи) 
助成 		содействие способствование 
女 		женщина 
女子 		женщина девушка 
女子大 		женский университет женский колледж 
女神 		богиня 
女性 		женщина 
序文 		предисловие 
除夜 		ночь перед новым годом 
勝つ 		побеждать (кого-л.) 
勝利 		победа 
召し上がる 		есть пить 
商工業 		торговля и промышленность 
商社 		торговая фирма торговая компания 
商店街 		торговый квартал торговая улица 
商売 		(1) торговля дело (2) профессия занятие 
将棋 		сёги (kj) шоги (японские шахматы) 
将軍 		генерал сёгун (kj) 
将来 		будущее в будущем 
小さい 		маленький 
小学 		начальная школа (длится 6 лет в Японии) 
小学校 		начальная школа (длится 6 лет в Японии) 
小学生 		учащийся начальной школы 
小作農 		фермер-арендатор 
小皿 		блюдце 
小耳に挟む 		услышать мельком случайно услышать 
小心 		(1) малодушие (2) скрупулёзность 
小数 		дробь 
小石 		камешек 
小説 		роман повесть новелла 
小川 		речка 
小鳥 		птичка 
小刀 		короткое лезвие короткий нож короткий меч 
小麦粉 		пшеничная мука 
少し 		немного немножко 
少ない 		малочисленный в малом количестве 
少年 		мальчик подросток 
床 		пол 
床屋 		парикмахерская 
承諾 		согласие 
承認 		признание согласие одобрение 
抄訳 		сокращённый перевод 
晶化 		кристаллизация 
松 		сосна 
松林 		сосновый лес 
消える 		гаснуть исчезать 
消す 		гасить стирать (написанное) отключать питание 
消毒 		дезинфекция 
焼く 		жарить 
焼酎 		хлебное саке 
焦げる 		подгорать обугливаться 
照らす 		освещать 
笑う 		смеяться 
笑み 		улыбка 
笑顔 		улыбающееся лицо 
肖像画 		портрет 
衝撃 		удар столкновение 
衝動 		толчок импульс побуждение 
衝突 		удар столкновение 
詳しい 		знающий подробный точный 
象牙 		слоновая кость 
障子 		раздвижные перегородки 
上 		вверху наверху сверху на над находящийся наверху верхний высший лучший старший 
上 		верхний наружный вверху вверх высший 
上 		(1) верх верхняя часть (2) верхи власти 
上 		(1) верх лучшее (2) 1-ый том двухтомника или трёхтомника 
上がり 		(1) подъём повышение (2) продвижение вперёд прогресс успехи (3) доход сбор 
上がり段 		лестница ступенька 
上がり目 		(1) косые глаза (2)тенденция на повышение (3) поворот к лучшему 
上がる 		(1) подниматься повышаться (2) заходить (3) приезжать в столицу 
上げる 		(1) поднимать повышать (2) преподносить давать (2-му лицу) приводить (в качестве примера) жарить в масле 
上げ下げ 		(1) подъём и спуск повышение и понижение (2) похвала и порицание 
上げ下ろし 		(1) поднятие и спуск (2) погрузка и выгрузка 
上げ蓋 		крышка люка 
上げ潮 		прилив 
上り 		(1) подъём восхождение (2) поезд идущий в столицу (крупный город) 
上り坂 		подъём 
上り列車 		поезд, идущий в столицу (большой город) 
上る 		(1) подниматься взбираться (2) идти вверх 
上演 		ставить на сцене играть на сцене 
上下 		(1) верх и низ (2) подъём и падение колебание (3) верхи и низы правители и народ начальство и подчинённые (4) 1-й и 2-й тома двухтомника 
上記 		вышеупомянутый 
上級 		(1) высший разряд (2) старший класс (в школе) 
上京 		ехать в столицу 
上甲板 		верхняя палуба 
上告 		апелляция (в вышестоящий орган) 
上手 		умение умелый искусный 
上出来 		(1) прекрасная работа (2) удача успех 
上旬 		первая декада первые десять дней месяца 
上書き 		надпись адрес (на конверте, пакете) 
上水 		водопроводная вода 
上訴 		апелляция 
上体 		верхняя часть тела 
上代 		глубокая древность 
上値 		более высокая цена 
上中下 		первый, второй и третий 
上長 		высший старший начальник 
上塗 		покрывать слоем краски закрашивать 
上騰 		подъём повышение 
上半期 		первая половина года 
上物 		прекрасная вещь высокосортная вещь 
上役 		старший (по чину и т. п.) 
上陸 		высадка на берег 
乗る 		садиться (в вагон, машину) ехать (на чём-л.) 
乗換駅 		станция пересадки 
乗換券 		билет для пересадки (с одного транспорта на другой) 
乗数 		множитель 
乗法 		умножение 
乗用車 		автомашина 
冗漫 		многословие 
城壁 		крепостная стена 
場合 		случай 
場所 		место 
場面 		сцена (часть действия) 
情勢 		ситуация 
情報 		информация 
情報理論 		теория информации 
条件 		условия 
浄化 		очищение 
畳 		татами соломенный мат 
蒸す 		парить (готовить) 
譲る 		уступать 
錠剤 		таблетка 
飾る 		украшать выставлять для украшения 
職業 		занятие профессия 
職歴 		послужной список служебный стаж 
色 		цвет 
触る 		касаться дотрагиваться 
触れる 		касаться задевать трогать упоминать 
触覚 		осязание 
触媒 		катализатор 
食べる 		есть 
食塩 		столовая соль 
食器 		столовая посуда 
食事 		пища еда 
食堂 		столовая 
食堂車 		вагон-ресторан 
食欲 		аппетит 
食料品 		продукты продовольствие гастрономия 
食糧 		продовольствие пища 
のし上がる 		(1) становиться на цыпочки (2) выдвигаться преуспевать 
伸す 		вытягивать расправлять 
伸びやか 		удобный привольный 
伸びる 		растягиваться вытягиваться удлиняться распрямляться 
伸び上がる 		тянуться (к чему-л.) становиться на цыпочки 
伸び伸び 		свободно легко 
伸び悩む 		расти с трудом развиваться с трудом 
伸縮 		удлинение и сокращение расширение и сужение эластичность 
伸展 		растяжимость 
信じる 		верить доверять 
信号 		светофор сигнал дорожный знак 
唇 		губы 
寝る 		ложиться спать 
寝言 		разговор во сне бред 
寝言を言う 		разговаривать во сне бредить 
寝室 		спальня 
寝床 		постель 
寝台車 		спальный вагон 
寝付く 		заснуть 
心 		сердце душа 
心遣い 		беспокойство забота 
心構え 		готовность 
心細い 		беспомощный одинокий (2) безрадостный унылый 
心残り 		сожаление 
心持ち 		(1) настроение самочувствие (2) чуть-чуть немного 
心情 		чувства настроение 
心身 		душа и тело 
心臓 		сердце (орган) 
心地 		настроение ощущение чувство 
心中 		самоубийство по сговору (влюблённых и т. п.) 
心的 		душевный психический психологический 
心電図 		электрокардиограмма 
心配 		беспокойство (о ком-л.) забота 
心棒 		ось стержень вал 
心理 		душевное состояние психология 
心労 		беспокойство заботы тревоги 
慎重 		осторожность осмотрительность 
振動 		колебание 
新しい 		новый 
新しがり屋 		любитель новинок 
新た 		новый свежий 
新刊 		новое издание 
新婚 		молодожёны 
新婚旅行 		свадебное путешествие 
新体制 		новый порядок новая система 
新築 		новостройка новая постройка 
新婦 		невеста 
新聞 		газета 
新聞社 		газетное издательство 
新郎 		жених 
新郎新婦 		жених и невеста 
森 		лес 
深い 		глубокий 
深まる 		углубляться 
深める 		углублять 
申し上げる 		сказать заметить 
申告 		заявление 
真 		правда истина 
真っ暗 		совершенно тёмный 
真空管 		электронная лампа радиолампа 
真似 		подражание 
真心 		искренность чистосердечие 
真筆 		автограф 
神 		бог божество 
神宮 		синтоистский храм 
神経 		нервы 
神話 		миф легенда 
紳士 		джентльмен 
親愛 		(1) глубокое чувство (2) дорогой любимый 
親戚 		родственник 
親切 		доброта сердечность 
診る 		осматривать (больного) 
診察 		медицинский осмотр 
診断 		диагноз 
身分証明書 		документы удостоверяющие личность 
辛い 		острый (о пище) 
辛い 		трудный тяжкий 
進む 		продвигаться двигаться вперёд 
進める 		двигать (вперёд) продвигать 
進化 		эволюция развитие 
進歩 		прогресс развитие 
針 		игла рыболовный крючок стрелка часов 
針金 		проволока 
震える 		дрожать трястись 
震央 		эпицентр землетрясения 
震災 		землетрясение (как бедствие) 
人違い 		обознаться принять одного человека за другого 
人間 		человек 
人魚 		русалка тритон 
人形 		кукла 
人絹 		искусственный шёлк 
人口 		население (численность) 
人口密度 		плотность населения 
人工衛星 		искусственный спутник 
人殺し 		убийство убийца 
人種 		раса 
人種差別 		расовая дискриминация 
人種差別主義者 		расист 
人生 		(человеческая) жизнь 
人体 		человеческое тело 
人体 		(1) вид внешность (2) нрав 
人道主義 		гуманизм 
人非人 		изверг 
人民 		народ 
人力車 		рикша 
人類 		человечество 
人類猿 		человекообразная обезьяна 
人類学 		антропология 
塵 		пыль 
ちり取り 		совок для мусора 
陣痛 		родовые муки 
酢 		уксус 
図書館 		библиотека 
吹く 		дуть играть (на духовом инструменте) 
吹奏 		игра на духовых инструментах 
垂下 		свешиваться 
推薦 		рекомендация 
推定 		оценка 
推論 		вывод заключение 
水 		вода 
水泳 		плавание 
水銀 		ртуть 
水銀柱 		столбик ртути 
水彩画 		акварель 
水準 		уровень (инструмент) 
水晶 		кристалл 
水星 		Меркурий (планета) 
水素 		водород 
水族館 		аквариум (строение) 
水着 		купальник 
水筒 		фляга 
水道 		водопровод 
水無月 		шестой месяц лунного календаря 
水面 		поверхность воды уровень воды 
水曜日 		среда (день недели) 
水路 		водный путь 
炊事 		приготовление пищи кулинария 
睡眠 		сон 
遂に 		в конце концов 
随分 		очень порядочно 
数える 		считать 
数回 		несколько раз 
数詞 		числительное 
数字 		цифра 
数値 		численный 
数日 		несколько дней 
数日間 		в течении нескольких дней 
数日後 		через несколько дней 
数年 		несколько лет 
杉 		криптомерия японская 
雀 		воробей 
世界 		мир свет общество 
世界一 		лучший в мире 
世紀 		век столетие 
瀬戸内海 		Внутреннее Японское море 
制限 		ограничение 
制服 		униформа 
姓 		фамилия 
姓名 		имя и фамилия полное имя 
性別 		пол 
成り果てる 		опуститься дойти до (чего-л. плохого) 
成り上がる 		внезапно выдвинуться внезапно разбогатеть 
成り立つ 		(1) образовываться осуществляться состояться (2) состоять (из чего-л.) 
成る 		(1) становиться делаться превращаться (2) составлять (3) состоять (из чего-л.) (4) выходить получаться 
成るべく 		насколько возможно 
成る丈 		насколько возможно по возможности 
成果 		результат успех 
成金 		скороспелый богач нувориш 
成功 		успех 
成就 		осуществление достижение (цели) 
成熟 		взросление зрелость спелость 
成人 		взрослый 
成績 		успехи (в чём-л.) достижения 
成長 		рост развитие 
成程 		в самом деле действительно "всё ясно" "я понял" 
成年 		совершеннолетие 
成敗 		(1) кара наказание (2) суд отправление правосудия 
成仏 		достичь нирваны стать буддой 
成分 		составная часть составной элемент состав 
成立 		осуществление образование учреждение 
政策 		политический курс 
政治 		политика 
政治家 		политический деятель 
政府 		правительство 
整数 		целое число 
整理 		упорядочение 
星 		звезда планета 
星空 		звёздное небо 
晴れ 		ясная погода 
晴れる 		проясняться (о небе) рассеиваться 
正しい 		правильный справедливый 
正確さ 		точность 
正午 		полдень 
正数 		положительная величина 
清い 		чистый 
清潔 		чистый 
生 		необработанный сырой 
生きる 		жить быть живым 
生まれる 		рождаться 
生化学 		биохимия 
生活 		жизнь быт существование 
生活費 		расходы на жизнь 
生産 		производство 
生産高 		объём производства 
生体 		живой организм 
生徒 		ученик 
生年月日 		дата рождения (год, месяц и число) 
生物学 		биология 
生物兵器 		биологическое оружие 
生理 		менструация 
盛ん 		процветающий обильный 
精一杯 		изо всех сил 
精神 		дух душа 
聖霊 		святой дух 
声 		голос крик зов 
声帯 		голосовые связки 
声明 		декларация 
製品 		готовые изделия продукция товары 
西 		запад 
西瓜 		арбуз 
西欧 		Западная Европа 
西暦 		европейское летоисчисление 
誠実 		искренность 
誓う 		клясться присягать давать слово 
誓願 		клятва обет 
青い 		синий голубой бледный (о лице) 
青空 		голубое небо 
青春 		молодость 
青森県 		Аомори (префектура) 
青銅 		бронза 
青年 		юноша молодой человек 
静か 		тихий спокойный 
税関 		таможня 
席 		место (сидения) 
惜しむ 		любить ценить 
昔 		давно в старину 
石 		камень 
石棺 		(каменный) саркофаг 
石鹸 		мыло 
石油 		керосин 
積む 		грузить нагромождать 
積もり 		намерение 
積分 		интеграл 
赤い 		красный 
赤ん坊 		ребёнок 
赤軍 		Красная Армия 
赤毛 		рыжие волосы 
切り石 		тёсаный камень 
切る 		резать 
切手 		почтовая марка 
切符 		билет 
切腹 		сэппуку 
接触 		контакт прикосновение соприкосновение 
接続 		соединение 
接頭語 		префикс приставка 
接尾語 		суффикс 
折りたたみ 		складной разборный откидной 
設ける 		устраивать создавать 
設備 		оборудование оснащение 
設立 		создание 
説く 		объяснять убеждать проповедовать 
説得 		убеждение (кого-л.) 
説明書 		инструкция (на бумаге) 
雪 		снег 
雪国 		снежная страна 
絶えず 		непрерывно 
絶対 		абсолютный безусловный 
絶壁 		обрыв отвесная скала 
絶望 		отчаяние 
舌 		язык 
舌禍 		(1) неудачное выражение (2) обмолвка 
舌先 		кончик языка 
舌打ち 		щёлкать языком 
覇王樹 		кактус 
先ず 		прежде всего 
先に 		впереди спереди заранее раньше 
先月 		прошлый месяц 
先週 		прошлая неделя 
先進国 		развитая страна 
先生 		учитель 
先日 		на днях недавно 
先非 		прежние заблуждения прежние проступки 
千鳥 		зуёк 
千万 		10,000,000 десять миллионов 
専門 		специальность 
専門家 		специалист 
川 		река 
川下 		низовье 
川上 		верховье 
戦く 		дрожать трепетать 
戦記 		военная история военная летопись 
戦国 		страна в состоянии гражданской войны 
戦国時代 		эпоха гражданской войны 
戦死 		смерть на войне 
戦争 		война 
戦闘機 		истребитель 
戦慄 		дрожь трепет содрогание 
扇風機 		(электрический) вентилятор 
泉 		источник родник ключ 
浅い 		мелкий неглубокий 
洗う 		мыть стирать 
洗濯 		стирка 
洗濯物 		бельё для стирки 
洗面 		умывание 
染み 		пятно 
染みる 		проникать просачиваться пронизывать 
染み通る 		просачиваться пропитывать проходить сквозь 
染める 		красить окрашивать 
潜水 		подводное плавание ныряние 
潜水艦 		подводная лодка 
潜水夫 		водолаз ныряльщик 
旋律 		мелодия 
線 		(телефонная) линия (ж.-д.) путь провод 
線形 		линейный 
繊維 		волокно 
船酔い 		морская болезнь 
船舶 		судно (не военное) 
詮索 		поиски розыски исследование 
選挙 		выборы 
選挙権 		избирательное право 
選手 		игрок участник 
選択 		выбор 
銑 		чугун 
銑鉄 		чугун 
前 		перед до 
前衛 		авангард 
前書き 		предисловие преамбула 
前線 		фронт 
前置 		вступление 
前日 		предыдущий день за день до того 
前非 		прежние заблуждения прежние проступки 
前面 		перёд фасад 
良し 		ладно хорошо 
善感 		принятие (прививки) 
漸近 		асимптота 
全 		весь полностью целиком 
全く 		совсем совершенно 
全体 		всё в целом пленарный (о заседании) тотальный (о войне) 
全般的 		универсальный 
全部 		всё полностью целиком 
全滅 		полное уничтожение 
禅 		дзен 
狙い 		цель 
狙う 		целиться 
疎開 		эвакуация 
疎開者 		эвакуируемый 
祖国 		родина отечество 
祖先 		предок 
祖父 		дедушка 
祖母 		бабушка 
粗探し 		придираться 
素人 		неспециалист любитель 
素数 		простое число 
素晴らしい 		замечательный прекрасный 
素描 		эскиз набросок 
組 		комплект набор группа класс организация объединение 
組み立てる 		составлять 
組む 		составлять собирать объединяться 
組合 		ассоциация союз 
組織 		организация 
組長 		староста (группы) 
鼠 		(1) мышь крыса (2) серый мышиный цвет 
鼠疫 		чума 
ネズミ捕り 		(1) мышеловка (2) крысиный яд 
ねずみ色 		серый мышиный цвет 
鼠賊 		мелкий вор 
鼠族 		мыши и крысы грызуны 
鼠輩 		мелкая сошка 
創痕 		шрам 
創造 		создание 
創立 		основание учреждение 
創立者 		основатель создатель 
双曲線 		гипербола гиперболическая кривая 
双子 		близнец близнецы двойня 
村雨 		короткий ливень 
倉廩 		рисовый амбар 
喪服 		траурное одеяние 
壮大 		величественный грандиозный 
捜索 		поиск розыск разведка 
掃く 		подметать мести 
掃除 		уборка (мусора) 
操作 		манипуляция оперирование (чем-л.) 
操縦 		вождение управление пилотирование 
早く 		быстро рано 
早まる 		торопиться спешить 
早期 		ранняя стадия 
早耳 		острый слух 
早足 		быстрый шаг 
早速 		немедленно сейчас же 
漕ぐ 		грести вёслами 
燥ぐ 		веселиться 
相違 		различие разница расхождение 
相似 		сходство подобие 
相手 		партнёр противник 
相対性理論 		теория относительности 
相談 		совет консультация 
相変わらず 		как обычно 
窓 		окно 
窓口 		окошко (на почте и т. п.) 
総会 		общее собрание 
総選挙 		всеобщие выборы 
総体 		в общем в целом в основном 
総理大臣 		премьер-министр 
草 		трава 
葬式 		похороны 
走る 		бежать пробегать идти (о транспорте) 
送り 		проводы 
送る 		посылать 
霜 		мороз иней 
霜月 		одиннадцатый месяц лунного календаря 
騒音 		шум 
増産 		увеличение производства 
増築 		надстройка 
憎い 		ненавистный отвратительный 
憎む 		ненавидеть 
憎悪 		ненависть 
造形美術 		изобразительное искусство 
側 		рядом около возле 
側める 		смотреть в сторону 
側仕え 		личный слуга камеристка 
側線 		боковая ветка запасный путь боковая линия 
側背 		фланг 
側面 		боковая сторона фланг 
息 		дыхание 
息子 		сын 
足 		нога 
足りる 		хватать быть достаточным 
早い 		быстрый ранний 
速さ 		скорость 
速記 		стенография 
速達 		срочная доставка экспресс доставка 
速度 		скорость 
速度計 		спидометр 
俗語 		просторечье 
続く 		продолжаться длиться 
続ける 		продолжать 
卒業 		окончание учебного заведения выпуск (из учебного заведения) 
卒業式 		выпускной акт 
卒業証書 		диплом об окончании учебного заведения 
存じる 		знать думать полагать 
存在 		существование бытие наличие 
孫 		внук или внучка 
孫息子 		внук 
孫娘 		внучка 
尊名 		Ваше имя 
損失 		потери убытки 
損耗 		убытки потери износ 
村人 		деревенский житель 
村長 		староста (деревни, села) 
多い 		многочисленный в большом количестве 
多項式 		полином многочлен 
多少 		сколько-то 
多神論 		политеизм 
多分 		вероятно возможно 
多変量解析 		многовариантный анализ 
多面体 		многогранник 
多様化 		диверсификация 
太い 		толстый 
太る 		толстеть быть толстым 
太鼓 		барабан 
太平洋 		Тихий океан 
太陽 		солнце солнечный 
打つ 		бить ударять 
打撃 		удар 
駄目 		бесполезно невозможно не годится нельзя 
体 		(1) тело организм (2) телосложение фигура (3) здоровье 
体 		(1) тело (2) форма стиль (языка) 
体 		внешний вид состояние 
体育 		физическое воспитание физкультура 
体格 		телосложение конституция 
体験 		собственный опыт проверка на себе 
体現 		воплощение 
体裁 		(1) внешний вид наружность (2) приличие 
体制 		порядок система 
体積 		объём 
体操 		зарядка гимнастика 
体得 		овладеть хорошо усвоить 
体内 		внутри тела 
体罰 		телесное наказание 
体量 		(чей-л.) вес 
対 		против по отношению 
対格 		винительный падеж 
対角線 		диагональ 
対偶 		(1) супруг супруга пара (2) антитеза 
対策 		контрмеры 
対称 		симметрия 
対数 		логарифм 
耐火 		огнеупорный 
耐震 		сейсмостойкий 
帯 		оби (пояс для кимоно) 
待つ 		ждать 
待合室 		зал ожидания приёмная 
怠慢 		халатность небрежность 
態度 		отношение поведение позиция 
滞在 		остановка пребывание 
苔 		мох 
袋 		мешок 
袋小路 		тупик 
退位 		отрешение от престола 
退会 		выход из общества 
退職 		уход с работы отставка 
代議員 		депутат 
代議士 		депутат парламента 
代数 		алгебра 
代数学 		алгебра 
代入 		подстановка 
代表 		представитель представительство делегация 
代表者 		представитель делегат 
代表団 		делегация 
代名詞 		местоимение 
大宇宙 		вселенная 
大雨 		сильный дождь 
大会 		съезд конгресс 
大学 		университет 
大学生 		студент (вуза) 
大気 		атмосфера 
大使 		посол 
大使館 		посольство 
大衆 		массы народ 
大丈夫 		всё в порядке 
大臣 		министр 
大人 		взрослый 
大西洋 		Атлантический океан 
大切 		важный ценный 
大多数 		большинство подавляющее большинство 
大体 		(1) общее содержание суть (2) в общем в целом в основном 
大地震 		сильное землетрясение 
大通り 		проспект 
大統領 		президент 
大部分 		большинство 
大分 		очень значительно 
大変 		очень весьма 
大砲 		пушка орудие 
大理石 		мрамор 
大陸 		континент 
第一 		первый 
第一課 		первый урок 
第一歩 		первый шаг 
第二 		второй 
第二次大戦 		Вторая Мировая Война (1939-1945 гг.) 
第二量子化 		вторая квантизация 
鷹 		сокол ястреб 
滝 		водопад 
沢 		болото 
沢山 		много 
茸 		грибы 
達する 		достигать 
達人 		мастер эксперт 
脱ぐ 		снимать одежду раздеваться 
脱線 		сход с рельсов 
棚 		полка 
鱈 		треска 
鱈子 		тресковая икра 
誰 		кто 
単位 		единица измерения 
単行本 		отдельный том 
単調 		монотонность 
探求 		поиск 
旦那 		(1) хозяин господин (2) муж 
淡い 		бледный слабый 
炭酸水 		газированная вода 
短い 		короткий 
短編小説 		рассказ новелла 
短絡 		короткое замыкание 
誕生 		рождение 
誕生日 		день рождения 
団結 		объединение сплочение 
団体 		организация коллектив 
団長 		глава группы (делегации и т. п.) 
弾圧 		подавление 
弾雨 		ураганный огонь град пуль 
弾丸 		пуля снаряд 
弾力 		упругость эластичность 
断頭台 		гильотина 
暖かさ 		теплота 
暖房 		отопление 
暖流 		тёплое течение 
暖炉 		камин 
男 		мужчина 
男爵 		барон 
男女 		мужчина и женщина мужчины и женщины 
男性 		мужчина 
知らせ 		извещение сообщение 
知る 		знать 
地 		земля 
地位 		положение пост 
地下 		(1) подземный (2) подпольный 
地下室 		подвал 
地下鉄 		метро 
地下道 		подземный переход 
地球 		земля 
地球儀 		глобус 
地区 		участок район 
地形 		рельеф (географический) топография 
地獄 		ад 
地主 		землевладелец помещик лендлорд 
地上 		на земле 
地震 		землетрясение 
地図 		карта 
地帯 		район зона 
地平線 		горизонт 
地方 		район периферия край краевой 
地理 		география 
地理学 		география 
恥じらう 		стесняться быть застенчивым 
恥じる 		стыдиться 
池 		пруд 
置く 		класть ставить 
置換 		подстановка замена 
蜘蛛 		паук 
遅い 		медленный поздний 
遅く 		медленно поздно 
築く 		строить сооружать воздвигать 
畜産 		животноводство 
竹 		бамбук 
竹刀 		бамбуковый (тренировочный) меч 
蓄積 		накопление 
蓄電池 		аккумулятор 
窒素 		азот (N) 
窒息 		удушье 
茶 		чай 
茶色 		коричневый цвет 
着く 		прибывать достигать 
着る 		надевать на тело (пальто, пиджак, платье, рубашку и т. п.) 
着物 		кимоно 
着物姿 		одетый в кимоно 
着陸 		посадка приземление 
中央 		середина средняя часть 
中華料理 		китайское блюдо китайская кухня 
中学 		средняя школа (длится 3 года в Японии) 
中学校 		средняя школа (длится 3 года в Японии) 
中学生 		учащийся средней школы 
中興 		период нового подъёма реставрация 
中近東 		Ближний и Средний Восток 
中古 		(1) бывший в употреблении (2) средневековье 
中古車 		бывшая в употреблении машина 
中古品 		бывшие в употреблении товары 
中旬 		вторая декада 
中心 		центр середина средоточие фокус 
中心地 		центр (напр. торговли, культуры, промышленности и т. п.) 
中庭 		двор 
仲違い 		раздор разлад отчуждение 
仲夏 		середина лета 
仲間 		товарищ группа круг друзей 
仲直り 		примирение 
忠誠 		верность лояльность 
抽象 		абстракция 
抽選 		жеребьёвка лотерея 
昼 		день дневное время 
柱 		столб колонна 
注意 		внимание 
注解 		комментарий аннотация 
注射 		укол инъекция 
注文 		заказ 
虫 		насекомое 
著作 		литературная работа 
貯水池 		водохранилище 
丁度 		как раз ровно точно 
丁寧 		(1) вежливый учтивый (2) аккуратный старательный 
丁年 		совершеннолетие 
兆 		1,000,000,000,000 триллион 
帳面 		тетрадь 
張る 		(1) наклеивать (2) натягивать (3) ставить (палатку) 
彫刻 		скульптура 
彫刻家 		скульптор 
彫像 		статуя 
朝 		утро 
朝食 		завтрак 
朝鮮 		Корея 
朝早く 		рано утром 
朝日 		восходящее солнце 
潮干 		отлив 
蝶 		бабочка 
超特急 		суперэкспресс (поезд) 
跳び上がる 		(1) взлетать (2) вскакивать подпрыгивать 
跳躍 		скачок 
長い 		долгий длинный 
長月 		девятый месяц лунного календаря 
長男 		старший сын 
頂上 		вершина 
鳥肉 		куриное мясо 
直ぐ 		сразу немедленно сейчас же скоро 
直ぐに 		сразу же тут же немедленно 
直下 		прямо вниз точно под 
直角 		прямой угол (90 градусов) 
直感 		интуиция 
直交 		ортогональный 
直線 		прямая линия 
直面 		стоять перед лицом (чего-л.) 
直訳 		дословный перевод 
直流 		постоянный ток 
沈む 		тонуть погружаться 
沈める 		топить погружать окунать 
沈着 		спокойствие самообладание 
沈没 		погружение 
沈黙 		молчание 
珍しい 		редкий необычный 
賃金 		зарплата 
賃上げ 		повышение заработной платы 
陳列 		показ выставление (на выставке, в витрине и т. п.) 
津波 		цунами 
痛い 		больно болит 
痛み入る 		(1) быть тронутым быть глубоко признательным (2) быть смущённым чувствовать стыд 
痛む 		быть повреждённым быть испорченным болеть чувствовать боль 
痛める 		повреждать портить причинять боль ранить болеть 
痛め付ける 		делать выговор отчитывать 
痛手 		тяжёлая рана большие потери 
痛切 		остро резко безжалостно 
通じて 		через посредством 
通り 		дорога улица 
通る 		проходить проезжать 
通関 		таможенная очистка таможенный досмотр 
通告 		извещение 
通訳 		(1) перевод (устный) (2) переводчик 
通話 		телефонный звонок 
漬物 		соленье маринад 
椿 		камелия 
爪 		ноготь коготь 
つま先 		палец ноги 
爪先で歩く 		ходить на цыпочках 
吊るす 		вешать подвешивать 
吊り上げる 		вешать подвешивать поднимать подтягивать 
吊る 		вешать подвешивать 
釣る 		удить ловить рыбу 
鶴 		журавль 
低い 		низкий 
低能 		слабоумие 
停会 		перерыв (заседания, собрания, сессии и т. п.) 
停学 		временный запрет на посещение учебного заведения 
停止 		остановка 
停職 		временное отстранение от должности 
停電 		прекращение подачи электричества 
停頓 		застой 
停留所 		остановка (трамвая, автобуса) 
偵察機 		самолёт-разведчик 
剃刀 		бритва 
呈上 		преподношение 
定まる 		быть установленным быть определённым 
定める 		устанавливать определять 
定価 		установленная цена 
定期 		установленный период определённый период регулярный 
定常 		стационарный 
定数 		константа 
帝国 		империя 
帝国主義 		империализм 
帝国主義的 		империалистический 
底 		дно 
庭 		сад двор 
庭園 		парк сад 
庭球 		теннис 
抵抗 		сопротивление 
提げる 		держать в руках нести 
提案 		предложение проект 
提議 		внесение предложения 
提供 		предложение предоставление 
提出 		представление предъявление предложение 
提灯 		бумажный фонарь 
閉まる 		быть сжатым быть закрытым 
締める 		затягивать завязывать 
締結 		заключение (напр. договора) 
締約 		пакт соглашение договор 
釘 		гвоздь 
泥 		грязь 
泥酔 		мертвецки пьяный 
摘み 		закуска 
敵意 		враждебность 
敵対 		враждебность антагонизм 
的 		цель мишень 
的確 		точный аккуратный 
哲学 		философия 
哲人 		философ мудрец 
鉄 		железо 
鉄筋コンクリート 		железобетон 
鉄鉱 		железная руда 
鉄道 		железная дорога 
鉄砲 		ружьё винтовка 
典 		закон правило 
天井 		потолок 
天下 		весь мир поднебесная 
天気 		погода 
天国 		рай небо 
天才 		гений одарённый 
天使 		ангел 
天女 		небесная дева 
天成 		природный прирождённый 
天晴れ 		великолепный восхитительный 
天体力学 		небесная механика 
天地無用 		"не кантовать" 
天文学 		астрономия 
天文台 		обсерватория 
天幕 		тент палатка 
天ぷら 		темпура (рыбно-овощные оладьи) 
展望台 		смотровая площадка 
展覧会 		выставка 
店員 		продавец (в магазине и т. п.) 
転向 		поворот (перен.) перелом 
点 		точка пункт 
点呼 		перекличка 
伝える 		передавать 
伝わる 		передаваться распространяться 
伝声器 		рупор мегафон 
伝統 		традиция 
殿下 		Ваше высочество (обращение к членам семьи императора) 
田 		рисовое поле 
田舎 		сельская местность деревня 
田舎者 		провинциал деревенщина 
電圧 		напряжение тока 
電圧計 		вольтметр 
電位 		(электрический) потенциал 
電位差計 		потенциометр 
電器 		электроприборы электроника (товары) 
電気 		электричество электрический свет 
電気スタンド 		настольная лампа 
電気製品 		электротовары 
電気カミソリ 		электрическая бритва 
電磁気 		электромагнетизм 
電磁石 		электромагнит 
電車 		электричка 
電線 		кабель электропровод 
電池 		электрическая батарея 
電灯 		электрическая лампа 
電熱器 		электронагревательный прибор 
電波 		радиоволна 
電報 		телеграмма 
電話 		телефон 
電話線 		телефонная линия 
電話帳 		телефонная книга телефонный справочник 
電話番号 		номер телефона 
兎 		заяц кролик 
吐き気 		тошнота 
吐き出す 		выплёвывать рвать 
吐く 		(1) выдыхать (2) высказывать лгать (3) рвать тошнить 
吐息 		вздох 
塗る 		красить покрывать (краской и т. п.) накладывать (краску и т. п.) 
徒労 		тщетные усилия напрасный труд 
時鳥 		кукушка 
渡し船 		паром 
渡る 		переправляться 
都会 		город 
都合 		обстоятельства 
都市 		город 
努力 		усилия старания 
度 		раз 
度量衡 		меры и веса 
土 		земля почва 
土砂崩れ 		оползень 
土産 		подарок сувенир 
土手 		берег насыпь набережная 
土壌 		земля почва 
土星 		Сатурн (планета) 
土台 		основание базис 
土地 		земля участок земли 
土曜日 		суббота 
奴隷 		раб 
怒り 		гнев 
怒る 		сердиться раздражаться 
怒気 		гнев 
党 		(политическая) партия 
党員 		член партии 
冬 		зима 
冬空 		зимнее небо 
冬至 		зимнее солнцестояние 
刀 		катана меч клинок 
塔 		башня 
島 		остров 
投影 		проекция 
投票 		голосование 
搭乗券 		посадочный билет 
東 		восток 
東海道 		Токайдо (магистраль) 
東京 		Токио 
東方 		восточное направление восток 
東北 		северо-восток 
東面 		смотрящий на восток восточная сторона восток 
桃 		персик 
桃色 		розовый персиковый цвет 
盗人 		вор 
盗む 		воровать 
盗賊 		вор грабитель 
湯気 		пар 
湯上がり 		после ванны 
灯台 		маяк 
当たり前 		естественно само собой разумеется 
当たる 		попадать совпадать 
当該 		надлежащий соответствующий 
当然 		естественно само собой разумеется 
当面 		стоящий перед неотложный первоочередной 
等価 		эквивалентность 
答え 		(1) ответ (2) решение ответ (к задаче) (3) отклик отзвук 
答える 		(1) отвечать давать ответ (2) благодарить отплачивать 
答申 		отчёт доклад 
糖尿病 		сахарный диабет 
糖分 		содержание сахара 
統一 		единство 
統計 		статистика 
統計的 		статистический 
統制 		управление контроль 
謄写 		копирование репродукция 
豆腐 		тофу (соевый творог) 
豆類 		бобовые 
頭痛 		головная боль 
闘争 		борьба конфликт 
働く 		работать 
動き 		движение 
動く 		двигаться 
動機 		мотив побуждение 
動作 		(1) действие движение (2) поведение 
動詞 		глагол 
動的 		динамический 
動物園 		зоопарк зоосад 
同じ 		одинаковый тот же 
同じく 		точно так же одинаково 
同ずる 		соглашаться 
同位体 		изотоп 
同意 		такое же мнение согласие такой же смысл 
同意語 		синоним 
同一 		идентичность одинаковость 
同化 		ассимиляция 
同感 		согласие то же мнение то же чувство 
同好 		одинаковые вкусы 
同行 		сопровождение 
同士 		единомышленник товарищ 
同志 		единомышленник товарищ 
同時 		то же время одно время одновременно 
同所 		то же место тот же адрес 
同上 		так же как дано выше 
同情 		сочувствие 
同心 		единодушие единство 
同伴 		сопровождение 
同伴者 		попутчик 
同僚 		коллега сослуживец 
導く 		вести за собой 
導体 		электропроводник 
童 		дитя ребёнок 
童話 		сказка рассказ для детей 
道 		дорога 
道徳 		мораль нравы 
銅貨 		медная монета 
銅像 		бронзовая скульптура 
特に 		в особенности 
特になし 		ничего особенного 
特異性 		сингулярность 
特異点 		особая точка 
特急 		экспресс (поезд) 
特急券 		билет на экспресс (поезд) 
特殊 		особый специальный 
特徴 		характерная особенность отличительная черта 
毒液 		яд ядовитая жидкость 
毒殺 		отравление (убийство) 
毒蛇 		ядовитая змея 
独り言 		разговор сам с собой монолог 
独裁 		диктатура 
独身 		неженатый холостяк незамужняя 
独占 		монополия 
独特 		особенность своеобразность 
独立 		независимость 
読む 		читать 
読者 		читатель 
読書 		чтение 
屯 		тонна 
豚カツ 		котлета из свинины 
豚肉 		свинина 
曇る 		быть облачным 
鈍間 		болван тупица 
鈍器 		тупое оружие 
鈍重 		тупой флегматичный 
内科医 		терапевт 
内戦 		гражданская война 
内線 		внутренняя телефонная линия 
縄 		верёвка канат 
南 		юг двигаться на юг 
南極 		южный полюс Антарктика 
南面 		смотрящий на юг южная сторона юг 
軟骨 		хрящ 
難しい 		трудный сложный 
二 		два 
二つ 		два 
二月 		февраль 
二項式 		бином двучлен 
二十世紀 		двадцатый век 
二十日鼠 		мышь 
二重星 		двойная звезда 
二重生活 		двойная жизнь 
二進 		двоичный 
二世 		два поколения второе поколение второй (в именах) 
二度 		два раза 
二等 		второй класс 
二等分線 		биссектриса 
二等辺三角形 		равнобедренный треугольник 
二日 		два дня второе (число месяца) 
二分木 		двоичное дерево 
二枚舌 		двоедушие 
賑やか 		оживлённый людный шумный 
肉 		мясо 
肉腫 		опухоль саркома 
肉汁 		мясной бульон 
肉親 		родственник (по крови) 
肉体 		тело плоть 
虹 		радуга 
虹色 		радужный 
日 		день сутки солнце 
日の出 		восход солнца 
日の入り 		заход солнца 
日刊紙 		ежедневная газета 
日帰り 		путешествие или экскурсия на один день 
日記 		дневник ежедневник журнал учётная книга 
日傘 		зонт от солнца 
日誌 		дневник ежедневник 
日照り 		засуха 
日食 		солнечное затмение 
日米 		Япония и Америка японско-американский 
日暮れ 		(1) заход солнца (2) сумерки вечер 
日暮れに 		к вечеру 
日本海 		Японское море 
日本語 		японский язык 
日本酒 		рисовое сакэ 
日本人 		японец 
日曜日 		воскресенье (день недели) 
日用品 		предметы повседневного обихода 
乳児 		грудной ребёнок 
乳色 		молочный цвет 
乳白 		молочно-белый (цвет) 
乳白色 		молочно-белый цвет 
入る 		входить 
入院 		госпитализация 
入学 		поступление в учебное заведение 
入場 		вход посещение 
入場者 		посетители 
入場門 		вход для посетителей 
入場料 		плата за вход 
入党 		вступление в политическую партию 
如何して 		почему каким образом 
如何しても 		во что бы то ни стало 
如何様師 		мошенник 
如来 		татхагата 
尿 		моча 
尿素 		мочевина 
任せる 		поручать доверять 
任命 		назначение 
妊娠 		беременность 
忍者 		ниндзя 
忍耐 		терпение выносливость 
認める 		(1) видеть замечать (2) признавать одобрять 
認可 		разрешение санкция 
濡らす 		мочить намочить замочить 
葱 		зелёный лук 
猫 		кошка 
猫舌 		идиосинкразия к горячей пище 
熱 		(высокая) температура жар лихорадка 
熱意 		пыл рвение энтузиазм 
熱湯 		кипяток 
年 		возраст годы 
年賀状 		новогодняя открытка 
年金 		пенсия 
年中 		целый год всегда каждый день 
年中行事 		ежегодное событие 
年譜 		летопись 
燃える 		гореть 
燃え立つ 		воспламеняться загораться 
納屋 		амбар сарай 
能力 		способность 
膿 		гной 
膿む 		гноиться 
農家 		крестьянский двор (хозяйство) 
農産物 		сельскохозяйственная продукция 
農地 		сельскохозяйственная земля 
農民 		крестьянин крестьянство 
農薬 		сельскохозяйственные химикаты 
把握 		схватывать захватывать овладевать 
波 		волна 
波動 		волна 
派 		группа фракция школа направление 
破れ目 		дыра прореха 
破壊 		разрушение 
馬 		лошадь конь 
馬力 		лошадиная сила 
俳句 		хайку (японский стих размером 5-7-5 слогов) 
廃棄物 		отходы мусор 
廃止 		отмена аннулирование упразднение 
拝む 		поклоняться 
拝見 		смотреть видеть 
排水溝 		водосток 
排尿 		мочеиспускание 
背景 		фон 
背中 		спина 
背負う 		нести на спине нести на плече 
肺炎 		пневмония воспаление лёгких 
配達 		доставка 
倍数 		кратное 
梅 		слива 
煤 		сажа 
買う 		покупать 
売る 		продавать 
売れる 		продаваться пользоваться спросом 
売国 		измена родине 
売店 		магазинчик киоск 
売買 		торговля купля-продажа 
伯爵 		граф 
博物館 		музей 
博覧会 		выставка 
泊まる 		останавливаться (на ночлег где-л. в пути, и. т. п.) 
泊める 		пускать на ночлег принимать 
白い 		белый 
白む 		светлеть 
白菜 		китайская капуста 
白鳥 		лебедь 
白墨 		мел 
薄い 		тонкий (о плоских предметах) 
薄暗い 		темноватый слабый тусклый 
迫る 		надвигаться 
爆撃機 		бомбардировщик 
爆笑 		взрыв смеха 
爆弾 		бомба 
爆発 		взрыв 
爆裂 		подрыв взрыв 
麦 		хлеб (зерно) 
箸 		палочки для еды 
畑 		поле (суходольное) 
八月 		август 
八日 		восемь дней восьмое (число месяца) 
八方 		все стороны 
発する 		испускать издавать проистекать 
発音 		произношение 
発火 		воспламенение зажигание 
発狂 		сумасшествие 
発酵 		брожение 
発車 		отправление (поезда, автобуса и т. п.) 
発信音 		телефонные гудки 
発生 		зарождение возникновение 
発生学 		генетика эмбриология 
発達 		развитие 
発展 		развитие рост 
発表 		публикация опубликование 
髪 		волосы 
抜かす 		пропускать (что-л.) 
抜く 		выдёргивать отключать 
鳩 		голубь 
伴う 		сопровождать 
伴奏 		аккомпанемент 
判子 		личная печать 
半円 		полуокружность 
半直線 		полупрямая 
半導体 		полупроводник 
半分 		половина 
半分 		полминуты 
半面 		(1) одна сторона половина (2) профиль 
反意語 		антоним 
反感 		антипатия внутренний протест 
反共 		антикоммунист 
反響 		отзвук отклик резонанс 
反射 		отражение 
反対 		оппозиция сопротивление возражение 
反吐 		рвота 
反動 		реакция 
帆立 		гребешок (двустворчатый моллюск) 
汎関数 		функционал 
版権 		авторское право 
犯罪 		преступление 
販売 		продажа 
範囲 		сфера область 
範例 		пример образец 
飯盒 		(походный) котелок 
晩 		вечер 
晩飯 		ужин 
晩方 		к вечеру 
番犬 		сторожевая собака 
番号 		номер последовательность цифр 
番人 		сторож охранник 
卑見 		моё скромное мнение 
否む 		отрицать отказываться отклонять 
否応 		да или нет 
否応なしに 		волей-неволей без учёта желания 
否決 		отклонять 
否定 		отрицание 
彼 		он 
彼ら 		они (преимущественно о мужчинах) 
彼岸会 		служба в праздник хиган 
彼女 		она 
彼方 		там (место удалённое от всех участников беседы) 
悲壮 		патетический трагический 
比べる 		сравнивать 
疲れる 		уставать 
疲弊 		истощение обеднение 
皮膚 		кожа кожный покров 
秘め事 		секрет 
秘書 		секретарь 
肥料 		удобрение 
被る 		надевать на голову (головной убор) 
非 		ошибочный не- 
非課税 		не облагаемый налогом 
非行 		плохой поступок дурное поведение 
非人 		пария 
非線形 		нелинейный 
非対称 		несимметричность асимметрия 
非同期 		асинхронность 
非売品 		не для продажи не продаётся 
非凡 		незаурядность 
非礼 		невежливость 
非論理的 		нелогичный нерациональный 
飛行機 		самолёт 
飛行士 		пилот лётчик 
飛行場 		аэродром аэропорт 
飛行船 		воздушное судно дирижабль 
飛躍 		скачок 
微分 		дифференциальный 
微分方程式 		дифференциальное уравнение 
眉 		бровь 
眉毛 		бровь 
美しい 		красивый прекрасный 
美術館 		музей искусств 
美術品 		произведение искусства 
美人 		красавица 
美的 		эстетический 
美味しい 		вкусный 
美容院 		салон красоты 
鼻 		нос 
髭剃り 		бритьё 
膝 		колено 
肘 		локоть 
必ず 		обязательно непременно 
必要 		необходимость 
逼迫 		острая нужда (в средствах) 
百 		сто 
百貨店 		универмаг 
百合 		лилия 
百万 		1,000,000 миллион 
氷 		лёд 
氷河 		ледник 
氷結 		замерзание 
氷山 		айсберг 
票 		бюллетень голос 
表 		таблица 
表現 		залог (глагола) 
表面 		лицевая сторона внешняя сторона поверхность 
評価 		оценка 
評議会 		совет 
評論家 		критик обозреватель 
描写 		отображение изображение 
病院 		больница 
病気 		болезнь 
品質 		качество 
品質管理 		контроль качества 
品質保持期限 		срок годности 
品物 		товар вещь 
浜辺 		пляж 
貧乏 		бедность 
敏感 		восприимчивость впечатлительность чувствительность 
瓶 		бутылка 
不意 		неожиданность 
不可能 		невозможность 
不規則 		неправильность 
不興 		дурное настроение неудовольствие 
不均衡 		дисбаланс 
不死鳥 		феникс 
不動 		неподвижность 
不平等 		неравноправие 
不便 		неудобство 
不満 		недовольство 
付く 		прикрепляться прилипать 
付け睫毛 		искусственные ресницы 
付近 		окрестности 
夫 		муж 
婦人科 		гинекология 
婦人科医 		гинеколог 
婦人科学 		гинекология 
富 		богатство 
富士山 		гора Фуджи Фуджисан 
布 		ткань 
敷居 		порог 
普通 		обычно 
浮き 		поплавок 
浮き上がる 		(1) всплывать (2) быть поднятым (о затонувшем судне) 
浮かぶ 		всплывать плавать на поверхности приходить на ум 
父 		отец 
父上 		отец 
父親 		отец 
父母 		мать и отец родители 
負ける 		проигрывать терпеть поражение 
負傷者 		раненый 
武器 		оружие вооружение 
武士道 		бусидо бушидо ("путь воина" - кодекс чести самурая) 
舞い上がる 		взвиться взвиваться 
舞台 		сцена (театра и т. п.) 
葡萄 		виноград 
部屋 		комната 
部下 		подчинённый 
部隊 		отряд подразделение 
部長 		начальник отдела 
部分 		часть 
部門 		отрасль 
封鎖 		блокада 
封筒 		почтовый конверт 
風 		ветер 
風下 		подветренная сторона 
風邪をひく 		простудиться 
風水 		фэн-шуй 
風体 		вид внешность 
風靡 		подавлять властвовать доминировать 
蕗 		подбел японский 
復興 		возрождение восстановление реконструкция 
復習 		повторение (пройденного материала и т. п.) 
復讐 		месть 
幅跳び 		прыжки в длину 
腹 		живот брюшная полость 
腹違い 		сводный (рождённый от другой матери) 
複雑化 		усложнение 
複素数 		комплексное число 
払う 		(1) платить (2) мести чистить 
沸かす 		кипятить 
沸騰 		кипение бурление 
仏壇 		(домашний) буддийский алтарь 
仏道 		буддизм 
物 		вещь предмет 
物語 		история легенда 
物理学 		физика 
分 		(1) один процент (2) бу (мера длины = 3,03мм) 
分 		порция доля 
分ける 		делить 
分科 		отрасль 
分岐 		дивергенция 
分子 		(1) числитель (2) молекула 
分数 		дробь 
分析 		анализ 
分布 		распределение распространение 
分母 		знаменатель 
分野 		сфера область 
噴射 		реактивный 
噴水 		водный фонтан 
雰囲気 		атмосфера дух 
文 		предложение (в тексте) 
文化 		культура 
文学 		литература филология 
文月 		седьмой месяц лунного календаря 
文字 		символ буква 
文体 		литературный стиль 
文部大臣 		министр просвещения 
文法 		грамматика 
文明 		цивилизация 
聞き手 		слушатель аудитория 
然し 		однако но 
兵威 		военная мощь 
兵営 		казармы 
兵火 		пожар возникший в результате военных действий 
兵器 		оружие вооружение 
兵庫県 		(японская) префектура Хёго 
兵語 		военный термин 
兵士 		солдат 
兵隊 		боец солдат 
兵端 		начало войны 
塀 		ограда забор 
平仮名 		хирагана 
平衡 		равновесие баланс 
平時 		мирное время 
平等 		равенство 
平方メートル 		квадратный метр 
平凡 		простой обычный заурядный 
平面 		плоскость 
平野 		равнина 
平和 		мир спокойствие гармония 
平和主義 		пацифизм 
平和主義者 		пацифист 
平和論者 		пацифист 
弊社 		наша фирма наша компания 
並ぶ 		стоять в ряд 
並べる 		раскладывать расставлять (в ряд) 
閉める 		закрывать 
閉館 		закрытие (ежедневное, по расписанию и т. п.) 
陛下 		Ваше величество (обращение к императору) 
米 		рис 
米国 		Америка 
米国人 		американец 
壁 		стена 
壁画 		настенная живопись фреска 
壁紙 		обои 
別 		различие разница 
別荘 		дача 
蔑む 		презирать пренебрегать 
偏愛 		пристрастность 
偏狭 		ограниченный недалёкий 
偏見 		предубеждение предвзятое мнение 
偏光 		поляризованный свет поляризация света 
偏向 		уклон склонность тенденция 
偏差 		(1) отклонение деклинация (2) (мор.) дрейф 
偏頗 		односторонний пристрастный 
変 		перемена странный необычный 
変える 		менять заменять (что-л.) изменять (что-л.) 
変わる 		изменяться меняться отличаться 
変圧器 		трансформатор 
変化 		перемена изменение 
変換 		преобразование 
変身 		трансформация 
変数 		переменная 
変節 		отступничество 
片仮名 		катакана 
片側 		одна сторона 
片付ける 		приводить в порядок 
編む 		вязать 
編曲 		аранжировка 
返す 		возвращать 
返金 		возврат денег 
返品 		возвращённый товар 
便器 		унитаз 
便利 		удобный 
勉強 		занятия учёба 
弁護士 		адвокат 
弁舌 		речь красноречие 
保険 		страхование гарантия 
保護 		защита покровительство 
保護者 		защитник покровитель 
捕虜 		пленный 
歩き回る 		обходить 
歩く 		идти пешком ходить 
歩道 		тротуар 
歩道橋 		пешеходный мост тротуарный мост 
歩兵 		пехота пехотинец 
補間 		интерполяция 
補助 		помощь поддержка вспомогательный 
墓 		могила 
墓穴 		могильная яма 
暮らし 		жизнь существование 
暮らす 		жить существовать 
暮れ 		(1) сумерки (2) конец года конец сезона 
暮れる 		кончаться 
暮春 		поздняя весна 
暮色 		сумерки сумеречный пейзаж 
母 		мать 
母音 		гласный звук 
母上 		мать 
簿記 		бухгалтерия счетоводство 
菩薩 		бодхисаттва 
包み 		свёрток 
宝石 		драгоценный камень 
崩壊 		распад 
放火 		поджог 
放射 		излучение 
放射性 		радиоактивный 
放射性廃棄物 		радиоактивные отходы 
放射線 		радиация 
放射線科医 		радиолог рентгенолог 
放射線学 		радиология рентгенология 
放射線感受性 		чувствительность к облучению 
放射能 		радиоактивность 
放送 		передача вещание 
放送局 		широковещательная станция 
放尿 		мочеиспускание 
方 		человек некто 
方 		сторона 
方言 		диалект 
方式 		форма формула метод система 
方程式 		уравнение 
方法 		метод способ 
法 		(1) закон правило (2) способ метод (3) учение 
法学 		юриспруденция 
法師 		буддистский монах 
法律 		закон 
泡 		пена 
砲弾 		снаряд 
砲兵 		артиллерист артиллерия (часть) 
縫う 		шить 
蜂蜜 		мёд 
豊富 		обильность 
亡霊 		мертвец призрак 
帽子 		шапка шляпа 
忘れっぽい 		забывчивый 
忘れる 		забывать 
忘却 		забывчивость 
忙しい 		занятый 
望ましい 		желательный 
望み 		желание надежда 
望む 		желать хотеть 
望遠鏡 		телескоп 
防ぐ 		оборонять обороняться предотвращать 
防音 		звукозащитный 
防毒面 		противогаз 
ほお紅 		румяна 
北 		север 
北緯 		северная широта 
北海道 		остров Хоккайдо (северный из четырёх основных островов Японии) 
北京 		Пекин 
北極 		северный полюс 
北極圏 		Северный полярный круг 
北極光 		северное сияние 
北西 		северо-запад 
北朝鮮 		Северная Корея 
北斗七星 		Большая Медведица 
北面 		смотрящий на север северная сторона север 
僕 		я 
僕ら 		мы 
僕達 		мы 
撲滅 		уничтожение искоренение 
牧師 		пастор 
牧畜 		скотоводство 
睦月 		первый месяц лунного календаря 
殆ど 		почти 
本 		книга 
本屋 		книжный магазин 
本棚 		книжная полка книжный шкаф 
本当 		правда в самом деле 
本日 		сегодня 
本年 		этот год текущий год 
本名 		настоящее имя 
翻訳 		перевод (письменный) расшифровка 
翻訳家 		переводчик (письменного материала) 
摩天楼 		небоскрёб 
磨く 		чистить 
魔女 		ведьма 
魔法 		магия колдовство 
魔法瓶 		термос 
埋める 		закрывать (лицо руками) зарываться (лицом в подушку) 
埋め立てる 		засыпать (что-л.) поднимать (грунт) 
埋葬 		погребение 
妹 		младшая сестра 
毎朝 		каждое утро 
毎日 		каждый день 
毎晩 		каждый вечер 
枕 		подушка 
鮪 		тунец 
又 		опять снова ещё 
又は 		или или же 
末 		конец 
繭 		кокон 
繭をかける 		плести кокон 
万年筆 		авторучка 
万有引力 		всемирное тяготение 
万葉仮名 		манъёгана (древняя форма японского слогового алфавита основанная на китайских иероглифах) 
満員 		полный (о помещении) 
満月 		полная луна 
満足 		удовлетворение 
満潮 		прилив 
漫画 		манга комикс свободные зарисовки 
漫然 		бесцельно необдуманно 
漫談 		лёгкая беседа пустая болтовня 
味噌汁 		мисо суп 
味方 		сторонник союзник "свой" "наш" 
未だ 		ещё не 
未知数 		искомое число неизвестное 
未亡人 		вдова 
未来 		будущее 
蜜柑 		мандарин (цитрусовый плод) 
蜜柑畑 		мандариновая плантация 
脈 		пульс 
民営 		частное предприятие 
民間人 		гражданский 
民主主義 		демократия 
眠る 		спать 
夢 		сон мечта 
夢を見る 		видеть сон 
無意味 		бессмысленный 
無限 		бесконечность 
無限ループ 		бесконечный цикл 
無限小 		бесконечно малая величина 
無限大 		бесконечно великая величина 
無条件 		безусловный 
無神論者 		атеист 
無人島 		необитаемый остров 
無責任 		безответственность 
無駄 		напрасно зря бесполезно 
無欲 		бескорыстие 
無料 		бесплатный 
矛盾 		непоследовательность 
娘 		дочь 
冥王星 		Плутон (планета) 
名高い 		знаменитый 
名詞 		существительное 
名所 		знаменитые места достопримечательности 
名称 		название наименование имя 
名声 		слава известность 
名前 		имя 
名付ける 		называть давать имя 
名簿 		поимённый список 
名誉 		слава честь почёт доброе имя 
名誉心 		честолюбие 
命令 		приказ команда 
明らか 		ясный отчётливый очевидный 
明るい 		светлый 
迷う 		запутаться потерять дорогу 
迷宮 		лабиринт 
鳴る 		звучать раздаваться 
姪 		племянница 
免疫 		иммунитет 
免許状 		свидетельство разрешение лицензия 
免状 		диплом свидетельство 
免税品 		беспошлинные товары 
面する 		быть обращённым (в какую-л. сторону, к чему-л.) выходить (на, в) 
面子 		честь престиж 
面積 		площадь поверхность 
面前 		перед лицом на глазах в присутствии 
面相 		черты лица 
面倒 		беспокойство затруднения заботы 
面白い 		интересный 
面目 		лицо честь престиж 
模型 		копия (скульптуры) макет 
模写 		копия (картины) репродукция 
模範 		образец пример 
毛皮 		мех 
毛布 		шерстяное одеяло 
盲腸炎 		аппендицит 
蒙古 		Монголия 
木 		дерево 
木剣 		деревянный меч боккэн 
木星 		Юпитер (планета) 
木曜 		четверг 
木曜日 		четверг 
木苺 		малина 
目が回る 		чувствовать головокружение 
目を覚ます 		проснуться открыть глаза 
目印 		ориентир 
目下 		в данный момент 
目覚まし 		будильник 
目覚める 		проснуться 
目玉焼き 		яичница-глазунья 
目撃者 		свидетель 
目次 		оглавление 
目的 		цель назначение 
目的地 		пункт назначения 
目方 		вес 
目録 		каталог 
勿論 		конечно разумеется 
餅 		мочи (рисовая лепёшка) 
問い 		вопрос запрос 
問題 		вопрос проблема задача 
悶える 		мучиться терзаться 
悶死 		мучительная смерть 
紋章 		герб 
夜 		ночь 
夜間 		вечерний ночной 
夜勤 		ночная смена 
夜空 		ночное небо 
夜明け 		рассвет 
夜明けの明星 		утренняя звезда 
野球 		бейсбол 
野球部 		бейсбольная команда 
野菜 		овощ 
野蛮人 		дикарь 
弥生 		третий месяц лунного календаря 
矢 		стрела 
役に立つ 		годиться пойти на пользу 
役割 		роль 
役者 		актёр актриса 
約束 		обещание уговор договорённость 
薬 		лекарство 
薬局 		аптека 
薬味 		специи приправа 
訳 		причина основание обстоятельства смысл 
訳す 		переводить (с одного языка на другой) 
訳者 		переводчик 
訳注 		примечание к переводу 
踊る 		танцевать 
柳 		ива 
愉快 		приятный весёлый 
油 		масло 
油絵 		картина маслом 
油断 		неосмотрительность небрежность 
諭旨 		инструкция напутствие 
輸出 		экспорт 
輸入 		импорт 
ただ今 		(1) "я дома!" "я пришёл!" (2) сейчас только что 
唯物論 		материализм 
優れた 		выдающийся превосходный 
優越 		превосходство преимущество 
勇気 		мужество смелость 
勇士 		герой храбрец 
友 		друг приятель 
友好 		дружба 
友情 		дружба 
友人 		друг 
友達 		друг 
幽霊船 		корабль-призрак 
憂い 		печальный 
憂い 		печаль тоска 
有難うございます 		спасибо благодарю 
有限 		конечный ограниченный 
有名 		известность знаменитость 
有料 		платный 
由緒 		происхождение родословная 
誘電体 		диэлектрик 
誘惑 		искушение соблазн 
郵便局 		потовое отделение 
郵便番号 		почтовый индекс 
郵便物 		почта почтовое отправление 
夕べ 		вечер предыдущая ночь 
夕食 		ужин 
夕日 		вечернее солнце заходящее солнце 
夕暮れ 		сумерки вечер 
夕方 		вечер под вечер 
予感 		предчувствие 
予習 		приготовление уроков подготовка к урокам 
予定 		предположение наметка 
予報 		предсказание прогноз 
予約 		предварительный заказ 
余興 		развлечение увеселение 
誉れ 		честь слава 
預かる 		принимать на хранение принимать на попечительство 
預ける 		сдавать на хранение оставлять на попечительство доверять (что-л.) 
幼稚園 		детский сад 
妖精 		фея 
揺れる 		трястись качаться 
曜日 		день недели 
様式 		форма стиль (арх.) ордер (2) образ (жизни) 
洋式 		европейский стиль 
洋食 		европейское блюдо 
洋風 		западный стиль 
洋服 		одежда (европейская) 
洋服ダンス 		гардероб (для европейской одежды) 
溶ける 		таять плавиться 
溶接 		сварка 
用意 		подготовка 
用紙 		бланк форма 
用事 		дело 
用心 		осторожность 
羊 		овца баран 
羊毛 		шерсть 
葉 		лист 
葉書 		открытка 
要求 		требование 
要旨 		существо суть 
養鶏 		птицеводство 
養子 		приёмный ребёнок приёмыш 
養父 		приёмный отец 
養母 		приёмная мать 
抑揚 		интонация модуляция 
浴室 		ванная 
浴槽 		ванна 
翌日 		следующий день 
翼 		крыло 
裸体 		голое тело нагота 
来る 		приходить 
来月 		следующий месяц 
来週 		будущая неделя 
来年 		будущий год 
頼む 		(1) просить (2) поручать доверять (3) полагаться (на кого-л.) 
雷電 		гром и молния 
落ちる 		падать понижаться 
落下傘 		парашют 
乱数 		случайное число 
嵐 		буря 
欄 		столбец 
藍 		глаз индиго 
藍色 		цвет индиго 
利益 		прибыль выгода интересы 
利己 		себялюбие эгоизм 
利用 		использование применение 
履歴 		биография 
理解 		понимание 
理想 		идеал 
理由 		причина 
理論 		теория 
裏作 		второй урожай (в году) 
裏切り 		предательство 
裏切る 		предавать 
裏切り者 		предатель 
離婚 		развод 
陸 		суша 
陸軍 		армия сухопутные войска 
陸上競技 		соревнования по лёгкой атлетике 
立ち上がる 		вставать подниматься 
立場 		позиция положение ситуация 
立派 		прекрасный превосходный великолепный 
立方体 		куб 
立法 		законодательство законотворчество 
略語 		аббревиатура акроним 
略式 		неформальный неофициальный непарадный (о костюме) 
略称 		сокращённое название 
流れ 		течение 
流れ星 		падающая звезда 
流血 		кровопролитие 
流星 		метеор падающая звезда 
流星雨 		звёздный дождь метеорный дождь 
流体 		жидкое тело 
留守 		отсутствовать не быть дома 
留守番電話 		телефонный автоответчик 
隆盛 		процветание 
侶伴 		спутник товарищ 
旅 		путешествие поездка 
旅館 		гостиница японского типа 
旅客 		пассажир 
旅客機 		пассажирский самолёт 
旅行 		путешествие 
両舷 		оба борта судна 
両替 		обмен денег 
両替屋 		пункт обмена денег 
両替機 		машина для обмена денег 
両替商 		обмен денег (род бизнеса) 
両替人 		рабочий обменного пункта 
両刀 		два меча 
料金 		плата цена за услугу 
料理 		стол кухня блюдо 
涼しい 		прохладный 
量子化 		квантизация 
領事館 		консульство 
領収書 		чек 
領収証 		чек 
力 		сила мощь энергия способность 
力 		сила мощь 
力学 		динамика механика 
緑色 		зелёный цвет 
林檎 		яблоко 
隣 		соседний 
涙 		слеза 
類 		сорт вид род 
類義語 		синоним 
類語 		синоним 
令夫人 		Ваша супруга 
例えば 		например 
冷たい 		холодный прохладный (о предметах, жидкостях) 
冷静 		хладнокровие спокойствие 
冷戦 		холодная война 
礼拝 		богослужение 
鈴 		колокольчик 
零 		ноль 
零下 		ниже нуля 
霊感 		вдохновение 
麗しい 		(1) красивый изящный прекрасный (2) милый сердцу 
麗人 		красавица 
暦数 		судьба срок жизни 
歴史 		история 
歴史上 		исторически 
歴代 		поколения 
列 		ряд 
列車 		поезд состав 
烈風 		резкий ветер ураган 
裂傷 		рваная рана 
廉売 		(дешёвая) распродажа 
恋 		любовь 
恋う 		любить 
恋しい 		любимый дорогой 
恋愛 		любовь 
恋愛結婚 		брак по любви 
恋人 		возлюбленный возлюбленная 
煉瓦 		кирпич 
練習 		упражнение тренировка 
蓮根 		корень лотоса 
連れる 		брать с собой (кого-л.) 
連れ戻す 		возвращать приводить назад 
連続 		последовательность непрерывность продолжение чередование 
連帯 		солидарность 
連邦 		федерация 
連盟 		лига федерация объединение союз 
錬金術 		алхимия 
路線 		линия курс 
露 		роса 
露語 		русский язык 
労作 		большой труд (о произведении) 
労働者 		рабочий 
労働組合 		профсоюз 
廊下 		коридор 
浪人 		ронин самурай без хозяина безработный ожидающий нового приёма в учебное заведение 
浪人生 		не поступивший абитуриент 
老人 		старый человек 
六月 		июнь 
六日 		шесть дней шестое (число месяца) 
録音 		звукозапись 
論じる 		рассуждать трактовать 
論ずる 		рассуждать трактовать 
論拠 		обоснование 
論理 		логика 
論理的 		логичный 
和英 		японско-английский 
和英辞典 		японско-английский словарь 
和歌 		вака (японский стих размером 5-7-5-7-7 слогов) 
和歌山県 		Вакаяма (префектура) 
和語 		ваго (исконно японская лексика) японские слова 
和尚 		буддийский священник 
和食 		японское блюдо 
和独 		японско-немецкий 
話す 		говорить рассказывать 
脇差 		вакидзаси (kj) вакизаши (короткий японский меч) 
詫び 		извинение 
詫状 		письменное извинение 
湾 		залив 
腕 		рука 
腕輪 		браслет 
倨傲 		высокомерие 
凭れる 		прислоняться облокачиваться опираться 
呟く 		ворчать бормотать 
呻き 		стон 
呻く 		стонать 
唸り 		рык 
喘ぐ 		задыхаться запыхаться 
嗚呼 		А! 
嗅ぐ 		нюхать 
埃 		пыль 
宦官 		евнух 
屏風 		ширма 
箒 		метла 
彗星 		комета 
慄然 		ужас трепет 
戌 		Собака (11-й знак китайского зодиака, направление на 30 градусов к северу с запада, время с 7-ми до 9-и часов вечера) 
掣肘 		сдерживание остановка ограничение 
干ばつ 		засуха 
暈す 		(1) смазывать контуры (в рисунке) (2) затемнять (смысл, суть и т. п.) 
曰く 		говорить 
梵語 		санскрит 
滲む 		расплываться (по чему-л.) пропитывать покрываться (пятнами) 
焜炉 		переносная печка плитка 
癲癇 		эпилепсия эпилептический припадок 
目眩 		головокружение 
睫毛 		ресницы 
罠 		ловушка 
耄碌 		старческое слабоумие 
臍 		пупок 
舅姑 		тесть и тёща свёкор и свекровь 
苺 		клубника 
茹でる 		отварить 
薔薇 		роза 
蚋 		мошка 
蠍 		скорпион 
衒う 		щеголять (чем-л.) выставлять напоказ корчить из себя 
衒学 		(1) педантизм (в науке) (2) показная учёность 
衒気 		тщеславие хвастовство аффектация 
詭計 		хитрость интрига махинация 
詭弁 		казуистика софистика 
詭謀 		уловка хитрость обман 
誂える 		заказывать размещать заказ 
諳んじる 		запоминать наизусть 
蹲る 		садиться на корточки 
鞦韆 		качели 
餃子 		гёза (японское блюдо напоминающее пельмени) 
饂飩 		удон (японская лапша) 
騾馬 		мул 
鰊 		сельдь 
鱚 		поцелуй 
鶺鴒 		трясогузка 
麒麟 		жираф 
靡かす 		соблазнять обольщать склонять на свою сторону подчинять 
靡く 		(1) развеваться колыхаться (2) гнуться сгибаться (3) поддаваться подчиняться 
愛想 		сердечность радушие приветливость 
愛着 		любовь привязанность 
一言 		одно слово 
一昨日 		позавчера 
一昨年 		позапрошлый год 
一時 		один час 
一人 		один человек 
一生 		вся жизнь 
一日 		один день целый день первое (число месяца) 
右側 		правая сторона 
雨水 		дождевая вода 
卯月 		четвёртый месяц лунного календаря 
遠道 		дальняя дорога 
塩 		соль 
黄色 		жёлтый цвет 
俺 		я 
俺ら 		мы 
音 		звук нота 
下々 		низы 
下半期 		вторая половина года 
下葉 		нижние листья 
何 		что 
何故 		почему почему зачем 
どれ程 		сколько 
可愛い 		прелестный очаровательный милый 
暇 		(1) время свободное время (2) отпуск (3) увольнение свободное время 
火傷 		ожёг 
蛙 		лягушка 
偽君子 		лицемер 
偽物 		подделка подделка фальшивка 
久遠 		вечность 
魚 		рыба 
興 		интерес удовольствие 
九 		девять 
五角形 		пятиугольник 
口舌 		слова 
工場 		фабрика завод 
紅 		алый 
行く 		идти ехать 
頃 		время период 
今朝 		сегодня утром 
今日 		сегодня 
今年 		этот год 
魂 		душа 
左側 		левая сторона 
最上 		высший лучший 
最中 		в середине в разгар во время (чего-л.) 
昨日 		вчера 
三 		три 
三角形 		треугольник 
四 		четыре 
姉妹 		сёстры 
師走 		двенадцатый месяц лунного календаря 
耳たぶ 		мочка уха 
七日 		семь дней седьмое (число месяца) 
寂しい 		одинокий 
十 		десять 
縦横 		вдоль и поперёк всесторонне по всем направлениям 
出国 		выезд из страны 
初産 		первые роды 
女形 		оннагата (мужчина-актёр, исполняющий женские роли в кабуки) 
小便 		моча 
少女 		девочка девушка 
消耗 		расход потребление растрата 
上院 		верхняя палата (парламента) сенат 
上顎 		верхняя челюсть 
上座 		почётное место высшее место 
上手 		(1) верхняя часть (2) верхнее течение (3) наветренная сторона (4) лучший высший 
上方 		верх верхняя часть вверху 
乗客 		пассажир 
信 		доверие уверенность 
寝台 		кровать 
真っ直ぐ 		точно вперёд прямо 
真っ白 		белоснежный совсем белый 
人 		человек 
人々 		люди 
数 		число 
石綿 		асбест 
全国 		вся страна 
側 		сторона 
昼間 		дневное время днём 
丁 		хиното (4-ый циклический знак) 
朝飯 		завтрак 
停車場 		станция остановка стоянка 
弟 		младший брат 
弟子 		ученик последователь 
敵 		враг 
店 		магазин 
伝言 		сообщение на словах 
途中 		по пути 
島国 		островная страна 
頭 		голова (1) голова (2) глава вожак 
銅 		медь 
読本 		хрестоматия 
鈍い 		(1) тупой притупившийся (2) тупой несообразительный (1) медленный медлительный неповоротливый (2) глупый тупой вялый 
鈍る 		притупляться 
南瓜 		тыква 
日本 		Япония 
入口 		вход 
年々 		из года в год с каждым годом 
此の 		этот (рядом с говорящим) 
派出所 		районное отделение полиции 
梅雨 		дождь (в период дождей в Японии) сливовые дожди 
八 		восемь 
八つ 		восемь 
否 		нет 
描く 		рисовать описывать обрисовывать 
夫婦 		супруги муж и жена 
風邪 		простуда 
分泌 		выделение секреция 
別人 		другой человек кто-то другой 
偏頭痛 		мигрень 
墓石 		могильный камень 
墓地 		кладбище 
包む 		завёртывать 
北東 		северо-восток 
北風 		северный ветер 
牧場 		пастбище 
毎年 		каждый год ежегодно 
末流 		потомки 
末裔 		потомки 
万 		10,000 десять тысяч 
明後日 		послезавтра 
明日 		завтра 
面 		(1) лицо (2) поверхность лицо 
面 		физиономия 
面 		(1) лицо (2) маска (3) лицевая сторона поверхность сторона 
妄説 		ошибка заблуждение 
門 		ворота 
夕飯 		ужин 
余り 		не слишком не особенно 
浴衣 		юката (летнее кимоно) 
螺旋 		спираль 
来客 		посетитель 
雷 		гром молния 
両側 		обе стороны 
六 		шесть 
六つ 		шесть 
箱 		ящик коробка 
蜉蝣 		стрекоза 
蜻蛉 		стрекоза 
襁褓 		пелёнка 
合気道 		(MA) айкидо 
逢引 		свидание 
愛欲 		любовь страсть 
明かり 		свет освещение 
空く 		быть пустым опустеть (напр. о желудке) 
開く 		быть пустым быть свободным (о месте) 
暖かい 		тёплый (о погоде, воздухе) тёплый (о предметах, жидкостях) 
温まる 		греться нагреваться 
温める 		греть подогревать 
宛名 		адрес (на письме и т. п.) 
阿呆 		болван идиот 
雨がさ 		зонт от дождя 
雨上がり 		после дождя 
怪しい 		сомнительный подозрительный удивительный странный 
鮎 		восточная форель 
有り難う 		спасибо благодарю 
或いは 		или либо возможно пожалуй 
鮑 		морское ушко 
暗黒 		тьма мрак темнота 
言い合い 		спор 
言い合う 		спорить пререкаться 
言う 		говорить сказать называться 
生け垣 		живая изгородь 
意向 		намерение настроение 
痛々しい 		(1) печальный прискорбный (2) жалкий 
頂く 		(1) получать (2) есть пить 
痛み 		повреждение порча боль страдание 
位置 		(1) расположение место (2) положение пост 
一ヶ月 		один месяц 
一か所 		одно место то же место 
嫌々 		нежелание неохота отказ 
否々乍ら 		неохотно 
入り江 		залив бухта 
入れ墨 		татуировка 
色々 		различный 
鰯 		сардина 
初々しい 		невинный чистый свежий 
受付 		приём (в чистку, ремонт и т. п.) 
歌う 		петь читать нараспев 
写す 		копировать снимать копию фотографировать 
雲丹 		морской ёж 
売り場 		секция (в торговом зале) прилавок торговая стойка киоск 
閏年 		високосный год 
憂える 		горевать сетовать 
絵はがき 		открытка (с картинкой) 
海老 		креветка 
選ぶ 		выбирать отбирать 
得る 		получать 
大きい 		большой громкий (о голосе) 
丘 		холм 
贈り物 		подарок 
遅れる 		опаздывать 
行う 		проводить совершать 
押し入れ 		стенной шкаф 
雄 		самец 
思い出 		воспоминание 
思う 		думать считать полагать 
降りる 		спускаться сходить выходить (из транспорта) 
下ろす 		(1) опускать спускать (2) снимать сверху сгружать (3) ссаживать дать сойти помочь сойти 
終わり 		конец 
終わる 		кончаться оканчивать 
会館 		дом (культуры, дружбы и т. п.) 
買い手 		покупатель 
買い物 		покупки 
係 		ведающий (чем-л.) служащий 
掛け算 		умножение 
影 		тень силуэт 
陰 		тень 
貸し切り 		заказ заказанный забронированный 
箇所 		место пункт 
仮説 		гипотеза 
下腿 		нижняя часть тела 
片思い 		любовь без взаимности 
肩書 		звание ранг 
可也 		довольно порядочно 
神々 		боги 
枯れ葉 		сухие листья 
関数 		функция 
乾杯 		тост осушим бокалы 
飢渇 		голод и жажда 
聞く 		слушать слышать спрашивать 
聞こえる 		слышаться 
傷跡 		шрам рубец 
奇跡 		чудо 
切符売り場 		билетная касса 
軌範 		норма стандарт 
決まる 		решаться быть решённым быть определённым 
気持ち 		чувство ощущение настроение 
胡瓜 		огурец 
恐竜 		динозавр 
綺麗 		красивый чистый опрятный 
気を付ける 		быть внимательным быть осторожным 
偽装 		маскировка 
食う 		есть 
国 		страна 
国々 		страны 
首 		шея 
悔み 		соболезнование 
蔵 		кладовая склад складское помещение 
位負 		быть недостойным своего положения 
食らう 		(1) есть пить (2) получать претерпевать 
黒金 		железо 
計算機 		компьютер вычислительная машина 
元素 		химический элемент 
子犬 		щенок 
交差点 		перекрёсток 
興敗 		процветание и упадок величие и падение судьба 
凍る 		замерзать покрываться льдом 
小包 		бандероль 
子猫 		котёнок 
込む 		быть переполненным (людьми) 
ご存じ 		знание знакомство (с чем-л.) 
ご馳走 		угощение 
桜 		сакура 
挿絵 		иллюстрация (в книге) 
差出人 		отправитель 
砂漠 		пустыня 
晒す 		подвергать (действию чего-л.) выставлять (на солнце, под дождь и т. п.) 
仕上げ 		завершение окончательная отработка 
幸せ 		счастье 
仕方なく 		поневоле 
死骸 		труп 
敷き布団 		матрац 
刺激 		стимул 
下請け 		субконтракт 
確り 		твёрдо уверенно решительно 
しみ出る 		просачиваться выделяться выступать 
写真器 		фотоаппарат 
首位 		ведущее положение первое место 
出版社 		издательство издатель 
醤油 		соевый соус 
退く 		посторониться отступить 
銀 		серебро 
心 		(1) сердце душа (2) сердцевина внутренняя часть 
伸張 		расширение увеличение 
辞典 		словарь 
絨毯 		ковёр 
上々 		наилучший 
寿司 		суши (рис с сырой рыбой) 
勧める 		рекомендовать советовать 
全て 		все всё целиком полностью 
住まい 		(1) жилище местожительство (2) жизнь проживание местожительство 
成員 		постоянный член 
精々 		самое большое 
先頭 		главенство во главе 
相互 		взаимный 
総合 		синтез обобщение 
掃除機 		пылесос 
仄聞 		слышать со стороны 
夫れ夫れ 		все каждый 
体当たり 		таран 
太平 		спокойствие мир 
蓄える 		копить запасать накоплять 
蛸 		осьминог 
戦い 		борьба сражение битва 
戦う 		бороться сражаться биться 
立ち入り禁止 		Не входить! Посторонним вход воспрещён! 
立つ 		отправляться выезжать стоять вставать (с места) 
煙草 		сигареты табак 
度々 		часто 
偶々 		случайно редко 
炭鉱 		угольная шахта 
段々 		постепенно 
違い棚 		неравномерно расположенные полочки (расположенные не друг над другом, а одна левее, другая правее и т. д.) 
着 		счётный суффикс для европейской одежды 
貯蓄 		накопления сбережения 
直径 		диаметр 
衝立 		экран 
作り言 		(1) выдумка вымысел (2) симуляция 
作る 		(1) изготовлять делать (2) строить воздвигать (3) сочинять слагать (4) выращивать производить (5) учреждать устанавливать (1) изготовлять делать (2) строить воздвигать 
付け合わせ 		гарнир 
慎む 		(1) быть осторожным быть осмотрительным (2) воздерживаться избегать 
摘む 		брать (пальцами) щипать 
吊り下がる 		свешиваться болтаться 
釣り道具 		рыболовные принадлежности 
吊橋 		висячий мост 
手当 		пособие помощь 
手すり 		перила 
手帳 		блокнот записная книжка 
手続き 		формальности процедура 
天爾遠波 		частицы послелоги 
出会う 		встречаться 
出入り口 		вход и выход 
出かける 		выходить отправляться 
問い合わせ 		запрос справка 
時々 		иногда время от времени 
所々 		там и сям в разных местах повсюду 
取っ手 		ручка рукоятка 
飛び下りる 		спрыгнуть 
独逸 		Германия 
同形 		однотипный изоморфизм 
堂々 		величественный грандиозный 
同盟 		союз лига 
泥棒 		вор 
治す 		лечить исправлять улучшать 
治る 		поправляться выздоравливать улучшаться исправляться 
並木 		ряд деревьев (вдоль улицы, дороги) аллея ряд деревьев (вдоль улицы, дороги) 
成り行き 		течение ход развитие 
何箇 		сколько штук 
何となく 		как-то необъяснимо 
匂い 		запах 
匂う 		пахнуть 
握り飯 		рисовый колобок 
弐心 		двоедушие двуличность 
担う 		нести на плече 
大蒜 		чеснок 
値段 		цена 
値引き 		скидка 
残す 		оставлять 
乗せる 		сажать помещать (людей в вагон и т. п.) грузить 
喉 		горло 
伸ばす 		растягивать вытягивать протягивать удлинять разглаживать 
伸び 		рост 
飲み水 		питьевая вода 
乗り換え 		пересадка (с одного транспорта на другой) 
乗り換える 		пересесть (с одного транспорта на другой) 
乗り物 		средство передвижения 
暢気 		беспечный беззаботный 
計る 		измерять взвешивать 
二十日 		двадцать дней двадцатое (число месяца) 
話し中 		(1) в процессе беседы (2) занято (телефонный сигнал) 
歯磨き 		зубная паста 
早める 		ускорять приближать (срок и т. п.) 
万歳 		да здравствует десяти тысячи лет ура 
引っ越し 		переезд (куда-л.) 
人差し指 		указательный палец 
酷い 		ужасный жестокий 
雲雀 		жаворонок 
一一九番 		номер 119 (телефонный номер скорой помощи и пожарной части в Японии) 
１１０番 		номер 110 (телефонный номер полиции в Японии) 
百科事典 		энциклопедия 
表札 		табличка с именем (на двери) 
昼食 		обед 
広げる 		разворачивать распрямлять расправлять 
両親 		родители (оба) 
不妊 		бесплодие 
船 		корабль судно лодка судно лодка 
振り袖 		фурисодэ (кимоно с длинными рукавами для незамужних женщин) 
旧跡 		исторические места исторические руины 
併呑 		аннексия захват поглощение 
偏屈 		эксцентричность упрямство 
菠薐草 		шпинат 
保証 		гарантия обеспечение поручительство 
褒める 		хвалить 
前売り券 		предварительно купленный или проданный билет 
益々 		всё более и более ещё (более) 
町 		(1) городок (2) улица 
真っ黒 		абсолютно чёрный 
祭 		фестиваль праздник 
眉墨 		карандаш для бровей 
丸い 		круглый 
稀 		редкий 
周り 		окрестности вокруг 
真ん中 		самая середина 
民族 		нация национальность 
民俗 		нация национальность 
向い 		напротив противоположная сторона 
向かい側 		противоположная сторона 
向かう 		(1) быть обращённым (куда-л.) обращаться (2) отправляться идти развиваться (в каком-л. направлении) 
麦わら帽子 		соломенная шляпа 
向こう側 		противоположная сторона напротив 
目 		глаз 
目覚まし時計 		будильник 
目につく 		бросаться в глаза 
面々 		каждый все 
申し込み 		заявление требование 
基づく 		основываться опираться 
焼き鳥 		жареная курица 
焼肉 		якинику (японское блюдо из жареного мяса) 
屋敷 		особняк 
山々 		горы 
郵便 		почта 
有利 		полезный выгодный 
世 		мир общество эпоха 
良い 		хороший 
呼び出し 		вызов 
蘇る 		воскреснуть переродиться 
倚る 		опираться облокачиваться 
略奪 		грабёж захват 
暦年 		календарный год 
労働 		труд 
魯国 		Россия 
分かる 		понимать быть понятым 
我が 		мой наш свой 
沸く 		кипеть бурлить 
湧く 		кипеть бурлить 
詫びる 		просить прощения извиняться 
割 		десять процентов одна десятая 
割り当て 		распределение 
割引 		скидка 
我ら 		мы 
我々 		мы 
伯父 		дядя (старше матери или отца) дядя (младше матери или отца) 
伯母 		тётя (старше матери или отца) тётя (младше матери или отца) 
低音 		бас 
履く 		надевать на ноги (обувь, чулки, носки, брюки и т. п.) 
裃 		(1) верхняя и нижняя части тела (2) парадное одеяние самураев 
上下 		верхи и низы правители и народ 
戦後 		послевоенный период послевоенный 
近代音楽 		современная музыка 
痛ましい 		(1) печальный прискорбный (2) жалкий 
一向に 		(с отриц.) нисколько ничуть 
嫌がる 		не любить ненавидеть 
母さん 		мать 
風上 		наветренная сторона 
感ずる 		(1) чувствовать ощущать (2) быть тронутым быть взволнованным (чем-л.) 
塩辛い 		солёный 
資本家 		капиталист 
成算 		расчёт на успех надежды на успех 
速達便 		срочная почта экспресс почта 
速達郵便 		срочная почта экспресс почта 
対する 		быть обращённым (куда-л.) 
注意深い 		внимательный 
父さん 		отец 
聊か 		слегка незначительно немного 
診療所 		(поли)клиника 
違いない 		несомненно (в конце предл.) не что иное как (после сущ.) 
アイスコーヒー 		кофе глясе 
イスラム教 		ислам мусульманство мусульманская религия 
ガラス戸 		стеклянная дверь 
寝過ごす 		проспать 
ひき肉 		фарш 
間違う 		ошибаться 
岬 		мыс 
耳より 		приятный на слух 
汚れ 		грязь 
歴然 		ясно очевидно 
寝ぼける 		быть сонным 
彼方此方 		здесь и там 
お休み 		(1) выходной отдых отсутствие пропуск (2) "спокойной ночи" 
御座います 		быть находиться существовать 
どうも有難う 		спасибо 
お祝い 		поздравление празднование 
お早う 		"доброе утро" 
カトリック教会 		католическая церковь 
マルクス主義 		марксизм 
ユダヤ教 		иудаизм 
一人暮らし 		жизнь в одиночестве 
陰関数 		неявная функция 
鬼面 		маска демона отталкивающее лицо 
脚光 		рампа свет рампы 
鈍 		тупой несообразительный глупый медлительный 
散発的 		спорадический 
慨嘆 		скорбь горе 
戒慎 		осторожность осмотрительность 
漫歩 		гулять бродить без цели 
面詰 		упрекать в лицо порицать в лицо 
老成 		достижение зрелости 
呻吟 		стон 
曠古 		исторический небывалый 
赤旗 		красное знамя 
網目 		сеть сетка 
琵琶湖 		Бива (озеро) 
木刀 		деревянный меч 
暢達 		плавность лёгкость 
第五 		пятый 
第三 		третий 
鈍才 		глупость несообразительность глупый человек 
エッフェル塔 		Эйфелева башня 
不協和音 		диссонанс неблагозвучие какофония 
負数 		отрицательная величина 
外交団 		дипкорпус дипломатический корпус 
下の下 		худшее из худшего 
岐阜 		Гифу 
初めまして 		"рад с вами познакомиться" (при первой встрече) 
薄暮 		сумерки 
非業の死 		неестественная смерть 
放漫 		распущенный безответственный безалаберный 
本土 		основная территория страны 
砲声 		звук канонады орудийные залпы 
此れ 		это (рядом с говорящим) 
ソフトドリンク 		безалкогольный напиток 
豹 		пантера 
竜 		дракон 
受取人 		адресат 
オレンジ色 		оранжевый цвет 
如月 		второй месяц лунного календаря 
葉月 		восьмой месяц лунного календаря 
敢え無い 		(1) преходящих эфемерный (2) слабый (3) печальный горестный трагический 
近衛 		гвардия 
見張り 		охранник сторож 
しーん 		сцена 
鎌 		серп 
錠 		замок 
定め 		закон правило судьба предопределённость 
鞭 		бич кнут 
魔 		демон дьявол злой дух 
偶に 		случайно редко 
赤信号 		красный свет (светофора) 
譲位 		отрешение от престола (в пользу кого-л.) 
述作 		сочинение произведение 
核の傘 		ядерный зонт атомный зонт 
カスピ海 		Каспийское море 
語らい 		(1) разговор (2) уговор 
喫煙席 		место (сиденье) для курящих 
オフ会 		офлайн встреча (встреча вживую людей обычно общающихся в онлайне) 
リニューアル 		обновление (en: renewal) 
座標 		координаты 
国体 		государственный строй 
心する 		принимать к сердцу 
小娘 		юная девушка 
位する 		(1) занимать место (по какому-л. разряду и т. п.) (2) быть расположенным лежать 
窓ガラス 		оконное стекло 
名君 		мудрый правитель 
面識 		знакомство 
耳鳴り 		звон в ушах 
無名氏 		аноним 
生水 		сырая (не кипячёная) вода 
親会社 		компания-учредитель материнская компания 
連作 		(1) совместно созданное произведение (2) повторный посев той же культуры 
陸揚げ 		высадка выгрузка (на берег) 
緑化 		озеленение 
声調 		тон голоса 
成否 		успех или неудача результат 
精糖 		производство сахара 
世間体 		приличие репутация 
船倉 		трюм 
進化論 		теория эволюции 
心筋 		миокард 
深耕 		глубокая вспашка 
心痛 		тревога страдание 
神式 		синтоистский ритуал 
ブレス 		дыхание 
カイゼル 		кайзер 
ハルバード 		алебарда 
ショックウェイブ 		ударная (взрывная) волна 
アサルト 		штурм 
ナイトメア 		кошмар (en: nightmare) 
ノヴァ 		новая звезда 
タイフーン 		тайфун 
スピア 		копьё 
ソード 		меч 
ジャベリン 		метательное копьё 
エクスキューター 		палач 
プリースト 		священник жрец 
セイント 		святой 
ワーロック 		ворлок 
アロー 		стрела 
オーガ 		огр людоед 
カース 		проклятие 
ガーディアン 		страж 
グール 		гуль 
グリフォン 		грифон 
グレムリン 		гремлин 
コカトリス 		куролиск 
ゴーレム 		голем 
スティンガー 		жало стингер 
スライム 		слизь 
ツヴァイハンダー 		двуручный меч 
デミ 		полу- деми- 
トゥルー 		истина истинный 
トルーパー 		солдат (наземный - пилот техники или десантник) (en: trooper) 
ハーピー 		гарпия 
ハウンド 		гончая (собака) 
バイパー 		гадюка випера 
ヒドラ 		гидра 
ビースト 		зверь животное 
フロッグ 		лягушка 
ベヒーモス 		бегемот (мифический) 
マンティス 		богомол 
メイス 		булава 
リザード 		ящерица 
ヴァンパイア 		вампир 
松風 		ветер в соснах 
父君 		отец 
初子 		первый ребёнок 
初孫 		первый внук первая внучка 
白雪 		белый снег 
白旗 		белый флаг 
完全無欠 		абсолютное совершенство безупречность 
君側 		двор (монарха) приближённые 
暮夜 		ночь 
京都 		Киото (город) 
仏蘭西 		Франция 
逆比例 		обратная пропорция 
緒言 		предисловие введение 
睡蓮 		кувшинка 
診察料 		плата за медицинский осмотр 
勝ち取る 		добиться завоевать 
訪問着 		полуофициальное кимоно для женщин 
恭賀 		почтительное поздравление 
対語 		антоним 
篤実 		честность верность 
文学部 		филологический факультет 
提琴 		скрипка 
作付面積 		обрабатываемая площадь 
三度 		три раза третий раз 
紙上 		на бумаге в газете в письме 
写真集 		фотоальбом 
集結 		сосредоточение накопление 
集大成 		компиляция 
エチオピア 		Эфиопия 
ケニア 		Кения 
モーターボート 		моторная лодка 
戸 		счётный суффикс для дворов (в хозяйстве и т. п.) 
アシッド 		кислота 
グレネード 		граната 
サンダー 		гром 
スモーク 		дым 
タンジェント 		касательная тангенс 
バズーカ 		базука 
パーセク 		парсек 
ランチャー 		пусковая установка 
初校 		первая корректура 
相思相愛 		взаимная любовь 
当否 		правомерность справедливость уместность 
初陣 		первый бой боевое крещение 
歌い手 		певец 
洋傘 		зонт (в европейском стиле) 
有機体 		организм 
舌頭 		кончик языка 
造詣 		знания эрудиция 
客語 		прямое дополнение 
初空 		небо первого дня в году 
幼名 		детское имя 
流砂 		зыбучие пески 
暗暗裡 		скрытно тайно молчаливо окольным путём 
完全主義 		перфекционизм 
完全雇用 		полная занятость 
和書 		японская книга 
瓦屋根 		черепичная крыша 
運び去る 		увлекать 
運命論者 		фаталист 
運転免許証 		водительские права 
違警罪 		нарушение полицейских правил 
旬間 		декада десять дней 
帰納的 		рекурсивный 
遺産相続人 		наследник наследница 
血液学 		гематология 
血液検査 		анализ крови 
血液銀行 		банк крови 
暮れ方 		к вечеру 
暮秋 		поздняя осень 
暮雪 		вечерний снегопад заснеженный вечерний пейзаж 
無手 		невооружённый с голыми руками без средств 
無名指 		безымянный палец 
無体 		(1) бестелесный нематериальный невещественный (2) насильно дерзко 
無味 		безвкусный 
無神論 		атеизм 
無限小数 		бесконечная дробь 
無限級数 		бесконечный ряд 
無記名投票 		тайное голосование 
無聊 		скука 
空想家 		мечтатель 
浴衣掛け 		одетый в юката 
喉仏 		адамово яблоко 
後衛 		арьергард 
発動機 		двигатель мотор 
廃位 		лишать престола 
廃兵 		инвалид (о военном) 
反戦主義 		пацифизм 
反戦主義者 		пацифист 
金的 		центр мишени яблочко цель 
感傷的 		сентиментальный 
急行便 		экспресс почта 
暗殺未遂 		попытка убийства 
暗殺者 		убийца 
禁圧 		запрет запрещение 
泣き言 		жалобы нытьё 
古典音楽 		классическая музыка 
航空路 		авиалиния 
衡平 		равновесие (перен.) справедливость 
衡器 		весы 
重合体 		полимер 
通話料 		плата за телефон 
痛心 		тревога страдание 
痛苦 		боль мука 
痛論 		горячее обсуждение острая критика 
同時通訳 		синхронный перевод 
非命 		неестественный насильственный (о смерти) 
非理 		нелепость абсурд 
非望 		(1) непомерное честолюбие (2) злой умысел задняя мысль 
非道 		(1) жестокость зверство (2) несправедливость 
非業 		неестественный насильственный (о смерти) 
非戦論 		пацифизм 
非戦論者 		пацифист 
非違 		незаконность 
飛び下り 		спрыгивание 
飛語 		ложный слух 
薄鈍 		глуповатый придурковатый 
父性 		отцовство 
独身者 		одинокий холостяк 
投票所 		избирательный участок 
邪神 		злой бог 
五十 		пятьдесят 
お負け 		(1) дополнение (2) преувеличение 
輸尿管 		мочеточник 
朝風 		утренний ветер 
畜産学 		животноводство 
手術台 		операционный стол 
手術衣 		хирургический халат 
寵愛 		благосклонность расположение 
村夫子 		сельский учитель 
村会 		сельский совет (в Японии) 
存否 		существование (под вопросом) существование или нет жизнь или смерть 
鎖鎌 		кусаригама (оружие в виде серпа с цепью) 
土語 		местный говор 
吐剤 		рвотное (средство) 
鼠算 		геометрическая прогрессия 
専門化 		специализация 
専門学校 		техникум 
団結心 		дух солидарности 
真っ暗闇 		полная тьма 
身ごもる 		забеременеть быть беременной 
実否 		истинность (под вопросом) истинность или ложность 
登山家 		альпинист 
数十 		несколько десятков 
放射性元素 		радиоактивный элемент 
放射性同位体 		радиоизотоп 
放射性物質 		радиоактивный материал 
放射能汚染 		радиоактивное загрязнение 
放射能雲 		радиоактивное облако 
放射線療法 		рентгенотерапия 
並木道 		аллея улица или дорога обсаженная деревьями 
偶蹄類 		парнокопытные 
鈍物 		тупица 
鈍根 		вялый тупой 
汗水 		пот испарина 
喫煙車 		вагон для курящих 
喫煙室 		комната для курения 
看護人 		санитар медбрат 
調髪 		стрижка 
毒虫 		ядовитое насекомое 
往復切符 		билет туда и обратно 
広原 		широкая равнина 
泳者 		пловец 
光体 		светящееся тело 
光学機械 		оптический прибор 
光学顕微鏡 		оптический микроскоп 
最大公約数 		наибольший общий делитель 
最終兵器 		совершенное оружие 
絶対零度 		абсолютный ноль 
絶望的 		отчаянный 
未来形 		(грам.) будущее время 
紋章学 		геральдика 
火掻き 		кочерга 
門衛 		привратник швейцар 
美術家 		художник артист 
晩成 		позднее образование поздняя зрелость (кого-л.) 
資本主義者 		капиталист 
階上 		верхний этаж 
筋肉労働 		физическая работа 
二刀流 		школа двух мечей 
二極真空管 		диод 
日本化 		японизация 
年中無休 		открытый круглый год без выходных 
弥漫 		распространение широкое проникновение 
等式 		(мат.) равенство 
等質 		однородность 
敵愾心 		враждебность 
船体 		корпус судна 
船端 		борт судна 
術計 		хитрость уловка махинация трюк 
水力発電所 		гидростанция гидроэлектростанция 
水耕法 		гидропоника 
水栽培 		гидропоника 
水素爆弾 		водородная бомба 
水銀中毒 		отравление ртутью 
水銀灯 		ртутная лампа 
水銀気圧計 		ртутный барометр 
水銀温度計 		ртутный термометр 
不定方程式 		неопределённое уравнение 
不等式 		(мат.) неравенство 
不確定 		неопределённость 
在庫管理 		инвентаризация 
窮鼠 		загнанная мышь 
哨戒機 		патрульный самолёт 
小成 		небольшой успех 
小作 		аренда земли 
小作料 		арендная плата за землю 
小荷物 		посылка (в ящике) 
小舅 		деверь 
小熊座 		Малая медведица 
小鴨 		утёнок 
笑声 		смех 
執行機関 		исполнительный орган 
有り体 		как есть правдиво 
国際電話 		международный телефонный звонок 
郵便車 		почтовый вагон 
郵便受け 		почтовый ящик 
活用形 		спряжение 
換気装置 		вентилятор 
遠島 		(1) отдалённый остров (2) наказание ссылкой на отдалённый остров 
遠視眼 		дальнозоркость 
保証書 		гарантийный талон 
浮雲 		плывущее облако 
相対性 		относительность 
相関関係 		соотношение корреляция 
双球菌 		диплококк 
精神労働 		умственная работа 
売品 		товар для продажи 
世界新記録 		новый мировой рекорд 
残月 		луна на ущербе 
山荒 		дикобраз 
山ほど 		очень много куча по горло 
山麓 		подножие горы 
義勇兵 		доброволец (о военном) 
宴会場 		банкетный зал 
利尿剤 		мочегонное средство 
利鈍 		(1) острый или тупой (2) сообразительность или тупость 
第一次世界大戦 		Первая Мировая Война (1914-1918 гг.) 
第二次世界大戦 		Вторая Мировая Война (1939-1945 гг.) 
第二次性徴 		вторичные половые признаки 
第五列 		пятая колонна 
女子大生 		студентка 
女子供 		женщины и дети 
女子学生 		ученица студентка 
女心 		женское сердце женская психология 
女学校 		женская школа 
女嫌い 		женоненавистник 
奴隷制度 		рабовладельческий строй 
ゆで卵 		варёное яйцо 
地鼠 		землеройка 
成人式 		торжество по случаю совершеннолетия 
成因 		причина образования (чего-л.) 
成体 		взрослый организм имаго 
成案 		определившийся план определённый план 
成敗 		результат успех или поражение 
成語 		устойчивое словосочетание 
神無月 		десятый месяц лунного календаря 
電気掃除機 		электрический пылесос 
電気機関車 		электровоз 
電気器具 		электроприборы 
電動機 		электрический мотор 
電報料 		плата за телеграмму 
洗面台 		умывальник 
西洋式 		европейский стиль 
西班牙 		Испания 
さらし首 		отрубленная голова, выставленная для устрашения 
四百 		четыреста 
死肉 		падаль мертвечина 
細君 		жена 
耽美主義 		эстетизм 
針葉樹 		хвойные деревья 
舷梯 		трап сходни 
歯磨き粉 		зубной порошок 
道心 		(1) моральное чувство чувство долга (2) благочестие набожность 
導関数 		производная 
から傘 		зонт (в японском стиле) 
露西亜 		Россия 
許否 		разрешение (под вопросом) разрешение или отказ 
灯下 		при свете 
奇声 		странный голос 
拙宅 		моё жалкое жилище 
拙作 		неумелая работа 
鉄心 		железный сердечник 
金槌 		(1) молот (2) наказание 
謹直 		добросовестность скрупулёзность 
機帆船 		моторно-парусное судно 
機械的 		механический 
機関士 		инженер 
近代文学 		современная литература 
近代主義 		модернизм 
近代国家 		современная страна 
練兵 		армейская (военная) тренировка 
練り歯磨き 		зубная паста 
連続関数 		непрерывная функция 
権衡 		весы 
観光案内所 		справочное бюро для туристов 
球乗り 		катание на шаре 
掬い網 		сачок 
太陰暦 		лунный календарь 
置き去り 		оставлять покидать 
特命全権大使 		Чрезвычайный и Полномочный Посол 
差別待遇 		дискриминационное отношение дискриминация 
敢為 		смелый 
気変わり 		непостоянство 
汽缶 		паровой котёл 
賃下げ 		снижение заработной платы 
潜水服 		водолазный костюм 
潜水器 		водолазный аппарат 
養父母 		приёмные родители 
象牙海岸 		Берег Слоновой Кости 
記念品 		памятный подарок сувенир 
理事会 		комитет совет директорат 
爆音 		взрыв (звук) 
長広舌 		многословие говорливость 
常数 		постоянная величина константа 
初一念 		первоначальное намерение 
初氷 		первый лёд 
初号 		первый номер журнала 
初年 		первый год 
初見 		впервые увидеть 
初乗り 		первая поездка (на новой машине и т. п.) 
初発 		зарождение первое возникновение 
初速 		начальная скорость движения 
初診 		первый осмотр (у врача) 
初診料 		плата за первый осмотр (у врача) 
競技会 		соревнования игры 
競技場 		стадион 
銀行券 		банкнота 
月世界 		луна лунный мир 
木偶の坊 		(1) деревянная кукла марионетка чучело (2) олух остолоп 
木霊 		эхо 
目明き 		зрячий 
あつらえ向き 		как по заказу вполне подходящий идеальный 
高遠 		возвышенный 
量子力学 		квантовая механика 
誇張法 		гипербола преувеличение 
関ヶ原 		Сэкигахара 
関数空間 		функциональное пространство 
漫画家 		мангака автор манги 
漫筆 		разные заметки литературная смесь 
漫漫 		безбрежный безграничный бескрайний 
面部 		лицо 
進化論者 		эволюционист 
進歩的 		прогрессивный 
三分 		три минуты 
三日間 		три дня в течении трёх дней 
暫定的 		временный предварительный 
挿話的 		эпизодический 
握り拳 		сжатый кулак 
時間の問題 		дело времени 
耳打ち 		шептание на ухо 
耳語 		шёпот 
耐食 		нержавеющий антикоррозийный 
耕土 		пашня 
掛け物 		какэмоно (декоративный свиток с рисунком или каллиграфической надписью) 
詭弁家 		софист 
乱流 		турбулентное течение 
本式 		по-настоящему как следует согласно форме правильно 
詮議 		обсуждение рассмотрение расследование 
代数方程式 		алгебраическая уравнение 
代数関数 		алгебраическая функция 
膿汁 		гной 
肉体労働 		физическая работа 
曙光 		(1) рассвет утренняя заря (2) (перен.) луч проблеск 
赤黒い 		тёмно-красный 
生き死に 		жизнь или смерть жизнь и смерть 
生命線 		линия жизни 
生け贄 		жертва 
陳列室 		выставочная комната 
震源地 		очаг землетрясения 
流動体 		жидкое тело 
蛋白 		белок 
食あたり 		пищевое отравление 
白雪姫 		Белоснежка 
白鼠 		белая мышь белая крыса 
座礼 		поклон сидя 
染色体 		хромосома 
染み抜き 		пятновыводитель 
風見 		флюгер 
風景画 		пейзаж (изображение) 
鬨の声 		боевой клич 
打ち立てる 		устанавливать 
寝入る 		заснуть 
連分数 		непрерывная дробь 
ステンレス鋼 		нержавеющая сталь 
短期間 		короткий период времени 
就いて 		о об относительно 
当て事 		надежды расчёты 
暗殺を謀る 		замышлять убийство 
伺い 		(1) вопрос запрос (2) посещение визит 
虚ろな目 		пустые глаза невидящие глаза 
運賃込みで 		(цена) включая стоимость доставки 
俺たち 		мы 
吃水 		осадка (судна) 
記録を破る 		побить рекорд 
携帯カメラ 		ручная камера ручной фотоаппарат 
京浜 		Кэйхин (район Токио-Йокохама) 
血液中の糖 		уровень сахара в крови 
呼応して 		согласованно 
言葉の壁 		языковой барьер 
小箱 		маленькая коробка шкатулка 
暫定案 		предварительный план 
写真を撮る 		фотографировать 
真犯人 		настоящий преступник 
心配を掛ける 		причинять беспокойство 
数年間 		несколько лет в течении нескольких лет 
声誉 		почёт слава доброе имя 
組織体 		организм 
旦暮 		утро и вечер 
朝食を出す 		подавать завтрак накрывать стол для завтрака 
費え 		расходы 
続き 		продолжение 
冷たい戦争 		холодная война 
鉄のカーテン 		железный занавес 
電報局 		телеграфное отделение 
電報を打つ 		посылать телеграмму 
遠い昔 		далёкое прошлое 
遠くから 		издали издалека 
恥ずかしがり屋 		стеснительный человек 
髭剃り後 		после бритья 
方程式の一項 		член уравнения 
本の虫 		книжный червь 
瞬く間に 		в мгновение ока 
みかんの汁 		мандариновый сок 
子供部屋 		детская комната 
ガントレット 		перчатка (латная) 
ヘルム 		шлем 
デストロイヤー 		разрушитель 
ブルーム 		метла 
ワンド 		жезл 
ゲイル 		порыв (ветра) 
コンポジット 		композит смесь 
ベルセルク 		берсерк 
フランヴェルジュ 		фламберг (меч) 
トゥース 		зуб 
コフィン 		гроб 
スレイヤー 		убийца 
ドゥーム 		рок судьба 
クリーヴァ 		колун секач тесак 
デュエル 		дуэль 
レイピア 		рапира 
タリスマン 		талисман 
リフレクト 		отражать 
マジカル 		магический 
クロノ 		хроно 
ベルベーヌ 		вербена 
ラベンダー 		лаванда 
セージ 		(1) мудрец (2) шалфей 
セボリー 		сатурея 
パイン 		сосна 
イフリート 		ифрит 
ウンディーネ 		ундина 
シルフ 		сильф 
リザレクション 		воскрешение 
ディスペル 		рассеивать изгонять (духа) 
アンチドート 		антидот 
エイド 		помощь 
メテオ 		метеор 
クラウド 		облако 
デス 		смерть 
ウォール 		стена 
ストーン 		камень 
トーネード 		торнадо 
イラプション 		извержение 
グレイブ 		могила 
ソルジャー 		солдат 
ライトニング 		молния 
トルバドール 		трубадур 
グーングニル 		Гунгнир (копьё Одина) 
二年生 		студент второго курса учащийся на втором году обучения 
何の 		который какой 
何の 		какой 
くノ一 		женщина-ниндзя 
シスオペ 		системный оператор 
パラサイトシングル 		человек, не вступающий в брак и зарабатывающий достаточно на своё содержание, но живущий с родителями, чтобы не тратить деньги на жильё (en-trans: parasite single) 
メルアド 		адрес электронной почты 
ビーチバレー 		пляжный волейбол 
シスアド 		системный администратор 
和英辞書 		японско-английский словарь 
阿弗利加 		Африка 
オーディーン 		Один 
エクスカリバー 		Экскалибур 
ヴァルキリー 		валькирия 
ユミル 		Имир 
モレキュラー 		молекулярный 
ロアー 		мудрость 
エルヴン 		эльфийский 
プライマル 		древний изначальный примитивный 
ドワーフ 		дварф карлик 
ホーネット 		шершень 
オーブ 		сфера шар 
ターコイズ 		бирюза бирюзовый цвет 
バシリスク 		василиск 
アデプト 		адепт 
クレリック 		клирик церковник 
スクイッド 		кальмар 
ビー 		пчела 
スラッグ 		слизняк 
トード 		жаба 
コープス 		труп 
バンシー 		баньши 
イーブル 		зло 
ポルターガイスト 		полтергейст 
上布 		высокосортная ткань 
完全燃焼 		полное сгорание 
喫煙所 		место для курения 
銀行口座 		банковский счёт 
現代英語 		современный английский 
作詞者 		автор текста (песни) 
暫定措置 		временная мера 
就職活動 		поиск работы 
住宅問題 		жилищный вопрос 
女子校 		женская школа 
女子大学 		женский университет женский колледж 
女子寮 		женское общежитие 
診断学 		диагностика 
蜘蛛の巣 		паутина 
リンガホン室 		лингафонный кабинет 
試験を受ける 		сдавать экзамен 
ポプラ 		тополь 
積分法 		интеграция 
組織学 		гистология 
男爵夫人 		баронесса 
通訳官 		официальный переводчик (устный) 
伝導体 		(физ.) проводник 
復讐心 		мстительность 
保健室 		(школьный) медицинский кабинет 
放射性降下物 		радиоактивные осадки 
野球選手 		бейсболист 
旅客列車 		пассажирский поезд 
両替所 		обменный пункт 
練習機 		учебный самолёт 
錬金術師 		алхимик 
トロリーバス 		троллейбус 
エルグ 		эрг 
呪詛 		проклятие 
スクウェア 		квадрат (en: square) 
展覧会場 		выставочный зал 
四年生 		студент четвёртого курса учащийся на четвёртом году обучения 
舌苔 		налёт на языке 
留袖 		томэсодэ (официальное чёрное кимоно с короткими рукавами для замужних женщин для ношения в торжественных случаях) 
感 		чувство ощущение впечатление 
芸 		искусство умение игра (на сцене) 
範 		(1) пример образец (2) сфера область 
紋 		(фамильный) герб 
有りとあらゆる 		всевозможный 
暈 		ореол корона 
アールエイチ 		Rh резус-фактор 
アテネ 		Афины 
アパラチア山脈 		Аппалачи 
イギリス人 		англичанин 
通訳者 		переводчик (устный) 
通訳人 		переводчик (устный) 
アラブ人 		араб 
イギリス海峡 		Английский канал 
イギリス諸島 		Британские острова 
イタリア語 		итальянский язык 
ゲームの理論 		теория игр 
ヒルベルト空間 		Гильбертово пространство 
フェルマの原理 		принцип Ферма 
フェルマの問題 		задача Ферма 
ブラウン運動 		броуновское движение 
メキシコ湾流 		Гольфстрим 
ユークリッド幾何学 		евклидова геометрия 
ユークリッド空間 		евклидово пространство 
レーザー光線 		лазерный луч 
確率分布 		распределение вероятностей 
完全数 		совершенное число 
ブロッブ 		сгусток капля 
アックス 		топор 
アーマー 		броня доспех 
アースクエイク 		землетрясение 
ケイン 		трость посох 
マイン 		мина 
臨時工 		временный рабочий 
メット 		шлем каска 
残念なことに 		к сожалению 
眩む 		темнеть 
掛け直す 		перезванивать (по телефону) 
愛くるしい 		милый прелестный 
兄上 		старший брат 
エミュレーション 		эмуляция 
週一日 		один день в неделю 
週二日 		два дня в неделю 
週三日 		три дня в неделю 
週四日 		четыре дня в неделю 
週五日 		пять дней в неделю 
週六日 		шесть дней в неделю 
週七日 		семь дней в неделю 
バチ環 		Ватикан 
中高 		средняя школа и средняя школа высшей ступени 
四人 		четверо четыре человека 
生産能力 		производственная сила 
この世 		этот мир настоящее (время) 
セントラル 		центральный 
下 		под при по 
愛蘭 		Ирландия 
アルバニア 		Албания 
アルメニア 		Армения 
アンゴラ 		Ангола 
アンドラ 		Андорра 
イギリス領ギアナ 		Гвиана Британская 
イギリス領ホンデュラス 		Британский Гондурас 
グアドループ島 		Гваделупа 
グアム島 		Гуам 
ジブラルタル 		Гибралтар 
バーミューダ 		Бермуды 
露和 		Россия и Япония русско-японский 
和露 		Япония и Россия японско-русский 
幼児虐殺 		избиение младенцев 
ソビエト社会主義自治共和国 		автономная советская социалистическая республика АССР 
ソビエト社会主義共和国 		советская социалистическая республика ССР 
人民共和国 		народная республика 
人民社会主義共和国 		народная социалистическая республика 
人民民主共和国 		народная демократическая республика 
もう一度 		ещё раз 
何人 		кто какой человек 
何年生 		студент какого курса (при вопросе) на каком году обучения 
バングラデシュ 		Бангладеш 
ガーナ 		Гана 
ベリーズ 		Белиз 
バルバドス 		Барбадос 
ベラルーシ 		Беларусь Белоруссия 
感ける 		(1) быть занятым (чем-л.) (2) жаловаться ныть (3) быть тронутым быть взволнованным 
違える 		противоречить нарушать 
巧む 		замышлять 
慎ましい 		скромный застенчивый сдержанный 
ひょっとしたら 		может быть быть может 
真っ白い 		белоснежный совсем белый 
ガボン 		Габон 
ガボン共和国 		Габонская Республика 
ハワイ諸島 		Гавайские острова 
ハイチ島 		Гаити 
ハイチ共和国 		Республика Гаити 
ガイアナ 		Гайана 
ガイアナ協同共和国 		Кооперативная Республика Гайана 
ガンビア共和国 		Республика Гамбия 
ガーナ共和国 		Республика Гана 
グアテマラ共和国 		Республика Гватемала 
仏領ギアナ 		Гвиана Французская 
フランス領ギアナ 		Гвиана Французская 
ギニア共和国 		Гвинейская республика 
ギニアビサウ 		Гвинея-Бисау 
ギニアビサウ共和国 		Республика Гвинея-Бисау 
ホンジュラス共和国 		Республика Гондурас 
グレナダ 		Гренада 
グレナダ島 		Гренада 
グリーンランド島 		Гренландия 
ギリシャ共和国 		Греческая Республика 
グルジアソビエト社会主義共和国 		Грузинская Советская Социалистическая Республика Грузинская ССР ГССР 
目に浮かぶ 		стоять перед глазами 
聖 		святой 
酔拳 		(MA) пьяный кулак 
狂牛病 		коровье бешенство 
二次コン 		двухмерный комплекс (пристрастие к рисованным персонажам) 
ジオラマ 		диорама 
編曲者 		аранжировщик 
リライタブル 		перезаписываемый 
ミニスカ 		мини-юбка 
サテュロス 		сатир 
ビバップ 		бибоп 
水力電気 		гидроэлектроэнергия 
癲狂 		сумасшествие помешательство 
露日 		русско-японский 
理髪室 		парикмахерская 
遊びに行く 		ходить в гости 
目を見張る 		вытаращить глаза поразиться 
牧 		пастбище 
米作り 		возделывание риса 
噴射式 		реактивный 
麦類 		зерновые 
陳列品 		экспонат 
アーチャー 		лучник (en: archer) 
クロウ 		ворона (en: crow) 
ブッチャー 		мясник (en: butcher) 
リッパー 		потрошитель (en: ripper) 
タイガー 		тигр 
相伴 		участвовать принимать участие разделять (что-л. с кем-л.) 
ミノタウロス 		минотавр 
エビル 		злой (en: evil) 
メイジ 		маг 
マッド 		грязь (en: mud) 
ドール 		кукла (en: doll) 
エクトプラズム 		эктоплазма 
ウェアウルフ 		оборотень человек-волк вервольф (en: werewolf) 
グラディエーター 		гладиатор 
ブライトネス 		яркость (en: brightness) 
五面体 		пятиугольник 
旅行会社 		туристическая компания 
就活 		поиск работы 
誂え 		заказ 
痛がる 		страдать от боли 
ホムンクルス 		гомункул гомункулус 
暈倒病 		колер (у лошадей) вертячка (у овец) 
戍卒 		охрана стража гарнизон 
漫ろ言 		бессвязная болтовня 
スノーボード 		сноуборд 
共晶 		эвтектика 
ターボプロップ 		турбовинтовой 
電磁気学 		электромагнетизм 
メチレン 		метилен 
解 		решение (напр. уравнения) 
お気に召す 		нравиться 
下手に出る 		держаться подобострастно 
大阪 		Осака 
下 		(1) низ худшее (2) 2-ой том двухтомника 3-ий том трёхтомника 
下 		(1) низ внизу подчинённые низшие низы 
べた 		бета 
二等車 		вагон второго класса 
握らせる 		сунуть в руку 
東シナ海 		Восточно-Китайское море 
違う 		(1) быть другим отличаться различаться (по чему-л.) расходиться (с чем-л.) (2) нарушать идти против 
色無地 		одноцветное (кроме чёрного) кимоно 
ローマ法王 		римский папа 
ユーラシア 		Евразия 
虎列剌 		холера 
弐つ 		два (в основном используется в документах) 
横浜 		Йокохама 
名古屋 		Нагоя (город) 
衛士 		(ист.) охранник 
詣で 		посещение храма паломничество 
詣でる 		посещать храм совершать паломничество 
ヴァルナ 		Варна 
下垂体 		гипофиз 
貂 		десять (en: ten) 
慎ましやか 		скромный застенчивый сдержанный 
ラーメン 		рамэн (китайская лапша) 
ブール代数 		булева алгебра алгебра логики 
御覧に入れる 		показывать 
非ず 		не 
元 		под руководством (и т. п.) 
一日 		первое (число месяца) 
線形計画法 		линейное программирование 
統一場理論 		единая теория поля 
星々 		звёзды 
逐次通訳 		последовательный перевод 
舌たるい 		шепелявый невнятный 
伯母さん 		тётя 
都合がいい 		удобный благоприятный 
都合が悪い 		неудобный неблагоприятный 
急に 		внезапно срочно поспешно 
第四 		четвёртый 
雪風 		вьюга 
アンチウィルス 		антивирус 
コードページ 		кодовая страница (en: code page) 
サウンドカード 		звуковая карта (en: sound card) 
シグナルハンドラ 		обработчик сигнала (en: signal handler) 
ハッチング 		штрих штриховка (en: hatching) 
バビロン 		Вавилон 
フーリエ変換 		преобразование Фурье 
マルコフ連鎖 		Марковская цепь 
帰納的関数 		рекурсивная функция 
光学式スキャナ 		оптический сканер 
光学式走査器 		оптический сканер 
光学式文字読取り装置 		оптическое распознавание символов ОРС 
光学的文字認識 		оптическое распознавание символов ОРС 
国番号 		(телефонный) код страны 
差分法 		разностное исчисление 
走査器 		сканер 
地図帳 		атлас 
中心極限定理 		центральная предельная теорема 
非線形計画法 		нелинейное программирование 
部分列 		подпоследовательность 
輸送問題 		задача о перевозках 
切手収集 		филателия 
メープル 		клён (en: maple) 
暫くして 		через некоторое время 
アタリ 		Атари 
デー 		день 
ロマ 		Рим 
鼓す 		(1) бить в барабан (2) подымать (кого-л. на борьбу и т. п.) воодушевлять 
アストラカン 		Астрахань 
ガニメデ 		Ганимед 
クレセント 		полумесяц 
月球儀 		лунный глобус 
非負 		неотрицательный 
バレッタ 		Валетта 
インド洋 		Индийский океан 
方言学 		диалектология 
亜皮西尼 		Абиссиния 
柱暦 		настенный календарь 
ヴァルハラ 		Валгалла 
衛戍 		гарнизон 
三年生 		студент третьего курса учащийся на третьем году обучения 
ロム 		ПЗУ постоянное запоминающее устройство 
自動式 		автоматический 
吃驚 		поражаться пугаться 
国際郵便 		международная почта 
シャイフ 		змея 
吐く 		(1) выдыхать (2) высказывать лгать (3) рвать тошнить 
愛敬 		любовь и уважение 
干潮 		отлив 
徒 		зря напрасно попусту 
その上 		давно раньше 
囁き 		шёпот 
端 		жена 
アゼルバイジャン 		Азербайджан 
ガンビア 		Гамбия 
バーレーン 		Бахрейн 
バヌアツ 		Вануату 
ブルネイ 		Бруней 
ブルンジ 		Бурунди 
ベナン 		Бенин 
アブハジア 		Абхазия 
白ロシア 		Беларусь Белоруссия 
ウィニペグ 		Виннипег 
ビール 		пиво (en: beer) пиво 
父称 		отчество 
ミイラ化 		мумификация 
回り 		окрестности вокруг 
喫茶室 		кафе (комната) 
コス 		костюм 
ゆた 		Юта 
実に 		на самом деле в самом деле 
兵 		боец солдат воин 
違犯 		нарушение (закона и т. п.) 
各々 		каждый всякий 
伊蘭 		Иран 
乃公 		я 
何色 		какой цвет 
鉄槌 		(1) молот (2) наказание 
ノワール 		нуар 
