A‐bom 		atom bomb 
Aandland 		Occident 
Aandster 		Evening Star Venus 
Abessinies 		Abyssinian 
Abessinië 		Abyssinia 
Abessiniër 		Abyssinian 
Achilles 		Achilles 
Achilleshiel 		Achilles' heel 
Achillespees 		Achilles' tendon 
Adam 		Adam 
Aden 		Aden 
Adonis 		Adonis 
Adriatiese 		Adriatic Adriatic Sea 
Afgaan 		Afghan 
Afgaans 		Afghan 
Afganistan 		Afghanistan 
Afrika 		Africa 
Afrikaan 		African 
Afrikaans 		African 
Afrikaner 		Afrikaans 
Afrikanertroos 		coffee 
Afro‐Asiaties 		Afro‐Asian 
Agter‐Indië 		Indo‐China 
Aken 		Aix‐la‐Chapelle 
Albaans 		Albanian 
Albanees 		Albanian 
Albanies 		Albanian 
Albaniese 		Albanian Albanian language 
Albanië 		Albania 
Albion 		Albion 
Alexandrië 		Alexandria 
Algerië 		Algeria 
Algeryn 		Algerian 
Algeryns 		Algerian 
Algiers 		Algiers 
Allah 		Allah 
Allerheilige 		All Hallows All Saints' Day 
Allersiele 		All Souls' Day 
Alpe 		Alps 
Alpien 		alpine 
Alpinies 		alpine 
Alpyns 		alpine 
Amasone 		Amazon 
Amerika 		America 
Amerikaans 		American 
Amerikaner 		American 
Amor 		Cupid 
Anatolië 		Anatolia Asia Minor 
Andalusië 		Andalusia 
Angel‐Sakser 		Anglo‐Saxon 
Angel‐Saksies 		Anglo‐Saxon 
Anglikaan 		Anglican 
Anglikaans 		Anglican 
Angola 		Angola 
Annunsiasie 		Annunciation Lady Day 
Antarktika 		Antarctic the Antarctic 
Antille 		Antilles 
Antonius 		Antony 
Apokalips 		Apocalypse 
April 		April 
Arabier 		Arab 
Arabies 		Arabian Arabic 
Arabië 		Arabia 
Ardenne 		Ardennes 
Areopagus 		Areopagus 
Argentinië 		Argentina 
Argentyn 		Argentine 
Argentyns 		Argentine Argentinean 
Argus 		Argus 
Aries 		Aryan 
Aristoteles 		Aristotle 
Ariër 		Aryan 
Ark 		Ark of the Covenant 
Armenies 		Armenian 
Armenië 		Armenia 
Armeniër 		Armenian 
Asdag 		Ash Wednesday 
Asepoestertjie 		Cinderella 
Asiaat 		Asian 
Asiaties 		Asian Asiatic 
Asië 		Asia 
Assiries 		Assyrian 
Assirië 		Assyria 
Assiriër 		Assyrian 
Astekies 		Aztec 
Atheens 		Athenian 
Athene 		Athena Athene 
Athener 		Athenian 
Atlanties 		Atlantic 
Atlantiese 		Atlantic Atlantic Ocean 
Atlas 		Atlas 
Atties 		Attic 
Augias 		Augeas 
Augiasstal 		Augean stable 
Augustus 		Augustus 
Aurora 		Aurora 
Australies 		Australian 
Australië 		Australia 
Australiër 		Australian 
Awendland 		Occident 
Babel 		Babel Babylon 
Babilon 		Babel Babylon 
Babilonies 		Babylonian 
Babilonië 		Babylonia 
Bacchus 		Bacchus 
Baleare 		Balearic Islands 
Baleariese 		Balearic Islands 
Balkan 		Balkans 
Balties 		Baltic 
Baltiese 		Baltic Sea 
Bantoe‐ 		Bantu 
Bantoe 		Bantu 
Baptis 		baptist 
Barbarye 		Barbery 
Bask 		Basque 
Baskies 		Basque 
Bataaf 		Batavian 
Bataviaan 		Batavian 
Batavier 		Batavian 
Baäl 		Baal 
Beier 		Bavarian 
Beiere 		Bavaria 
Beiers 		Bavarian 
Belg 		Belgian 
Belgies 		Belgian 
België 		Belgium 
Belgrado 		Belgrade 
Benediktyner 		Benedictine Benedictine monk 
Benediktynermonnik 		Benedictine Benedictine monk 
Benelux 		Benelux 
Bengaals 		Bengal 
Bengaalse 		bengal‐light bengal‐lights 
Bengale 		Bengal 
Beosië 		Beotia 
Berlyn 		Berlin 
Berlyner 		Berliner 
Berlyns 		Berlin 
Bern 		Berne 
Betlehem 		Bethlehem 
Birma 		Burma 
Birmaan 		Burmese 
Birmees 		Burmese 
Bisantium 		Byzantium 
Bisantyns 		Byzantine 
Bloemfontein 		Bloemfontein 
Bloubaard 		Bluebeard 
Boeddha 		Buddha 
Boeddhisme 		Buddhism 
Boeddhist 		Buddhist 
Boekarest 		Bucharest 
Boer 		Afrikaans 
Boesman 		Bushman 
Boheems 		Bohemian 
Boheme 		Bohemia 
Boliwies 		Bolivian 
Boliwië 		Bolivia 
Bolsjewiek 		Bolshevik 
Bolsjewis 		Bolshevik 
Bombaai 		Bombay 
Brabander 		Brabantine 
Brabant 		Brabant 
Brabants 		Brabantine 
Brasiliaan 		Brazilian 
Brasiliaans 		Brazilian 
Brasilië 		Brazil 
Bretagne 		Bretagne Brittany 
Brit 		Briton 
Brits 		British 
Brunswyk 		Brunswick 
Brussel 		Brussels 
Brussels 		Brussels 
Brusselse 		Brussels‐sprouts 
Bulgaar 		Bulgar Bulgarian 
Bulgaars 		Bulgarian 
Bulgarye 		Bulgaria 
Bybel 		Bible 
Caesar 		Caesar 
Calvyn 		Calvin 
Carthager 		Carthaginian 
Carthago 		Carthage 
Celebes 		Celebes 
Ceylon 		Ceylon 
Chileen 		Chilean 
Chileens 		Chilean 
Chili 		Chile 
China 		China 
Chinees 		Chinese 
Christelik 		Christian 
Christen 		Christian 
Christendom 		Christianity 
Christus 		Christ 
Cipries 		Cypriot Cypriote 
Ciprioot 		Cypriot 
Ciprus 		Cyprus 
Columbus 		Columbus 
Confucius 		Confucius 
Curaçao 		Curaçao 
Dardanelles 		Dardanelles Hellespont 
Deen 		Dane 
Deens 		Danish 
Denemarke 		Denmark 
Desember 		December 
Deuteronomium 		Deuteronomy 
Dinsdag 		Tuesday 
Dominikaans 		Dominican 
Donau 		Danube 
Donderdag 		Thursday 
Dories 		Dorian Doric 
Drakensberge 		Drakensberg Mountains 
Driekoninge 		Epiphany Twelfth‐night 
Driekoningefees 		Epiphany Twelfth‐night 
Duits 		German 
Duitser 		German 
Duitse 		German measles 
Duitse 		German German language 
Duitsland 		Germany 
Eden 		Eden 
Edenburg 		Edinburgh 
Egeïese 		Aegean Aegean Sea 
Egipte 		Egypt 
Egiptenaar 		Egyptian 
Egipties 		Egyptian 
Eksodus 		Exodus 
Elsasies 		Alsatian 
Elsasser 		Alsatian 
Engeland 		England 
Engels 		English 
Engelsman 		Englishman Sassenach 
Eskimo 		Eskimo 
Esperanto 		Esperanto 
Est 		Estonian 
Estland 		Estonia 
Ests 		Estonian 
Ethiopië 		Abyssinia Ethiopia 
Ethiopiër 		Ethiopian 
Etruries 		Etrurian Etruscan 
Etrurië 		Etruria 
Etruriër 		Etrurian Etruscan 
Etruskies 		Etrurian Etruscan 
Eufraat 		Euphrates 
Europa 		Europa 
Europeaan 		European 
Europees 		European 
Europese 		European bizon wisent 
Europeër 		European 
Eva 		Eva 
Februarie 		February 
Filippyns 		Philippine 
Filistyn 		Philistine 
Fin 		Finn 
Finland 		Finland 
Finlander 		Finn 
Fins 		Finnish 
Frankeland 		Franconia 
Frankies 		Frankish 
Frankryk 		France 
Frans 		French 
Franse 		French French language 
Fries 		Frisian 
Friesland 		Friesland 
Galicies 		Galician 
Gallië 		Gaul 
Genesis 		Genesis 
Geneve 		Geneva 
Gent 		Ghent 
Genua 		Genoa 
Germaan 		German Teuton 
Germaans 		Germanic Teutonic 
God 		God 
Goeie 		Good Friday 
Goties 		Gothic 
Goudkus 		Gold Coast 
Graal 		Grail 
Griek 		Greek 
Griekeland 		Greece 
Grieks 		Greek 
Groenland 		Greenland 
Groot‐Brittanje 		Britain Great Britain 
Guinee 		Guinea 
Gulde 		Golden Fleece 
Havanna 		Havana 
Hawaiï 		Hawaii 
Hawaïes 		Hawaiian 
Haïti 		Haiti 
Hebreeus 		Hebrew Jewish 
Hebreër 		Hebrew Jew 
Hebride 		Hebrides Western Islands 
Helleens 		Hellenian Hellenic 
Hellespont 		Dardanelles Hellespont 
Helvesië 		Helvetia 
Hemelvaartdag 		Ascension Day 
Hindoe‐ 		Hindu 
Hindoe 		Hindu 
Hindoes 		Hindu 
Holland 		Holland 
Hollander 		Dutchman Hollander 
Hollands 		Dutch 
Hongaar 		Hungarian 
Hongaars 		Hungarian 
Hongarye 		Hungary 
Hooglander 		Highlander 
Hooglied 		Canticles Song of Solomon Song of Songs 
Iberies 		Iberian 
Ier 		Irishman 
Ierland 		Ireland 
Iers 		Irish 
Indiaan 		Indian American Indian 
Indiaans 		Indian Red Indian 
Indies 		Indian 
Indiese 		tiger 
Indië 		India 
Indiër 		Indian 
Indo‐China 		Indo‐China 
Indo‐Europeaan 		Indo‐European 
Indo‐Europees 		Indo‐European 
Indo‐Europeër 		Indo‐European 
Indo‐Germaans 		Indo‐European Indo‐Germanic 
Indo‐Sjina 		Indo‐China 
Indonesies 		Indonesian 
Indonesië 		Indonesia 
Indonesiër 		Indonesian 
Ionies 		Ionian 
Iraaks 		Iraqi Iraquian 
Irak 		Iraq 
Irakiër 		Iraqi Iraquian 
Iran 		Iran Persia 
Iranies 		Iranian 
Iraniër 		Iranian Persian 
Islam 		Islam 
Islamities 		Islamic 
Israel 		Israel 
Israeli 		Israelian 
Israelies 		Israelian 
Israeliet 		Hebrew Jew 
Israelities 		Israelite Israelitish 
Istanboel 		Istanbul 
Italiaan 		Italian 
Italiaans 		Italian 
Italianer 		Italian 
Italië 		Italy 
Jamaika 		Jamaica 
Januarie 		January 
Japan 		Japan 
Japannees 		Japanese 
Japanner 		Japanese 
Japans 		Japanese 
Java 		Java 
Javaan 		Javanese 
Javaans 		Javan Javanese 
Jehova 		Jehovah 
Jerusalem 		Jerusalem 
Johannesburg 		Johannesburg 
Jood 		Hebrew Jew 
Joods 		Jewish 
Jordaan 		Jordan 
Josef 		Joseph 
Julie 		July 
Junie 		June 
Kaapprovinsie 		Cape Province 
Kaaps 		Cape 
Kaapstad 		Cape Town 
Kaap 		Cape of Good Hope 
Kain 		Cain 
Kalifornië 		California 
Kalvarieberg 		Calvary Golgotha 
Kameroen 		Cameroon 
Kanada 		Canada 
Kanadees 		Canadian 
Kanaries 		Canary 
Kanariese 		Canary Islands 
Kapitool 		Capitol 
Karmeliet 		Carmelite 
Karpate 		Carpathians Carpathian mountains 
Kaspiese 		Caspian Sea 
Kastiliaans 		Castillian 
Kaukasus 		Caucasus 
Kaïro 		Cairo 
Kelt 		Celt 
Kelties 		Gaelic 
Kenia 		Kenya 
Kersfees 		Christmas Christmas feast 
Kersmis 		Christmas Christmas feast 
Kersvader 		Father Christmas 
Keulen 		Cologne 
Klein‐Asië 		Asia Minor 
Kongo 		Congo Zaire 
Konstantinopel 		Istanbul 
Kopenhagen 		Copenhagen 
Korinthies 		Corinthian 
Kremlin 		Kremlin 
Kreta 		Crete 
Krim 		Crimea 
Krisjna 		Krishna 
Kroaat 		Croat 
Kroasië 		Croatia 
Kroaties 		Croatian 
Kruisberg 		Calvary Golgotha 
Kuba 		Cuba 
Kubaan 		Cuban 
Lap 		Laplander Lapp 
Lapland 		Lapland 
Laplander 		Laplander Lapp 
Laplands 		Lapp Lappish 
Latyn 		Latin 
Latyns 		Latin 
Leiden 		Leyden 
Let 		Latvian Lett 
Letland 		Latvia 
Lets 		Latvian Lettish 
Libanon 		Lebanon 
Liberië 		Liberia 
Libies 		Libyan 
Libië 		Libya 
Libiër 		Libyan 
Lissabon 		Lisbon 
Litaue 		Lithuania 
Litauer 		Lithuanian 
Litaus 		Lithuanian 
Londen 		London 
Lotaringe 		Lorraine Lothringen 
Lucifer 		Lucifer 
Luik 		Liège 
Lusern 		Lucerne 
Lyfland 		Livonia 
Lyflands 		Livonian 
Maandag 		Monday 
Maart 		March 
Macedonië 		Macedonia 
Machiavelli 		Machiavelli 
Madagaskar 		Madagascar 
Madonna 		Madonna 
Madrid 		Madrid 
Malakka 		Malacca 
Maleis 		Malay 
Malta 		Malta 
Maltees 		Maltese 
Malteser 		Maltese 
Mantsjoerye 		Manchuria 
Maria‐ligmis 		Candlemas 
Marokkaan 		Moroccan 
Marokkaans 		Moroccan 
Marokko 		Morocco 
Mei 		May 
Mekka 		Mecca 
Melanesies 		Melanesian 
Melanesië 		Melanesia 
Melanesiër 		Melanesian 
Mexikaans 		Mexican 
Mexiko 		Mexico 
Moedermaagd 		Madonna 
Mohammedaans 		Islamic 
Mohammedanisme 		Islam 
Mongolië 		Mongolia 
Montenegro 		Montenegro 
Montenegryn 		Montenegrin 
Montenegryns 		Montenegrin 
Mosambiek 		Mozambique 
Moskowiet 		Muscovite 
Namen 		Namur 
Namibië 		Namibia 
Ndebele 		Ndebele 
Nederduits 		Low German 
Nederlander 		Dutchman 
Nederlands 		Dutch 
Nguni 		Nguni 
Nigeria 		Nigeria 
Noor 		Norwegian 
Noord‐Amerika 		North America 
Noordpool 		Arctic the Arctic 
Noors 		Norwegian 
Noorweegs 		Norwegian 
Noorweë 		Norway 
Noorweër 		Norwegian 
November 		November 
Nuwejaarsdag 		New Year's Day 
Oekraine 		Ukraine the Ukraine 
Oekrainer 		Ukrainian 
Oekrains 		Ukrainian 
Oktober 		October 
Oos‐Duitsland 		East Germany GDR 
Oossee 		Baltic Sea 
Oostenryk 		Austria 
Oostenryker 		Austrian 
Oostenryks 		Austrian 
Openbaring 		Apocalypse 
Oranje‐Vrystaat 		Orange Free State 
Oranje 		Orange 
Paasfees 		Easter 
Parys 		Paris 
Pase 		Easter 
Peking 		Peiping Peking 
Persies 		Persian 
Persiese 		Persian Gulf 
Persië 		Iran Persia 
Pietermaritzburg 		Pietermaritzburg 
Pireneë 		Pyrenees 
Platduits 		Low German 
Pole 		Poland 
Pool 		Pole 
Pools 		Polish 
Portugees 		Portuguese 
Pretoria 		Pretoria 
Roemeen 		Romanian 
Roemenië 		Romania 
Roemeniër 		Romanian 
Rome 		Rome 
Rooihuid 		Indian American Indian 
Rus 		Russian 
Rusland 		Russia 
Russies 		Russian 
Sardinies 		Sardinian 
Satan 		Lucifer Satan 
September 		September 
Serwies 		Serb 
Serwië 		Serbia 
Serwiër 		Serb 
Siamees 		Siamese 
Sint 		Saint Helena 
Sjina 		China 
Sjinees 		Chinese 
Skot 		Scot Scotsman 
Skotland 		Scotland 
Skots 		Scottish 
Slams 		Islamic 
Slovenië 		Slovenia 
Slowaak 		Slovak 
Slowaaks 		Slovak 
Slowakies 		Slovak 
Slowakye 		Slovakia 
Sloween 		Slovene Slovenian 
Sloweens 		Slovenian 
Soedan 		Sudan 
Sondag 		Sunday 
Spaans 		Spanish 
Spaanse 		Spanish Spanish language 
Spanje 		Spain 
Steenbok 		Capricorn 
Suid‐Afrika 		South Africa 
Suid‐Afrikaans 		South African 
Suid‐Afrikaner 		South African 
Suid‐Amerika 		South America 
Suidelike 		Antarctic Ocean 
Suidpool‐ 		Antarctic 
Swart 		Black Sea Euxine Sea 
Swede 		Sweden 
Sweed 		Swede 
Sweeds 		Swedish 
Switser 		Swiss 
Switserland 		Helvetia 
T‐hemp 		T‐shirt 
TV 		television TV 
Transkei 		Transkei 
Transvaal 		Transvaal the Transvaal 
Transvaals 		Transvaalian 
Tsjeg 		Czech 
Tsjeggies 		Czech 
Tsjeggo‐Slowakye 		Czechoslovakia 
Turk 		Turk 
Turks 		Turkish 
Turkye 		Turkey 
‐loos 		‐less un‐ 
VSA 		United States of America USA 
Vaal 		Vaal 
Vatikaan 		Vatican the Vatican 
Venezolaan 		Venezuelan 
Venezolaans 		Venezuelan 
Venezuela 		Venezuela 
Venus 		Venus 
Versoendag 		Day of Atonement Feast of Expiation 
Vietnamees 		Vietnamese 
Vlaams 		Flemmish 
Vlaandere 		Flanders 
Vlaming 		Flemming 
Vlissingen 		Flushing 
Vrouedag 		Candlemas 
Vrydag 		Friday 
Vrystaat 		Orange Free State 
Waleland 		Wallonia 
Walhalla 		Valhalla 
Wallies 		Welsh 
Wallis 		Wales 
Walliser 		Welshman 
Weens 		Vienna Viennese 
Westers 		western 
Woensdag 		Wednesday 
Wolga 		Volga 
Xhosa‐ 		Xhosa 
Xhosa 		Xhosa 
Xhosavrou 		Xhosa woman 
Ysland 		Iceland 
Yslander 		Icelander 
Yslands 		Icelandic 
Yssee 		Arctic Ocean 
Zambia 		Zambia 
Zeus 		Zeus 
Zimbabwe 		Zimbabwe 
Zoeloe 		Zulu Zulu language 
... 		... to from ... to of ... to 
... 		... ago 
... 		feel ... 
a 		ah oh ow 
aag 		ah oh ow 
aai 		ah oh ow 
aak 		barge 
aaklig 		bleak dismal dreary horrible ghastly grisly nasty 
aakligheid 		abomination 
aal 		eel 
aalagtig 		eel‐like 
aalbessie 		currant 
aalbessiebos 		currant currant bush 
aalbessiesap 		currant juice 
aalbessievla 		currant custard 
aalfuik 		eel‐pot eel‐trap 
aalmoes 		alms charity 
aalmoesenier 		chaplain army chaplain padre 
aalmoeseniershuis 		almshouse workhouse 
aalmoesenierskap 		almonership 
aalmoeskassie 		alms‐box 
aalpastei 		eel‐pie 
aalsvel 		eelskin 
aaltjie 		nematode 
aalverkoper 		eelmonger 
aalvissery 		eel‐fishing 
aalvormig 		anguilliform eel‐shaped 
aalwee 		aloe 
aalweeagtig 		aloetic 
aalwurm 		nematode 
aalwyn 		aloe 
aalwynagtig 		aloetic 
aalwynbitter 		aloin 
aalwynhout 		eaglewood 
aalwynsap 		aloe juice 
aalwyntapper 		aloe juice collector 
aam 		aum 
aambeeld 		anvil incus 
aambeeldbeentjie 		anvil incus 
aambeeldbeitel 		hardy 
aambeeldvoël 		small woodpecker 
aambei 		haemorrhoid hemorrhoid pile 
aambeie 		haemorhoids 
aambeipoeier 		pile powder 
aamborstig 		asthmatic wheezy 
aamborstigheid 		asthma shortness of breath wheeziness 
aan 		at to toward towards 
aanbehoort 		belong to 
aanbel 		give a ring ring ring the bell 
aanbesteding 		tender 
aanbestee 		invite tenders for put out to tender 
aanbetref 		concern 
aanbetrou 		confide have confidence in trust entrust 
aanbeveel 		commend recommend 
aanbeveelbaar 		recommendable 
aanbevelenswaardig 		recommendable 
aanbeveling 		recommendation 
aanbid 		adore worship 
aanbidbaar 		adorable 
aanbiddelik 		adorable 
aanbidding 		adoration worship 
aanbied 		bid offer make an offer of 
aanbieding 		offer 
aanblaas 		fan blow 
aanblik 		appearance aspect look sight view 
aanbly 		remain stay stay over 
aanbod 		offer 
aanboor 		bore broach sink strike tap 
aanbou 		add 
aanbrand 		stick to the pan 
aanbrandsteker 		lighter 
aanbreek 		break into broach cut into 
aanbring 		bring fetch 
aand 		evening 
aandag 		acuity advertence advertency attention 
aandagtig 		attentive 
aandagtiglik 		attentively 
aandag 		pay attention to take account of take into account 
aandag 		draw attention 
aandag 		advance put forward 
aandblad 		evening paper 
aandeel 		share 
aandeelhebber 		shareholder 
aandeelhouer 		shareholder 
aandeel 		registered share 
aandelekapitaal 		share‐capital 
aandenking 		keepsake memento souvenir 
aandete 		evening meal supper 
aandgebed 		night prayers 
aandgrou 		dusk 
aandien 		advertise announce give notice 
aandiening 		ad advertisement 
aandjapon 		evening frock evening gown 
aandklok 		curfew 
aandkoerant 		evening paper 
aandkostuum 		evening dress 
aandoen 		affect 
aandoening 		affection 
aandoenlik 		affecting moving touching 
aandra 		bring fetch 
aandraag 		bring fetch 
aandraai 		fasten tighten turn turn on 
aandrang 		insistence pressure urgency 
aandrif 		access impetus impulse 
aandring 		insist 
aandruk 		press press firmly 
aandryf 		be washed ashore 
aandryfas 		drive shaft driving axle 
aandrywe 		be washed ashore 
aandrywing 		drive 
aandskemering 		dusk 
aandskool 		evening classes evening‐school night‐school 
aandui 		indicate suggest 
aanduiding 		indication 
aandurf 		dare to fight stand up to 
aaneen‐ 		co‐ fellow 
aaneen 		together 
aaneenbind 		connect join 
aaneenskakeling 		order 
aaneenvoeg 		join unite 
aanerd 		earth earth up hill hill up 
aanfluiting 		mockery 
aangee 		accuse denounce 
aangenaam 		agreeable enjoyable lovely nice pleasant 
aangenome 		adopted 
aangesien 		because for the reason that 
aangeskote 		tipsy 
aangetroud 		by marriage ‐in‐law 
aangetroude 		brother‐in‐law 
aangewing 		accusation 
aangifte 		declaration proclamation statement 
aangrensend 		adjacent adjoining 
aangry 		move stir 
aanhaal 		cite quote 
aanhaling 		citation quotation 
aanhalingstekens 		quotation marks quotes 
aanhang 		adherents disciples following party supporters 
aanhanklik 		affectionate devoted selfless 
aanhanklikheid 		adherence affection attachment 
aanhef 		intone raise 
aanhou 		breed keep raise rear 
aanhoudelik 		abiding lasting 
aanhoudend 		abiding lasting 
aanhouding 		apprehension arrest detention 
aanhê 		wear 
aankla 		accuse 
aanklaag 		accuse 
aanklae 		accuse 
aanklaer 		accuser 
aanklag 		accusal accusation 
aankoms 		arrival 
aankondig 		advertise announce give notice 
aankondiger 		advertiser 
aankondiging 		ad advertisement 
aankoop 		acquisition purchase 
aankweek 		cultivate grow 
aankyker 		spectator 
aanland 		end up 
aanleghawe 		port of call 
aanlegplek 		landing‐stage pier 
aanleiding 		inducement motive occasion 
aanlok 		attract draw 
aanloklik 		attractive 
aanloklikheid 		attraction attractiveness charm 
aanloksel 		attraction 
aanlonk 		make eyes at ogle stare at 
aanloop 		run 
aanloophawe 		port of call 
aanlê 		land 
aanlêhawe 		port of call 
aanlêplaas 		landing‐stage pier 
aanlêplek 		landing‐stage pier 
aanmaak 		making manifacture 
aanmaan 		admonish scold 
aanmaning 		admonition exhortation 
aanmaningsbrief 		dunning‐letter 
aanmerklik 		considerable sizable 
aanminlik 		charming lovely 
aanmoedig 		encourage 
aanmoediging 		encouragement 
aanneem 		accept receive take take in 
aanneembaar 		acceptable 
aanneemlik 		acceptable 
aannemer 		builder contractor building contractor master builder 
aanpak 		attempt test try 
aanpas 		try on 
aanpasbaar 		adaptable 
aanplak 		placard post post up 
aanplakbiljet 		notice placard poster 
aanplakbord 		bill‐board notice‐board 
aanprys 		commend recommend 
aanprysing 		recommendation 
aanraai 		advise counsel 
aanraak 		touch 
aanrading 		advice counsel 
aanraking 		touch 
aanrand 		assault violate 
aanrander 		assailant assaulter 
aanranding 		assault 
aanreg 		dresser 
aanroep 		appeal to invoke 
aans 		maybe mayhap perchance perhaps possibly 
aansien 		appearance aspect look sight view 
aansienlik 		considerably 
aansies 		maybe mayhap perchance perhaps possibly 
aansig 		appearance aspect look sight view 
aansit 		put on 
aanskakel 		put on start switch on turn on 
aanskerp 		sharpen 
aanslag 		assault 
aansluit 		join 
aansluiting 		connection 
aansoek 		ambition aspiration 
aansoek 		aspire aspire to hope for 
aanspreeklik 		accountable responsible 
aanstaande 		close near nearby next 
aansteker 		lighter 
aanstel 		appoint 
aanstelling 		appointment appointment to office 
aansterf 		inherit 
aanstoot 		jog nudge 
aansyn 		existence 
aansê 		advertise announce give notice 
aantal 		amount number 
aantas 		corrode 
aanteken 		record register 
aantekening 		annotation note 
aantonende 		indicative indicative mood 
aantoon 		demonstrate prove 
aantrek 		put on 
aantrekkingskrag 		attraction 
aantreklik 		attractive 
aantreklikheid 		attraction attractiveness charm 
aanvaar 		accept receive take take in 
aanvaarbaar 		acceptable 
aanvaarder 		acceptor 
aanvaarding 		acceptance admission 
aanval 		assault attack 
aanvaller 		aggressor assailant attacker 
aanvallig 		charming lovely 
aanvalligheid 		charm 
aanvang 		begin commence start 
aanvanger 		beginner 
aanvangsalaris 		commencing salary 
aanvangsletter 		initial 
aanvangsnelheid 		initial velocity 
aanvanklik 		at first at the outset in the beginning 
aanvanklike 		initial 
aanvul 		complete 
aanwesig 		present 
aan 		on the other hand 
aan 		kindle light 
aan 		me to me 
aan 		whom 
aap 		ape monkey 
aapagtig 		ape‐like apish monkey‐like 
aar 		ear 
aarbei 		strawberry 
aarbeiboom 		arbutus strawberry tree 
aarbeiboomvrug 		arbutus fruit 
aard 		character nature personality 
aardbewing 		earthquake 
aardbol 		globe worldglobe 
aarde 		ground soil 
aardgas 		natural gas 
aardgees 		brownie gnome goblin 
aardgordel 		zone 
aardhommel 		bumblebee 
aardig 		pretty 
aardkloot 		globe worldglobe 
aardkunde 		geology 
aardkundig 		geological 
aardkundige 		geologist 
aardmannetjie 		brownie gnome goblin 
aardrykskunde 		geography 
aardrykskundig 		geographic geographical 
aardrykskundige 		geographer 
aards 		earthen earthly terrestrial 
aardskok 		earthquake shock 
aardskudding 		earthquake 
aardtrilling 		earthquake 
aardverskuiwing 		landslide 
aardwolf 		aardwolf 
aars 		anus arse 
aartappel 		potato 
aartappelmeel 		potato flour 
aartsbisdom 		archbishopric 
aartsbiskop 		archbishop 
aartsdom 		as stupid as an ass 
aartsengel 		archangel 
aartsherog 		archduke 
aartshertogdom 		archduchy 
aartsvader 		patriarch 
aartsvyand 		arch‐enemy 
aarverkalking 		arteriosclerosis 
aas 		attraction 
aasvoël 		vulture 
ab 		abbot 
abakus 		abacus 
abattoir 		butcher's shop 
abc 		alphabet 
abdikasie 		abdication 
abdis 		abbess 
abdominaal 		abdominal 
abdy 		abbey 
abeel 		aspen 
ablatief 		ablative 
abnormaal 		abnormal 
abonnee 		subscriber 
abonnement 		subscription 
abonnent 		subscriber 
aborteur 		abortionist 
absensie 		absence non‐attendance 
absent 		absent 
abses 		abscess 
absint 		absinth 
absolutisme 		absolutism 
absorpsie 		absorption 
abstraheer 		abstract 
abstrak 		abstract 
absurd 		absurd 
absurditeit 		absurdity nonsense rubbish 
abuis 		aberration error mistake 
abusieflik 		by mistake 
achternadraai 		result 
acre 		acre 
adagio 		adagio 
adamsappel 		Adam's apple 
adder 		adder viper 
adekwaat 		adequate 
adel 		nobility 
adelaar 		eagle 
adelik 		of noble birth 
adem 		breath 
ademhaling 		respiration 
ademloos 		breathless 
adieu 		adieu farewell bye goodbye 
adjektief 		adjective 
adjektiwies 		adjectival 
administrasie 		administration management 
administrateur 		manager 
administratief 		administrative 
administreer 		administer manage 
admiraal 		admiral 
adopsie 		adoption 
adoptief 		adoptive 
adoreer 		adore worship 
adrenalien 		adrenaline 
adrenaline 		adrenaline 
adres 		address 
adresboek 		address list 
adresseer 		address 
adresseermasjien 		addressing machine 
adresverandering 		change of address 
adverbiaal 		adverbial 
adverbium 		adverb 
adverteer 		advertise announce give notice 
advertensie 		ad advertisement 
advies 		notification notice 
adviseer 		advise counsel 
afasie 		aphasia 
afbreek 		break break off 
afdeling 		branch compartment department pigeonhole section speciality 
afdelingswinkel 		warehouse 
afding 		bargain haggle 
afdwaal 		go astray stray off 
affiks 		affix 
affiniteit 		affinity 
affêre 		affair business business deal case matter 
affêring 		affair business business deal case matter 
afgaan 		descend get off go down 
afgee 		spread 
afgelope 		last 
afgod 		idol 
afgrond 		abyss chasm gulf precipice 
afgryse 		abhorrence abomination horror 
afgryslik 		agonizing hideous horrible ghastly 
afguns 		envy 
afgunstig 		envious 
afhaal 		take off put off 
afhanklik 		dependent 
afhanklikheid 		dependence 
afkappingsteken 		apostrophe 
afklim 		get out get out of a car 
afkomstig 		coming 
afkondig 		issue proclaim 
aflewer 		deliver furnish supply 
aflewering 		delivery 
afmeting 		dimension measurement 
afneem 		decrease decline wane 
afoes 		harvest 
aforisme 		aphorism 
afraai 		advise against dissuade from 
afrikanertjie 		African marigold 
afroep 		call over 
afrond 		round round off 
afroom 		cream skim 
afros 		thrash 
afruim 		do away with get rid of remove 
afruk 		pick pluck tear off 
afry 		drive away drive off 
afsegging 		abolition abrogation 
afsend 		dispatch send off ship 
afsender 		sender 
afset 		demand sale 
afsetgebied 		market sales activity 
afsetter 		extortioner swindler 
afsettery 		swindle swindling 
afsien 		abandon give up resign renounce 
afsien 		relinquish renounce waive 
afsigtelik 		dismal dreary horrible nasty 
afsit 		deposit 
afsitting 		amputation 
afskaduwing 		adumbration shadow 
afskaf 		abolish abrogate 
afskaffer 		teetotaller total abstainer 
afskaffing 		abolition abrogation 
afskakel 		cut cut a connection 
afskeep 		put off send about his business 
afskeer 		shave shave off 
afskei 		divide separate 
afskeid 		farewell goodbye good‐bye 
afskeiding 		separation partition 
afskeids‐ 		goodbye‐ 
afskeid 		say goodbye say goodbye to take leave take leave from 
afskerm 		screen 
afskeur 		pick pluck tear off 
afskeuring 		schism 
afskiet 		discharge fire fire off let off 
afskil 		shell peel 
afskilder 		paint 
afskilfer 		flake off peel off scale off 
afskrif 		copy 
afskrik 		abhorrence abomination horror 
afskrikwekkend 		deterrent forbidding 
afskryf 		amortize deaden 
afskud 		shake off 
afskuim 		skim 
afskuiwe 		abdicate 
afskuwelik 		abhorrent abominable alien awful hideous horrible gruesome 
afslaan 		turn 
afslaer 		auctioneer 
afslag 		abatement discount rebate 
afsluit 		bar obstruct 
afsluiting 		dam 
afslyt 		wear away wear off wear out 
afsnou 		snap at snarl at snub 
afsny 		cut off 
afsoek 		search 
afsoen 		kiss and be friends again 
afsonder 		divide separate 
afsondering 		isolation separation 
afsonderlik 		apart particular separate special 
afsper 		bar obstruct 
afsplits 		split off 
afspoel 		gargle rinse 
afspraak 		accommodation accord agreement 
afspreek 		agree 
afspring 		jump off leap down 
afstaan 		cede give in give up give way relinquish yield 
afstam 		accrue come derive originate result 
afstammeling 		offspring successor 
afstand 		abdication 
afstandsbediening 		remote control 
afstandsbeheer 		remote control 
afstand 		cede give in give up give way relinquish yield 
afstap 		descend get off go down 
afsteek 		cut off 
afstel 		fail neglect omit 
afstem 		reject 
afstempel 		mark stamp 
afsterf 		die away fail 
afsterwe 		die away fail 
afstewen 		bear down make 
afstof 		dust 
afstomp 		dull 
afstootlik 		repellent repelling repulsive 
afstroop 		harry ravage 
afstudeer 		finish one's studies 
afstuit 		rebound 
afstyg 		dismount 
afsweer 		abjure abnegate 
afswering 		abjuration 
afsydig 		apart particular separate special 
afsê 		cancel countermand 
aftak 		branch 
aftakking 		branching 
aftandig 		decayed decrepit dilapidated lapsed rickety 
aftands 		decayed decrepit dilapidated lapsed rickety 
aftap 		derive 
aftapkraan 		drain‐cock 
afteken 		design draw 
aftel 		count down 
aftelefoneer 		cancel by telephone countermand by telephone 
aftog 		retreat 
aftreding 		resignation 
aftree 		resign 
aftrek 		demand sale 
aftrekbaar 		deductible 
aftrekgetal 		subtrahend 
aftrekker 		subtrahend 
aftrekking 		subtraction 
aftreksel 		extract infusion 
aftreksom 		subtraction sum 
aftroef 		trump 
afvaardig 		depute 
afvaart 		departure 
afval 		apostatize 
afvallig 		apostate 
afvallige 		apostate 
afvalproduk 		waste product 
afvalwater 		effluent 
afvee 		delete wipe wipe off 
afveeg 		delete wipe wipe off 
afvloei 		flow down flow off 
afvoer 		carrying off discharge 
afvoerbuis 		drain‐pipe outlet‐pipe waste‐pipe 
afvoerder 		abductor 
afvuur 		discharge fire fire off 
afwaarts 		down 
afwag 		bide abide stay for wait await wait for 
afwagting 		expectation 
afwater 		drain 
afwatering 		draining 
afweer 		defend 
afwen 		break of a habit teach 
afwend 		turn away 
afwentel 		roll off 
afwerk 		finish work out 
afwerking 		finishing off 
afwerp 		cast off fling off throw off 
afwesig 		absent 
afwesige 		absentee 
afwesigheid 		absence non‐attendance 
afwesig 		be absent be missing 
afwikkel 		conclude dispatch expedite finnish settle 
afwikkeling 		unrolling unwinding 
afwimpel 		reject 
afwis 		delete wipe wipe off 
afwyk 		deviate 
afwyking 		abnormity anomaly 
afwys 		reject 
afwysing 		rejection 
ag 		acuity advertence advertency attention 
agaat 		agate 
agarm 		octopus 
agbaar 		respectable 
ageer 		act take action 
agenda 		agenda appointment book 
agent 		agent 
agentskap 		agency 
agentuur 		agency 
agglomeraat 		agglomerate 
aggregaat 		aggregate 
aggressie 		aggression aggro 
aggressief 		aggressive 
aghoek 		octagon 
agio 		premium 
agitasie 		agitation commotion 
agitator 		agitator 
agiteer 		abet agitate incite stir up 
agiteerder 		agitator 
agnosties 		agnostic 
agnostikus 		agnostic 
agorafobie 		agoraphobia 
agrariër 		agrarian farmer 
agronomie 		agriculture agronomics 
agronomies 		agricultural 
agronoom 		agriculturist 
agste 		eighth 
agtal 		number of eight 
agtallig 		octal 
agtarm 		octopus 
agteloos 		careless negligent 
agteloosheid 		carelessness negligence 
agtelosig 		careless negligent 
agtelosigheid 		carelessness negligence 
agtenswaard 		respectable 
agtenswaardig 		respectable 
agter 		behind after 
agteraan 		at the back behind in the rear 
agteras 		back axle hind axle rear axle 
agterbalkon 		rear platform 
agterbank 		back seat rear seat 
agterbly 		be kept in be detained remain stay on 
agterblyer 		laggard straggler 
agterboeg 		poop poopdeck stern 
agterbuurt 		back street slum 
agterdeel 		back rear 
agterdeur 		back‐door 
agterdog 		suspicion 
agterdogtig 		suspicious 
agtereen 		at a strech for ... together on end 
agtereenvolgens 		consecutively 
agterent 		back part hind part 
agtergedeelte 		back rear 
agtergrond 		background 
agterhoede 		rear rearguard 
agterhoof 		back of the head occiput 
agterhou 		hold back keep back withhold 
agterin 		behind 
agterkant 		back rear 
agterklap 		backbiting scandal slander 
agterkleindogter 		greatgranddaughter 
agterkleinkind 		greatgrandchild 
agterkleinseun 		greatgrandson 
agterlaag 		ambush 
agterlaat 		leave behind 
agterlamp 		rear‐lamp rear‐light tail‐light 
agterland 		hinterland 
agterlig 		rear‐lamp rear‐light tail‐light 
agterlik 		backward mentally deficient retarded 
agterlikheid 		backwardness 
agterloop 		be late 
agterlosig 		careless negligent 
agtermiddag 		afternoon 
agternaam 		surname 
agternadoen 		imitate 
agternadraai 		consequence consistency 
agternagaan 		run after 
agterneef 		second cousin 
agternig 		second cousin 
agterniggie 		second cousin 
agteroor 		backward on one's back 
agteroorval 		fall backwards 
agterraam 		rear window 
agterskip 		poop poopdeck stern 
agterstallig 		back outstanding overdue 
agterstand 		arrears 
agterste 		last 
agtersten 		poop poopdeck stern 
agterstevoor 		back to front 
agterstewe 		poop poopdeck stern 
agteruit 		backward backwards 
agteruitboer 		decline recede 
agteruitgaan 		decline recede 
agteruitgang 		rear‐exit 
agteruitkykspieël 		driving mirror 
agtervoegsel 		affix 
agtervolg 		chase persecute prosecute pursue 
agterwaarts 		backward backwards 
agterweë 		fail to appear 
agterweë 		fail neglect omit 
agterwiel 		back wheel hind wheel rear wheel 
agterwyk 		back street slum 
agter 		be late 
agthoek 		octagon 
agtien 		eighteen 
agtiende 		eighteenth 
agting 		esteem regard 
agtste 		eighth eighth part 
agttal 		number of eight 
agttallig 		octal 
agtvoudig 		eightfold octuple 
agurk 		gherkin 
agurkie 		gherkin 
agvoudig 		eightfold octuple 
ag 		advert pay attention pay attention to watch out for 
ahorn 		maple sycamore 
ai 		ouch ow 
aikôna 		not at all 
air 		appearance aspect look sight view 
akademie 		academy 
akademielid 		academician 
akant 		acanthus 
akasia 		acacia 
akelei 		columbine 
akka 		dung excrement 
akkedis 		lizard 
akkeldis 		lizard 
akker 		field 
akkerboom 		oak 
akkerbou 		agriculture farming tillage 
akkerdis 		lizard 
akkermonie 		agrimony 
akkerwinde 		lesser bindweed 
akklamasie 		acclaim acclamation approval 
akklimatisasie 		acclimatization 
akklimatiseer 		acclimatize 
akklimatisering 		acclimatization 
akkommodasie 		accommodation 
akkomodasie 		accoutrement accoutrements equipment 
akkompanjeer 		accompany 
akkompanjement 		accompaniment 
akkompanjis 		accompanist companian 
akkoord 		accord accordance agreement concurrence 
akkordeon 		accordion 
akkrediteer 		accredit 
akkumulasie 		accumulation 
akkumulator 		accumulator battery storage battery 
akkumuleer 		accumulate heap pile up stack 
akkuraat 		accurate on time prompt punctual 
akkuraatheid 		accuracy exactitude precision 
akkusatief 		accusative 
akne 		acne 
akoestiek 		acoustics 
akoesties 		acoustic 
akoliet 		acolyte 
akoniet 		aconite monkshood 
akrobaat 		acrobat 
akrobaties 		acrobatic 
akroniem 		acronym 
akselerasie 		acceleration 
akselerator 		accelerator accelerator pedal 
aksent 		accent stress 
aksenteken 		accent mark supersign 
aksentueer 		accent accentuate stress 
akseptabel 		acceptable 
akseptant 		acceptor 
aksepteer 		accept receive take take in 
aksidenteel 		accidental 
aksie 		action activity 
aksioma 		axiom 
aksionaris 		shareholder 
aksioom 		axiom 
aksyns 		excise excise‐duty 
akteur 		actor 
aktief 		active in action 
aktinie 		sea‐anemone 
aktinium 		actinium 
aktiveer 		activate put on start swotch on turn on 
aktivis 		activist agitator 
aktiwiteit 		activity vigour 
aktrise 		actress 
aktualiteit 		topicality 
aktuaris 		actuary 
aktueel 		current present present‐day topical up‐to‐date 
akwadukt 		aqueduct 
akwamaryn 		aquamarine 
akwarel 		water‐colour 
akwarium 		aquarium 
al 		already by now yet 
alarm 		alarm 
alarmeer 		alarm raise the alarm sound the alarm 
albas 		alabaster 
albatros 		albatross 
albe 		alb 
albei 		both 
albino 		albino 
album 		album 
alchemie 		alchemy 
alchemis 		alchemist 
aldaar 		at that place there 
aldehide 		aldehyde 
aldehied 		aldehyde 
aldeur 		constantly continually continuously 
aleenverteenwoordiger 		sole agent 
alfa 		alpha 
alfabet 		alphabet 
alfabeties 		alphabetical 
alg 		alga seaweed 
alge 		alga seaweed 
algebra 		algebra 
algebraïes 		algebraic 
algemeen 		general usual 
algemeenheid 		generality universality 
alhaas 		soon 
alhoewel 		though although 
alibi 		alibi 
alimentasie 		alimony 
alinea 		paragraph 
aljare 		yearly 
alkohol 		alcohol 
alkoholgehalte 		alcoholic content 
alkoholies 		alcoholic 
alkoholis 		alcoholic 
alkoholisme 		alcoholism 
alkoholvry 		non‐alcoholic 
alle 		all 
alledaags 		commonplace dismal trite 
allee 		avenue 
alleen 		exclusively just only 
alleenhandel 		monopoly 
alleenheerser 		absolute ruler autocrat 
alleenheerskapy 		absolute power absolute rule autocracy 
alleenspraak 		monologue soliloquy 
alleenverkoop 		monopoly 
allegaartjie 		hotchpotch medly 
allegorie 		allegory 
allegories 		allegoric 
allengs 		gradually little by little 
allengskens 		gradually little by little 
allenig 		alone only sole solitary 
aller 		everyone's 
alleraardigst 		most charming 
allerbekoorliks 		most charming 
allergie 		allergy 
allergies 		allergic 
allerhande 		all every kind of 
allerlei 		all every kind of 
allerweë 		all about everywhere 
alles 		all altogether everything 
allesbehalwe 		not at all 
allesbeheersend 		of paramount importance predominating 
allesins 		in every way 
alliansie 		alliance 
alliasie 		alloy 
allig 		maybe mayhap perchance perhaps possibly 
alligator 		alligator 
alliterasie 		alliteration 
allo 		hello 
allooi 		alloy 
allure 		airs 
alluviaal 		alluvial 
alluvie 		alluvion alluvium 
alluvio 		alluvion alluvium 
alluvium 		alluvion alluvium 
almag 		omnipotence 
almal 		everyone's 
almanak 		almanac 
almeteens 		at once immediately just right away right now 
alom 		all about everywhere 
alomteenwoordig 		omnipresent ubiquitous 
alomvattend 		general universal worldwide 
alpakka 		alpaca 
alpbok 		ibex 
alperoos 		Alpenrose rhododendron 
alpeviooltjie 		cyclamen 
alpinis 		Alpinist climber mountain climber mountaineer 
alras 		soon 
alreeds 		already by now yet 
alsem 		absinth 
also 		so such thus 
alt 		contralto contralto voice 
altaar 		altar 
altaardienaar 		acolyte 
altaarstuk 		altarpiece 
altans 		at least 
alteenwoordig 		omnipresent ubiquitous 
altemit 		maybe mayhap perchance perhaps possibly 
altemits 		maybe mayhap perchance perhaps possibly 
altemitters 		maybe mayhap perchance perhaps possibly 
alternatief 		alternative option 
altoos 		always ever 
altruïs 		altruist 
altruïsme 		altruism 
altruïsties 		altruistic 
altsanger 		alto contralto 
altstem 		contralto contralto voice 
altviool 		tenor violin viola 
altwee 		both 
altyd 		always ever 
altyddurend 		everlasting 
aluin 		alum 
aluminium 		aluminium aluminum 
alvermoë 		omnipotence 
alvleesklier 		pancreas 
alvorens 		before previous to 
alwaar 		where 
alwas 		even if 
alweer 		afresh again all over again anew 
alwetend 		all‐knowing omniscient 
al's 		all altogether everything 
al 		all 
amandel 		almond 
amanuensis 		laboratory assistent 
amarant 		amaranthus 
amasone 		Amazon 
amateur 		amateur fancier 
amateuragtig 		amateurish small‐time 
ambag 		handicraft occupation trade 
ambagsman 		artisan 
ambassade 		embassy 
ambassadeur 		ambassador 
ambassadrise 		ambassador female ambassador 
amber 		amber 
ambieer 		aspire aspire to hope for 
ambigeer 		doubt 
ambisie 		ambition 
ambisieus 		ambitious 
ambroos 		ambrosia 
ambrosyn 		ambrosia 
amebe 		amoeba 
amen 		amen 
amendeer 		amend 
amendement 		amendment 
amendering 		amendment 
amerikaniseer 		Americanize 
ametis 		amethyst 
ameublement 		furniture 
amfibie 		amphibian 
amfiteater 		amphitheatre 
amfora 		amphora 
amikaal 		friendly 
ammeter 		ammeter 
ammoniak 		ammonia 
ammonium 		ammonia 
ammunisie 		munition ammunition 
amnestie 		act of grace amnesty 
amok 		amuck 
amorf 		amorphous 
amortisasie 		redemption 
amortiseer 		amortize deaden 
amp 		function job office post 
amper 		barely hardly only just scarcely 
ampertjies 		barely hardly only just scarcely 
ampgenoot 		college 
amplitude 		amplitude 
ampsbroer 		colleague 
ampseed 		oath of office 
ampsgeheim 		official secret 
ampsgewaad 		robes of office 
ampsmisdryf 		abuse of power misfeasance 
ampswoning 		official residence 
amptelik 		official 
ampteloos 		private 
amptenaredom 		bureaucracy officialdom 
amptenary 		bureaucracy officialdom 
ampul 		bulb 
amputasie 		amputation 
amputeer 		amputate 
ampère 		ampère 
ampèremeter 		ammeter 
amulet 		amulet charm talisman 
amusant 		amusing entertaining funny 
amuseer 		amuse 
amusement 		entertainment 
anaal 		anal 
anachronisme 		anachronism 
anagram 		anagram 
anakonda 		anaconda 
analfabeet 		illiterate 
analis 		analyst analytical chemist 
analise 		analysis 
analiseer 		analyse 
analogie 		analogy 
analogies 		analogous 
analoog 		analogous 
ananas 		pineapple 
anapes 		anapaest 
anargie 		anarchy 
anargies 		anarchic anarchical anarchist 
anargis 		anarchist 
anargisme 		anarchism 
anatomie 		anatomy 
anatomies 		anatomical 
anatoom 		anatomist 
ander 		other another else 
anderland 		foreign country 
anderlander 		foreigner 
anders 		differently else 
andyvie 		endive 
anekdote 		anecdote 
anekdoties 		anecdotal 
anemie 		anaemia 
anemies 		anaemic 
anemoon 		anemone 
angel 		hook 
angelier 		carnation pink 
angina 		angina quinsy 
angskreet 		cry of distress 
angst 		agony anguish fear 
angstig 		horrible 
angsvallig 		accurate scrupulous 
angswekkend 		horrible 
aniline 		aniline 
animo 		soul 
anker 		anchor 
ankerplek 		anchorage moorage mooring 
anna 		ana anna 
anneksasie 		annexation 
annekseer 		annex 
annonseer 		advertise announce give notice 
annoteer 		comment 
annulleer 		abjure abolish abrogate annul cancel remit 
annullering 		abolition abrogation 
annuïteit 		instalment repayment 
anode 		anode 
anomalie 		abnormity anomaly 
anoniem 		anonymous 
anonimiteit 		anonymity 
anonymus 		anonymous writer 
anorganies 		inorganic 
ansjovis 		anchovy 
antenne 		aerial antenna 
antichris 		Antichrist 
antidoot 		antidote 
antiek 		ancient antique 
antiloop 		antelope 
antimonium 		antimony 
antimoon 		antimony 
antipatie 		aversion dislike 
antipatiek 		nasty 
antipode 		antipode 
antisemiet 		anti‐Semite 
antisemities 		anti‐Semitic 
antisemitisme 		anti‐Semitism 
antisepties 		antiseptic 
antisipasie 		anticipation 
antisipeer 		anticipate think ahead 
antisosiaal 		antisocial unsocial 
antrasiet 		anthracite 
antropologie 		anthropology 
antropoloog 		anthropologist 
antwoord 		answer reply respond 
anus 		anus arse 
anys 		anise 
aorta 		aorta 
apache 		apache hood ruffian 
apart 		apart particular separate special 
apartheid 		apartheid 
apatie 		apathy 
apaties 		apathetic 
apebroodboom 		baobab 
apekool 		nonsense 
apogeum 		acme 
apokalips 		apocalypse 
apokalipties 		apocalyptic 
apokrief 		apocryphal 
apopleksie 		fit apoplectic fit seizure stroke stroke of apoplexy 
apostaat 		apostate 
apostel 		apostle 
apostelskap 		apostleship apostolate 
apostolaat 		apostleship apostolate 
apostolies 		apostolic 
apostroof 		apostrophe 
apoteose 		apotheosis 
apparaat 		apparatus device set 
appartement 		apartment flat 
appel 		apple 
appelboom 		apple‐tree 
appeldrank 		cider 
appelkoos 		apricot 
appelkoosboom 		apricot‐tree 
appelleer 		appeal 
appelmoes 		apple‐sauce 
appeltert 		apple‐tart 
appelwyn 		cider 
appendisitis 		appendicitis 
applikant 		candidate 
apploudiseer 		acclaim applaud clap 
applous 		acclaim acclamation approval 
appèl 		appeal 
apropos 		by the way 
apteek 		chemist's shop drugstore 
apteker 		chemist 
aptyt 		appetite 
arabesk 		arabesque 
arak 		rack arrack 
arapapegaai 		macaw 
araroet 		arrowroot 
arbei 		work 
arbeid 		job work 
arbeider 		hand laborer labourer operative worker working man workman 
arbeidsaam 		active hardworking 
arbeidsaamheid 		activity 
arbeidsloos 		unemployed 
arbeidsloosheid 		unemployment 
arbeidsmark 		labor market labour market 
arbeidster 		female laborer femal labourer femal worker 
are 		are square decametre 
area 		area 
arena 		arena 
arend 		eagle 
arendsjong 		eaglet 
arendsneus 		aquiline nose 
argaïes 		archaic 
argaïsme 		archaism 
argeologie 		archaeology 
argeologies 		archaeological 
argeoloog 		archaeologist 
argiefbewaarder 		archivist keeper of the records 
argipel 		archipelago 
argitek 		architect 
argitektuur 		architectonic architectural 
argitraaf 		architrave 
argivaris 		archivist keeper of the records 
argon 		argon 
argument 		argument plea 
argumenteer 		maintain 
argwaan 		suspicion 
argwanend 		suspicious 
aria 		air aria 
aristokraat 		aristocrat 
aristokrasie 		aristocracy 
aristokraties 		aristocratic 
ark 		ark 
arm 		arm 
armband 		bracelet 
arme 		pauper poor man 
armhorlosie 		watch wrist‐watch 
armoede 		poverty 
arnika 		arnica 
aroma 		aroma flavour 
aronskelk 		arum 
arrestant 		arrested person prisoner 
arrestasie 		apprehension arrest detention 
arresteer 		arrest 
arrogant 		arrogant 
arsenaal 		armoury arsenal 
arterie 		artery 
arteriosklerose 		arteriosclerosis 
artesies 		artesian 
artikel 		article commodity 
artillerie 		artillery 
artilleris 		artilleryman gunner 
artis 		artist 
artisjok 		artichoke 
artistiek 		artistic 
artritis 		arthritis 
arts 		doctor physician 
artseny 		drug medicine pharmaceutical 
as 		ash cinder 
asalea 		azalea 
asbes 		asbestos 
asem 		breathe 
asepties 		aseptic 
asetileen 		acetylene 
aseton 		acetone 
asfalt 		asphalt 
asfalteer 		asphalt 
asiel 		asylum 
asimmetries 		asymmetric asymmetrical dissymmetric 
asimut 		azimuth 
asjoublief 		please 
asketies 		ascetic 
asma 		asthma shortness of breath wheeziness 
asmalyer 		asthmatic asthmatic patient 
asmaties 		asthmatic wheezy 
asof 		as if as though in a way 
aspek 		appearance aspect look sight view 
aspersie 		asparagus 
aspidistra 		aspidistra 
asseblief 		please 
assimileer 		assimilate 
assisteer 		abet aid assist help 
assistensie 		aid help 
assistent 		aid assistant helper 
assistente 		assistant lady help 
assuransie 		insurance 
assureer 		insure 
aster 		aster 
asterisk 		asterisk 
asteroïde 		asteroid 
asteroïed 		asteroid 
astrologie 		astrology 
astroloog 		astrologer 
astronomie 		astronomy 
astronomies 		astronomic astronomical 
astronoom 		astronomer 
asyn 		vinegar 
atavisme 		atavism throw‐back 
ateljee 		atelier studio work‐room workshop 
ateïs 		atheist 
ateïsme 		atheism 
atleet 		athlete 
atletiek 		athletics 
atleties 		athletic 
atmosfeer 		atmosphere 
atmosferies 		atmospheric 
atol 		atoll 
atomies 		atomic 
atoom 		atom 
atoombom 		atom bomb 
atoomenergie 		atomic energy 
atoomgewig 		atomic weight 
atrofie 		atrophy 
attensie 		acuity advertence advertency attention 
attent 		attentive 
au 		ouch ow 
aubade 		aubade 
auditorium 		auditory 
aula 		auditorium 
aviateur 		airman aviator 
avonturier 		adventurer 
avontuur 		adventure 
avontuurlik 		adventurous 
awend 		evening 
aä‐lawa 		aa lava block lava 
aërodinamies 		aerodynamic 
aërodinamika 		aerodynamics 
aërostaat 		balloon air‐balloon 
a 		alas regrettably unfortunately 
a 		certainly 
a 		not at all 
a 		at par 
baadjie 		jacket 
baai 		bay 
baaierd 		chaos tangle 
baaihokkie 		bathing box 
baaiklere 		bathing suit bathing‐suit 
baaikostuum 		bathing suit bathing‐suit 
baak 		beacon 
baal 		bale 
baan 		path road way 
baanbreker 		pioneer 
baantjie 		post 
baanveër 		sweeper 
baanwagter 		signalman 
baar 		wave 
baard 		beard 
baarmoeder 		uterus womb 
baars 		bass 
baas 		boss chief leader 
baat 		gain profit 
baatsug 		selfinterest selfishness 
baatsugtig 		self‐interested selfish 
baatsugtigheid 		selfinterest selfishness 
baba 		baby 
bababed 		bedstead 
babel 		barbel 
baber 		barbel 
babetjie 		baby 
bad 		bath 
badhokkie 		bathing box 
badhuis 		bathroom 
badkamer 		bathroom 
badklere 		bathing suit bathing‐suit 
badkostuum 		bathing suit bathing‐suit 
badkuip 		bath 
badpak 		bathing suit bathing‐suit 
badplaas 		spa 
badshuis 		bathroom 
badspons 		bathing‐sponge 
bagasie 		baggage luggage 
bagatel 		trifle 
baie 		a lot of much 
bajonet 		bayonet 
bak 		bake 
bakatel 		trifle 
bakbaard 		whiskers side‐whiskers 
bakboord 		port side 
bakeliet 		bakelite 
baken 		beacon 
baker 		nurse dry‐nurse monthly nurse 
bakkebaard 		whiskers side‐whiskers 
bakker 		baker 
baklei 		be at loggerheads tussle 
baksteen 		brick 
bakterie 		bacterium 
bal 		ball dance 
balans 		equilibrium 
baldakyn 		baldachin canopy 
balderja 		valerian 
balderjan 		valerian 
balju 		taskmaster 
balk 		beam girder 
balkon 		balcony 
ballade 		ballad ballade 
ballast 		ballast 
ballerina 		ballerina ballet dancer ballet girl 
ballet 		ballet 
balletdanser 		ballet dancer 
balletdanseres 		ballerina ballet dancer ballet girl 
balling 		exile 
ballingskap 		exile 
ballistiek 		ballistics 
ballon 		balloon 
balroos 		Guelder rose 
balsem 		embalm 
balustrade 		balustrade banisters parapet railing 
bamboes 		bamboo 
banaal 		commonplace dismal trite 
banaliteit 		banality platitude 
banana 		banana 
band 		binding strip tape 
bandiet 		bandit 
bang 		afraid 
banjo 		banjo 
bank 		bank 
banket 		banquet 
bankier 		banker bank manager 
bankrekening 		bank account banking account 
bankrot 		bankrupt 
bankrot 		be bankrupt go broke 
banneling 		exile 
bannelingskap 		exile 
baobab 		baobab 
barak 		barrack barn shack shanty shed 
barbaar 		barbarian 
barbaars 		barbaric 
barbaarsheid 		barbarity barbarousness 
barbarisme 		barbarism 
barbier 		barber 
bard 		bard 
bariton 		baritone 
barium 		barium 
barmhartig 		charitable merciful 
barnsteen 		amber 
barometer 		barometer 
baron 		baron 
barones 		baroness 
baronie 		barony 
barrikade 		barricade 
barrikadeer 		barricade 
barrière 		barrier 
bars 		split 
bas‐relief 		bas‐relief low relief 
basaar 		bazaar fair market 
basalt 		basalt whimstone 
basies 		basic 
basiliek 		basilica 
basilika 		basilica 
basilikum 		basil 
basketbal 		basketball 
baskule 		weighing machine 
bassin 		basin reservoir 
bastion 		bastion 
bataljon 		battalion 
battery 		accumulator battery storage battery 
bauxiet 		bauxite 
bazaar 		bazaar fair market 
beantwoord 		answer 
beboude 		built‐up area 
bed 		bed 
bedaar 		calm down 
bedags 		by day during the day 
bedank 		thank 
bedanking 		rejection 
beddegoed 		bed‐clothes bedding 
beddeken 		blanket 
beddekussing 		pillow 
bedding 		bed 
bede 		appeal entreaty supplication 
bedeel 		endow 
bedees 		abashed self‐conscious shy 
bedeesheid 		bashfulness shyness timidity 
bedehuis 		church church‐building kirk 
bedek 		cover 
bedel 		beg 
bedelaar 		beggar 
bedelares 		beggar‐woman 
bedelary 		begging 
bedelbroeder 		mendicant friar 
bedelmonnik 		mendicant friar 
bedelorde 		mendicant order 
bedelry 		begging 
bedelvrou 		beggar‐woman 
bedenking 		consideration deliberation 
bedenktyd 		time to consider 
bederf 		damage injure spoil 
bederfbaar 		perishable 
bederflik 		perishable 
bederfweermiddel 		antiseptic 
bederfwerend 		antiseptic 
bederwe 		spoil 
bedevaart 		pilgrimage 
bedevaartganger 		pilgrimage 
bedien 		serve 
bediende 		maid servant 
bediening 		attendance service waiting 
bedil 		carp at haze quibble 
bedilsiek 		censorious 
bedilsug 		censoriousness 
beding 		set conditions stipulate 
bedinging 		condition stipulation terms 
bedink 		think think about reflect on 
bedissel 		arrange fix up 
bedkussing 		pillow 
bedlaken 		sheet 
bedlêend 		bedridden confined to one's bed laid up 
bedoel 		aim intend 
bedoeling 		intention meaning plan 
bedol 		crazy insane mad nuts 
bedompig 		airless close frowsy stuffy 
bedorwe 		spoiled 
bedot 		fool hoax mystify trick 
bedra 		amount to 
bedrag 		amount sum 
bedreig 		menace threaten 
bedreiging 		menace threat 
bedremmeld 		dazed perplexed upset 
bedrewe 		experienced expert skilful skilled skillful practised 
bedrewenheid 		expertness skilfulness skill skillfulness 
bedrieg 		be unfaithful be unfaithful to 
bedrieglik 		deceptive delusive fallacious 
bedrieër 		cheat deceiver imposter 
bedrieëry 		swindle 
bedrië 		be unfaithful be unfaithful to 
bedroef 		afflict grieve 
bedroefdheid 		sadness 
bedroewe 		afflict grieve 
bedroewend 		dismal miserable 
bedrog 		swindle 
bedruip 		baste 
bedruk 		dejected depressed 
bedruktheid 		dejection depression oppression 
bedryf 		enterprise 
bedryfskapitaal 		working capital 
bedryfsklaar 		in working order 
bedryfsleier 		manager 
bedrywe 		achieve act do make perform 
bedrywig 		active 
bedrywigheid 		activity 
bedsprei 		bedspread counterpane coverlet 
bedug 		agitated anxious 
bedugtheid 		fear 
beduidenis 		indication 
bedwing 		bridle check restrain 
beef 		quiver shiver tremble 
beek 		stream 
beeld 		image picture 
beeldenaar 		effigy head 
beeldend 		plastic 
beelderig 		delightful lovely 
beeldestorm 		iconoclasm 
beeldestormer 		iconoclast 
beeldhou 		carve sculpture 
beeldhouer 		sculptor 
beeldhouwerk 		sculpture 
beeldig 		delightful lovely 
beeldradio 		television TV 
beeldryk 		full of images 
beeldskoon 		lovely 
beeldspraak 		metaphor 
beeldstorm 		iconoclasm 
beeldstormer 		iconoclast 
beeltenis 		image picture 
been 		leg 
beenbreuk 		fracture of the leg 
beenwindsel 		puttee 
beer 		abutment 
beerklou 		acanthus 
beerwyfie 		she‐bear 
bees 		animal beast 
beesagtig 		beastly bestial 
beesvleis 		beef 
beet 		beet 
beetgryp 		clutch grapple 
beethê 		have got hold of 
beetkry 		capture catch grapple 
beetneem 		clutch grapple 
beetnemery 		mystification 
beetpak 		clutch grapple 
beetsuiker 		beet sugar beetroot sugar 
beetvak 		clutch grapple 
beetvat 		capture catch grapple 
bef 		bands 
befaamd 		famous 
befaamdheid 		fame hearsay renown repute rumor rumour 
begaaf 		gifted talented 
begaafdheid 		aptitude disposition talent 
begaan 		achieve act do make perform 
begaanbaar 		passable practicable 
begeef 		go 
begeer 		covet 
begeerbaar 		desirable 
begeerlik 		desirable 
begeerte 		avidity covetousness eagerness greediness 
begeester 		inspire 
begeestering 		inspiration 
begelei 		accompany 
begeleider 		accompanist companian 
begeleiding 		accompaniment escort 
begeleier 		accompanist companian 
begenadig 		amnesty pardon 
begenadiging 		absolution pardon 
begerig 		acquisitive eager greedy 
begerigheid 		alacrity avidity covetousness eagerness greediness 
begewe 		go 
begiet 		irrigate water 
begiftig 		donate give 
begin 		begin commence start 
beginletter 		initial 
beginneling 		beginner 
beginner 		beginner 
beginpunt 		starting point 
beginsalaris 		commencing salary 
beginsel 		element 
beginselvas 		firm in one's principle firm in one's principles 
beginselverklaring 		declaration of policy platform statement of policy 
beginsnelheid 		initial velocity 
begluur 		peep peep at spy spy upon 
begluurder 		spy 
begogel 		bewitch delude 
begogelsing 		delusion spell 
begonia 		begonia 
begoël 		bewitch delude 
begoëlsing 		delusion spell 
begraaf 		bury 
begraafplaas 		cemetery God's acre graveyard 
begraafplek 		cemetery God's acre graveyard 
begrafnis 		burial funeral interment 
begrafnisondernemer 		mortician undertaker 
begrafnisonderneming 		undertaker's business 
begrafnisstoet 		funeral procession 
begrawe 		bury 
begrawing 		burial funeral interment 
begrens 		abridge confine limit restrict 
begrensing 		limitation restriction 
begrip 		idea 
begripsvermoë 		understanding 
begripsverwarring 		confusion of ideas 
begroei 		overgrow 
begroet 		greet salute 
begroeting 		greeting salutation 
begroot 		appraise estimate rate 
begroting 		budget 
begrotingstekort 		budgetary deficit 
begryp 		understand realize 
begrypbaar 		understandable 
begryplik 		understandable 
begryplikerwys 		for obvious reasons understandably 
begryplikerwyse 		for obvious reasons understandably 
begryplikheid 		comprehensibility intelligibility 
begunstig 		favor favour 
begunstiging 		favor favour 
begyn 		beguine 
begyntjie 		beguine 
behaag 		please 
behaaglik 		agreeable enjoyable lovely nice pleasant 
behaaglikheid 		pleasantness 
behaagsiek 		coquettish 
behaagsug 		coquetry 
behaal 		achieve acquire attain get obtain 
behaard 		hairy hirsute 
behae 		pleasure 
behalwe 		apart from but except other than 
behandel 		care for cure treat 
behandeling 		treatment 
behang 		tapestry wall covering 
behanger 		paperer paper‐hanger 
behangsel 		tapestry wall covering 
behangselpapier 		tapestry wall covering 
behartig 		look after 
behartigenswaardig 		considerable sizable 
behartiging 		care 
beheer 		administration management 
beheers 		control govern restrain rule 
beheerser 		ruler 
beheersing 		control reign rule 
beheks 		bewitch delude 
behels 		comprise contain include 
behendig 		adroit clever dexterous skillful 
behendigheid 		expertness skilfulness skill skillfulness 
behep 		affected with afflicted with subject to 
behoed 		guard preserve protect save 
behoedsaam 		careful cautious 
behoedsaamheid 		caution 
behoef 		need require 
behoefte 		need want 
behoeftig 		miserable needy 
behoeftigheid 		destitution distress indigence need penury 
behoor 		belong to 
behoorlik 		decent fitting proper suitable 
behoorlikheidshalwe 		decently properly 
behoort 		belong to 
behoort 		belong to be one of 
behoor 		belong to be one of 
behou 		conserve keep maintain preserve 
behoud 		conservation maintenance preservation retention 
behoudend 		conservative 
behoudenis 		salvage salvation recovery 
behoudens 		bar barring except for subject to without prejudice 
behoudensgesind 		conservative 
behoue 		safe secure 
behuis 		housed 
behulpsaam 		accommodating helpful 
behulpsaamheid 		helpfulness readiness to help 
beiaard 		carillon chimes 
beide 		both 
beier 		peal ring 
beige 		beige 
beitel 		carve chisel 
bejaard 		old 
bejammer 		be sorry about regret 
bejammerenswaardig 		regrettable 
bek 		beak bill 
bekaf 		exhausted tired out worn out 
bekeer 		convert 
bekeerling 		convert proselyte 
beken 		acknowledge admit confess profess 
bekend 		well‐known 
bekendheid 		acquaintance conversance familiarity 
bekendmaak 		issue proclaim 
bekendmaking 		proclamation 
bekendstel 		issue proclaim 
bekentenis 		acknowledgement admission confession 
beker 		goblet 
bekering 		conversion 
bekken 		cymbal 
bekkenis 		cymbalist 
beklaag 		have compassion on pity 
beklaagde 		accused defendant 
beklaaglik 		dismal miserable pitiful poor 
beklad 		slander 
beklae 		have compassion on pity 
beklaenswaardig 		dismal miserable pitiful poor 
beklag 		complaint 
beklagenswaardig 		dismal miserable pitiful poor 
beklag 		complain 
beklee 		occupy take 
bekleed 		cover overlay 
beklemd 		oppressed 
beklemde 		strangulated hernia 
beklemdheid 		dejection depression oppression 
beklemming 		dejection depression oppression 
beklemtoon 		accent accentuate stress 
beklim 		ascend climb scale 
beklimbaar 		mountable 
beklimming 		ascent climbing mounting 
beklink 		conclude dispatch expedite finnish settle 
beklouter 		ascend climb scale 
beknibbel 		bargain haggle 
beknor 		blame rebuke reproach reprove scold 
bekoel 		cool cool down 
bekom 		get have receive 
bekommerd 		anxious 
bekommering 		care concern 
bekommernis 		care concern 
bekommer 		care about take care of 
bekonkel 		intrigue 
bekoor 		attract draw 
bekoorlik 		charming lovely 
bekoorlikheid 		charm 
bekoring 		temptation 
bekort 		abbreviate abridge shorten 
bekorting 		abbreviation 
bekostig 		bear the cost of defray the cost of pay the expenses of 
bekragtig 		acknowledge confirm corroborate 
bekragtiging 		confirmation 
bekreun 		pay attention to take account of take into account 
bekritiseer 		censure criticize 
bekrompe 		narrow 
bekroning 		coronation 
bekroon 		crown 
bekruip 		come over 
bekruis 		check off mark with a cross put a cross against tick off 
bekryg 		make war against make war on wage war against wage war on 
bekwaald 		barely hardly only just scarcely 
bekwaam 		able capable 
bekwaamheid 		ability 
bel 		give a ring ring ring the bell 
belaag 		beset threaten 
belaai 		burden load 
belae 		beset threaten 
belaglik 		ridiculous 
beland 		end up 
belang 		concern 
belangegemeenskap 		community of interests 
belangeloos 		disinterested 
belangende 		about concerning 
belangrik 		important serious 
belangrykheid 		concern 
belangstelling 		interest 
belangstel 		be interested in take an interest in 
belangwekkend 		interesting 
belas 		tax 
belasbaar 		subject to tax 
belaster 		slander 
belasting 		tax 
belastingaanslag 		assessment 
belastingbetaler 		ratepayer taxpayer 
belastingdruk 		tax burden 
belastingjaar 		fiscal year 
belastingkantoor 		tax‐collector's office 
belastingpligtige 		ratepayer taxpayer 
belastingstelsel 		fiscal system system of taxation tax system 
belastingverhoging 		tax hike tax increase 
belastingverlaging 		tax abatement tax reduction tax relief 
belastingvermindering 		tax abatement tax reduction tax relief 
belastingvry 		duty‐free tax‐free 
beledig 		abuse insult offend 
beledigend 		insulting offensive opprobrious 
belediging 		abuse insult 
beleef 		go through live to see 
beleefdheid 		courtesy 
beleefdheidshalwe 		out of courtesy out of politeness 
beleen 		borrow money on pawn 
beleg 		invest 
belegger 		investor 
beleid 		policy 
beleidvol 		careful cautious 
belemmer 		bar hinder inhibit prevent 
belemmering 		handicap impediment obstacle 
belend 		abut adjoin be next to 
belendend 		adjacent 
belening 		pawning 
belese 		well‐read 
belet 		hindrance 
beletsel 		hindrance 
belewe 		go through live to see 
belewenis 		experience 
belewing 		experience 
beleë 		mature ripe 
beleër 		besiege 
beleëraar 		besieger 
beleëring 		siege 
belhamel 		bell‐wether 
belief 		please 
belig 		illuminate light 
beliggaam 		embody 
beliggaming 		embodiment 
beligting 		exposure 
beligtingsduur 		exposure time 
beligtingsmeter 		exposure meter 
beligtingstyd 		exposure time 
belladonna 		belladonna 
belletrie 		belles‐lettres 
beloer 		peep peep upon spy spy upon 
belofte 		affirmation promise 
beloning 		compensation reward 
beloof 		promise 
beloon 		compensate reward 
belowe 		promise 
belroos 		erysipelas 
beluister 		listen 
beluisteraar 		listener 
belus 		acquisitive eager greedy 
belus 		covet 
bely 		confess 
belydenis 		confession 
belê 		invest 
belêer 		investor 
bemagtig 		clutch grab grasp grip seize 
beman 		man 
bemanning 		crew 
bemantel 		mask 
bemeester 		overpower prevail over 
bemerk 		notice 
bemes 		fertilize 
bemesting 		dressing fertilization manuring 
bemiddel 		act as agent 
bemiddelaar 		agent 
bemiddeld 		in easy circumstances well‐to‐do 
bemiddeling 		mediation 
bemin 		love 
beminde 		beloved loved one lover sweetheart well‐beloved 
beminlik 		lovable 
beminlikheid 		sweetness 
beminnaar 		lover 
beminnenswaardig 		lovable 
beminnenswaardigheid 		sweetness 
bemisting 		dressing fertilization manuring 
bemodderd 		muddy mud‐stained 
bemoedig 		encourage 
bemoediging 		encouragement 
bemoeial 		bushbody meddler 
bemoeienis 		efforts 
bemoeigees 		meddlesomeness 
bemoeilik 		hamper hinder thwart 
bemoeisiek 		meddlesome 
bemoeisug 		meddlesomeness 
bemoeisugtig 		meddlesome 
benaam 		call 
benadeel 		harm hurt injure prejudice 
benader 		approach 
benadruk 		accent accentuate emphasize 
benaming 		appellation name 
benard 		straitened 
benardheid 		abashment embarrassment perplexity 
bende 		band bevy gang 
benede 		below downstairs underneath 
benedebuur 		neighbour on the lower storey 
benedebuurman 		neighbour on the lower storey 
benedeloop 		lower course 
benedeverdieping 		ground‐floor 
benedy 		bless 
beneem 		abstract take away 
benefice 		benefit performance 
beneficevoorstelling 		benefit performance 
benepe 		in distress 
benepenheid 		pettiness small‐mindedness 
benewel 		befog cloud dim 
beneweld 		tipsy 
benewens 		together with 
benodig 		necessary 
benodigdhede 		materials necessaries requisites 
benoem 		call 
benoeming 		nomad 
benoorde 		above 
benou 		agitate alarm 
benoud 		stale 
benouend 		alarming grave serious 
benseen 		benzene 
bensien 		gasolene gasoline petrol 
bensienreservoir 		gas tank petrol tank 
bensine 		gasolene gasoline petrol 
bensinereservoir 		gas tank petrol tank 
benul 		idea 
benut 		make use of turn to good account utilize 
benuttig 		make use of turn to good account utilize 
beny 		envy 
beoefen 		exert practice 
beoefenaar 		practitioner 
beoefening 		practice 
beoog 		aim intend 
beoordeel 		censure criticize 
beoordelaar 		judge 
beoordeling 		criticism 
beoorlog 		make war against make war on wage war against wage war on 
beoorloog 		make war against make war on wage war against wage war on 
beooste 		east of eastward of to the east of 
bepaal 		define determine 
bepalend 		defining determining 
bepaling 		definition 
bepantser 		armour 
bepantsering 		armour 
beperk 		abridge confine limit restrict 
beperkend 		restrictive 
beperking 		limitation restriction 
beplan 		plan 
beplant 		plant 
beplanting 		plantation planting 
bepleister 		plaster 
bepleit 		advocate plead 
beploe 		plough 
beploege 		plough 
beploë 		plough 
bepoeier 		powder 
bepraat 		persuade 
beproef 		afflict grieve 
beproewe 		afflict grieve 
beproewing 		affliction 
beraadslaag 		deliberate 
beraadslaging 		consultation deliberation 
beraam 		make a project of plan 
beraming 		plan project scheme 
berberis 		barberry 
beredder 		arrange fix up 
berede 		mounted 
beredeneer 		argue discuss reason about reason upon 
bereg 		administer the last sacraments 
beregting 		administration of the last sacraments 
berei 		prepare 
bereid 		finished ready through 
bereiding 		preparation 
bereidvaardig 		kind obliging 
bereidwillig 		kind obliging 
bereik 		accomplish achieve attain get reach 
bereikbaar 		accessible 
bereisd 		travelled widely‐travelled 
bereken 		calculate count figure work out 
berekening 		account bill calculation 
bereklou 		cow parsnip hogweed 
beremus 		bearskin bearskin cap 
berg 		mountain 
bergagtig 		mountainous 
bergamot 		bergamot 
bergbeklimmer 		Alpinist climber mountain climber mountaineer 
bergengte 		defile mountain pass 
berghelling 		mountain slope 
berging 		salvage salvation recovery 
bergingsmaatskappy 		salvage company 
bergkam 		mountain ridge 
bergklimmer 		Alpinist climber mountain climber mountaineer 
bergkristal 		rock‐crystal 
bergloon 		salvage salvage money 
berglug 		mountain air 
bergmuis 		lemming 
bergpik 		asphalt 
bergpunt 		mountain peak mountain top pinnacle 
bergreeks 		chain of mountains mountain chain mountain range rand 
bergrug 		mountain ridge 
bergspits 		mountain peak mountain top pinnacle 
bergtop 		mountain peak mountain top pinnacle 
berig 		account information 
beril 		beryl 
berilsteen 		beryl 
berin 		she‐bear 
berispe 		reproach rebuke reprove scold 
berisping 		observation remark reproof 
berk 		birch 
berkeboom 		birch 
berlynsblou 		Prussian blue 
berm 		shoulder verge verge of a road 
beroemd 		famous 
beroemdheid 		fame renown 
beroep 		appeal 
beroeps‐ 		professional 
beroer 		abet agitate incite stir up 
beroerd 		bad miserable nasty poor 
beroering 		agitation commotion 
beroerte 		fit apoplectic fit seizure stroke stroke of apoplexy 
berokken 		activate cause give rise to 
beroof 		rob 
berooid 		miserable needy 
berou 		repentance 
beroue 		regret repent repent of 
berouhebbend 		contrite penitent repentant 
berouvol 		contrite penitent repentant 
berowe 		rob 
berower 		robber 
berowing 		robbery 
berrie 		stretcher 
berug 		of ill repute 
beruik 		smell at sniff at 
berus 		acquiesce resign oneself 
berusting 		acquiescence rezignation 
bery 		drive over ride over 
berybaar 		passable practicable 
berym 		rhyme 
beryp 		frosted hoar 
besadig 		staid 
beseer 		hurt 
besef 		understand realize 
besem 		broom 
beset 		pregnant with young 
besete 		crazy insane mad nuts 
besetene 		lunatic 
besetenheid 		craziness insanity lunacy madness 
besetting 		garrison 
beseël 		acknowledge confirm corroborate 
beseëling 		sanction 
besie 		cricket 
besiel 		inspire 
besield 		enthusiastic 
besielend 		inspiring 
besieling 		alacrity enthusiasm 
besien 		see 
besienswaardig 		worth seeing 
besig 		busy 
besigheid 		activity occupation 
besighou 		distract divert entertain 
besinning 		awareness consciousness 
besit 		possession property 
besitting 		possession property 
beskaaf 		civilize 
beskaafdheid 		good breeding refinement 
beskaam 		put to shame 
beskaamd 		ashamed 
beskaamtheid 		shame 
beskadig 		damage injure spoil 
beskadiging 		damage 
beskadu 		cast a shadow 
beskaduwee 		cast a shadow 
beskamend 		humiliating 
beskawe 		civilize 
beskawing 		civilization 
beskeid 		document paper 
beskeidenheid 		modesty 
beskeie 		discrete 
beskerm 		protect 
beskermeling 		protégé 
beskermengel 		guardian angel 
beskermer 		patron 
beskermheer 		patron 
beskermheilige 		patron 
beskerming 		protection 
beskermling 		protégé 
beskiet 		bombard 
beskieting 		firing 
beskik 		arrange fix up 
beskikbaar 		available 
beskikking 		accommodation adjustment arrangement 
beskilder 		paint over 
beskimmel 		get mouldy 
beskimmeld 		mouldy 
beskimp 		jeer jeer at taunt 
beskinder 		slander 
beskindering 		backbiting scandal slander 
beskonke 		drunk intoxicated 
beskonkenheid 		drunkenness inebriety 
beskrywing 		account description 
beslis 		absolutely definitely without fail 
besluit 		decide 
besoedel 		soil 
besoek 		visit 
besoeker 		caller visitor 
besoekersboek 		visitor's register 
besonderheid 		detail 
bespaar 		save spare 
bespreek 		reserve 
bespreking 		booking 
bestaan 		exist 
beste 		best 
besteding 		expenses 
bestel 		book order reserve 
bestelling 		order 
bestudeer 		study 
bestuur 		direct guide manage steer 
bestuurder 		manager 
beswaar 		protest 
betaal 		pay 
betaam 		befit be fitting 
beteken 		imply mean signify 
betekenis 		meaning 
betekenisvol 		significant 
beter 		better 
betrekking 		post 
betrokke 		concerned in question 
betyds 		at the right time in time 
beuk 		beech 
bevat 		comprise contain include 
bevestig 		affirm assent say yes 
bevolking 		population 
bevorder 		advance promote 
bevordering 		promotion 
bevrore 		frozen 
bevrug 		pregnant with young 
bewaar 		conserve keep maintain preserve 
beweeg 		actuate move 
beweging 		movement 
bewering 		contention assertion 
bewonder 		admire 
bewys 		proof sign token 
beëindig 		accomodate end finish terminate 
beëindiging 		end ending 
beërf 		inherit 
beërwe 		inherit 
beïndruk 		impress 
beïnvloed 		act affect influence 
biblioteek 		library 
bibliotekaris 		librarian 
bid 		pray 
bieg 		confess 
bier 		ale beer 
bikini 		bikini 
biljart 		billiards 
billik 		fair just righteous 
bind 		bind connect join tie tie up 
binne 		a in inside into on per within 
binnekort 		soon 
binnelands 		aboriginal domestic 
bioskoop 		cinema movie theatre 
biskop 		bishop 
bismut 		bismuth 
bison 		bison buffalo 
bitter 		acerbic bitter 
blaarslaai 		lettuce 
blaas 		blow 
bladsy 		page 
blank 		white 
blanke 		European white man 
bleik 		point out to be 
blik 		can tin tin can 
blind 		blind 
blink 		bright brilliant 
bloed 		blood 
bloedrooi 		blood red blood‐red 
bloedverwant 		relative 
bloese 		blouse 
blok 		block pad 
blokletter 		type 
blom 		bloom flower 
blou 		blue 
blus 		extinguish put out 
bly 		remain stay stay over 
bo 		above over 
bobbejaan 		baboon 
boek 		book 
boekhou 		accounting book‐keeping 
boer 		agrarian farmer 
boereplaas 		estate farm property ranch 
boete 		fine 
boetekaartjie 		minutes protocol 
bogenoemd 		above above‐mentioned 
boks 		box 
bokser 		boxer 
bondel 		bunch bundle cluster sheaf 
bonus 		bonus 
boodskap 		errand message 
boom 		tree 
boonop 		on top of 
boor 		bore 
boord 		orchard 
bord 		plate 
bordeel 		brothel 
bors 		bosom breast chest 
borsel 		brush 
bos 		forest woods 
bosbok 		bushbuck 
bots 		collide 
botsing 		collision 
bottel 		bottle 
botter 		butter 
bouer 		builder 
braai 		barbecue 
brand 		burn 
brandewyn 		brandy 
brandstof 		fuel 
breek 		break 
breekbaar 		breakable brittle fragile 
brein 		brain 
brief 		letter 
briefkaart 		postcard 
bril 		glasses spectacles 
bring 		bring fetch 
brinjal 		brinjal eggplant 
broei 		incubate sit 
broer 		brother 
broerskind 		niece 
bron 		fountain source spring 
brons 		bronze 
brood 		bread loaf 
brosjure 		leaflet pamphlet paperback 
brug 		bridge 
bruin 		brown 
buffel 		buffalo 
buffer 		buffer bumper 
buig 		bend 
buis 		barrel channel pipe tube 
buite 		outside outside of 
buiteland 		foreign country 
bul 		bull 
bundel 		collection 
burger 		middleclass citizen 
buro 		bureau office 
bus 		bus autobus omnibus 
bushalte 		bus stop 
buurman 		neighbour 
by 		at beside by near nearby near to next to 
bybel 		bible 
bylae 		addition adjunct 
bymekaar 		together 
bymekaarbring 		collect gather pick up 
byna 		almost nearly 
bynaam 		byname nickname sobriquet 
byt 		bite 
byvoeg 		add 
bywoon 		attend be present witness 
bywoord 		adverb 
bywoordelik 		adverbial 
by 		about approximately 
bêre 		put away stow 
bêreplek 		depository 
casino 		casino 
chaos 		chaos tangle 
chemie 		chemistry 
chirurg 		surgeon 
chloor 		chlorine 
daad 		achievement act action 
daag 		assign 
daagliks 		daily 
daal 		descend go down 
daar 		there 
daardie 		those 
daarmee 		thereby 
daarna 		afterwards next subsequently 
daarom 		on that account therefore 
daarso 		there 
daarvandaan 		from there thence 
daar 		over there yon yonder 
dadelik 		at once instantly immediately without delay 
dag 		hello 
dagvaarding 		summons 
damestudent 		student female student 
dan 		then 
dank 		thank 
dankbaar 		thankful 
dankie 		thank you thanks 
danksy 		thanks to 
dans 		dance 
dapperheid 		courage 
darem 		genuinely indeed really truly 
das 		tie necktie 
dat 		that 
dateer 		date 
datum 		date 
deeglik 		enormously extremely 
deel 		part Parthian share 
deelneem 		participate share take part 
deels 		partially partly 
definisie 		definition 
definitief 		absolutely definitely without fail 
deftig 		beautiful fine handsome lovely 
dek 		cover 
dekade 		decade 
deken 		blanket 
dekor 		décor decoration 
delikaat 		dainty delicate fine refined 
demokrasie 		democracy 
demokraties 		democratic 
den 		fir 
denneboom 		fir 
departement 		department 
deponeer 		deposit 
deporteer 		deport 
derde 		third 
dertien 		thirteen 
dertig 		thirty 
destyds 		then 
detail 		detail 
deur 		by by means of on through with 
deurbring 		pass spend 
deurdat 		because for the reason that 
deurmaak 		go through live to see 
deurmekaar 		dazed perplexed upset 
deurpad 		motor road motorway 
deursnee 		profile 
diamant 		diamond 
die 		the 
dieet 		diet 
dief 		thief 
diens 		service 
diep 		deep profound 
diepte 		depth 
dier 		animal 
dieretuin 		zoo 
dieselfde 		the same 
die 		Cape Province 
die 		Crimea 
die 		Transkei 
die 		retreat 
digter 		poet 
dikwels 		frequently often regularly 
dimensie 		dimension measurement 
dinee 		dinner midday meal 
ding 		affair business business deal case matter 
dink 		account deem opine think 
diploma 		diploma 
direk 		direct straight 
direkteur 		director manager 
dissipline 		discipline 
dit 		that that over there those 
dit 		that that over there those 
dit 		these this this here 
dié 		those 
doel 		aim goal purpose target 
doen 		achieve act do make perform 
dogter 		daughter 
dokter 		doctor physician 
dokument 		document paper 
dom 		addled foolish stupid 
dominee 		pastor 
donasie 		gift present 
donker 		bleak dark dismal dreary 
donkie 		ass donkey 
dood 		dead 
doodmaak 		extinguish put out 
doodskiet 		shoot dead 
doof 		deaf 
doop 		baptism christening 
doopnaam 		Christian name 
doos 		box 
dor 		dry 
dorp 		village 
dors 		thirsty 
dors 		be thirsty 
dosyn 		dozen 
dra 		carry wear 
draagbaar 		stretcher 
draai 		turn 
dragtig 		pregnant with young 
drama 		drama 
dreigement 		menace threat 
drie 		three 
dringend 		pressing urgent 
drink 		drink drink to excess 
drinkpan 		bar pub 
dromedaris 		dromedary 
dronk 		drunk intoxicated 
droog 		dry 
droogte 		dryness 
druif 		grape 
druk 		press oppress squeeze 
drup 		drip 
dryf 		drift be adrift 
duidelik 		clearly 
duim 		thumb 
duisend 		thousand one thousand 
duister 		dark dim 
duiwel 		devil 
dun 		airy 
durf 		courage 
dus 		accordingly consequently so subsequently thus 
duur 		dear expensive valuable 
dwarsdeur 		across throughout 
dwerg 		dwarf midget 
dwing 		compel force 
edel 		noble 
edelweiss 		edelweiss 
eed 		oath 
eekhoring 		squirrel 
eekhorinkie 		squirrel 
een‐en‐twintig 		twenty‐one 
een 		one 
eend 		duck 
eendag 		at some time ever sometime 
eenheid 		unity 
eensaam 		lonely solitary 
eensaamheid 		isolation separation 
een 		twenty‐one 
eergister 		the day before yesterday 
eerlik 		above‐board honest 
eers 		at some time ever sometime 
eerskomende 		nearest next 
eerste 		first 
eetkamer 		dining‐room 
eetservies 		crockery set 
eeu 		centennial century 
effek 		effect impression 
effektief 		actual real 
eggenoot 		husband 
eggo 		echo 
egter 		but however nevertheless yet 
ei 		egg 
eie 		own personal 
eienaar 		owner 
eienaardig 		odd peculiar strange 
eiendomsagentskap 		broker 
eierplant 		brinjal eggplant 
eiervrug 		aubergine brinjal eggfruit 
eik 		oak 
eiland 		island 
einde 		end ending 
eindeksamen 		leaving examination 
eindig 		accomodate end finish terminate 
eintlik 		to tell the truth 
ekonomies 		economical 
eksamen 		investigation examination test 
eksperiment 		experiment 
ekstase 		ecstasy 
ekstra 		additional extra 
ekstreem 		excessive inordinate 
eland 		eland 
elders 		elsewhere 
elegant 		elegant 
elegie 		elegy 
elektries 		electric 
elektrisiteit 		electricity 
elektron 		electron 
elementêr 		elemental elementary 
elf 		eleven 
els 		alder 
elsboom 		alder 
emigreer 		emigrate 
emosie 		affection 
en 		and 
energie 		energy 
enige 		a few any some 
enige 		any time momentarily 
enigiemand 		a any anybody some somebody one someone some one 
enigiets 		anything something 
enigste 		alone only sole solitary 
enkele 		a few any some 
enorm 		enormous 
ens. 		etc. 
ensovoorts 		and so on et cetera 
erediens 		service worship service 
erf 		inherit 
erg 		important serious 
erken 		acknowledge confirm corroborate 
ernstig 		important serious 
ertjie 		pea 
ervare 		accomplished adept experienced expert 
ervaring 		experience 
esel 		ass donkey 
esperantis 		Esperantist 
ete 		meal 
evolusie 		development evolution 
ewe 		alike all the same equally 
ewig 		eternal 
fabriek 		factory 
familie 		family 
familielid 		relative 
fase 		phase stage 
fasiliteer 		facilitate 
fassineer 		fascinate 
fee 		fairy 
feit 		fact 
feodaal 		feudal 
ferm 		firm robust sturdy 
fiets 		bike cycle bicycle 
fietsry 		cycle 
fiks 		healthy well 
film 		film motion picture movie 
firma 		company firm 
flard 		rag scrap 
fliek 		go to the cinema go to the movies 
fliekhuis 		cinema movie theatre 
flikker 		flare flare up 
floreer 		be succesful prosper 
flou 		faint swoon 
fluit 		flute 
fonds 		fund 
fooitjie 		tip 
forel 		trout 
formeel 		formal 
fossiel 		fossil 
foto 		photograph 
fout 		aberration error mistake 
framboos 		raspberry 
funksie 		function 
gaaf 		good nice okay 
gaan 		go 
gaan 		halt come to a halt stop 
gade 		wife 
galery 		gallery 
gans 		goose 
garage 		garage 
garnaal 		prawn 
gas 		gas 
gasvry 		hospitable 
gasvryheid 		hospitality 
gat 		hole 
geadresseerde 		addressee 
geag 		dear 
gebed 		prayer 
gebeur 		come about happen occur 
gebeurtenis 		event 
gebied 		area 
geboorte 		birth 
gebou 		building 
gebruik 		custom habit way 
gebruiker 		user 
gedaante 		form shape 
gedagte 		thought 
gedeelte 		part Parthian share 
gedeeltelik 		partially partly 
gedek 		pregnant with young 
gedig 		poem 
gedra 		behave conduct oneself 
geduld 		patience 
geduldig 		patient 
gedurende 		for during whereas while whilst 
gee 		give 
geel 		yellow 
geen 		no 
gees 		soul 
geesdrif 		alacrity enthusiasm 
geesdriftig 		enthusiastic 
geheim 		secret 
gehoorsaam 		obey 
geld 		money 
geldstuk 		coin 
geleentheid 		chance event occurence opportunity 
geliefde 		lover 
geluk 		luck 
gelukkig 		fortunate happy 
gelukkig 		be lucky have good luck 
gelykheid 		draw equality 
gemiddeld 		average mean middle 
genealogie 		family tree genealogy pedigree 
genealogies 		genealogical 
genealoog 		genealogist 
geneig 		inclined 
generaal 		general 
generasie 		generation 
geniet 		be glad enjoy rejoice 
genoeg 		enough sufficient 
genot 		fun pleasure 
genre 		genre 
geografies 		geographic geographical 
geparenteer 		affined akin related 
geraamte 		skeleton 
gereed 		finished ready through 
geregtigheid 		justice righteousness 
gereëld 		regularly 
gerieflik 		comfortable 
geruime 		a long time for a long time long 
gerus 		politeness particle 
gesag 		authority 
gesels 		speak talk 
gesig 		expression 
gesin 		family 
gesins‐ 		domestic 
geskei 		divorced 
geskenk 		gift present 
geskie 		come about happen occur 
geskiedenis 		story history 
geskikt 		appropriate becoming seemly suitable 
geskoolde 		able 
geslag 		generation 
geslaglys 		generation 
geslagregister 		generation 
gesond 		healthy well 
gesondheid 		health 
gespanne 		strained 
gesprek 		conversation 
getroud 		married 
geur 		odor odour scent smell 
geveg 		action battle scuffle struggle 
gevolglik 		accordingly consequently so subsequently thus 
gevolgtrekking 		conclusion inference 
geweldig 		enormous huge immense 
gewete 		conscience 
gewig 		weight 
gewild 		popular 
gewoon 		common ordinary usual 
gewoond 		accustom be in the habit of 
gewoonlik 		ordinarily usually 
gewoonte 		custom habit way 
geïnteresseerd 		gripped interested 
gholf 		golf 
gids 		handbook guide guidebook 
gier 		vulture 
giet 		pour scatter shed 
giftig 		poisonous 
gil 		yell 
gimnastiek 		gymnastics 
ginder 		over there yon yonder 
ginds 		over there yon yonder 
gister 		yesterday 
glad 		not at all 
glas 		glass 
gleuf 		slot 
glimlag 		smile 
glo 		account accredit believe deem 
gly 		glide slip 
god 		god 
godsdiens 		religion 
godsdienstig 		pious 
goed 		good nice okay 
goedkoop 		cheap inexpensive 
goeiemiddag 		good afternoon 
goeiemôre 		good morning 
goeienaand 		good evening 
goeienag 		good night 
gooi 		throw 
gordyn 		curtain 
gou 		fast quickly swiftly 
goud 		gold 
goudgeel 		golden yellow 
goudmyn 		gold‐mine 
goudvis 		goldfish 
goue 		gold golden 
gou 		go fast hurry rush 
graad 		degree grade 
graag 		willingly 
gram 		gram gramme 
grammatika 		grammar 
gras 		grass 
grasgroen 		grass green 
gratis 		free 
grens 		boundary frontier limit 
gretig 		acquisitive eager greedy 
griep 		flu grip influenza 
grimeer 		make up 
grimering 		make up make‐up 
groen 		green 
groente 		vegetable 
groep 		group 
groet 		greet salute 
grond 		ground soil 
grondwet 		constitution 
groot 		big great large 
grootmoeder 		grandmother 
grootouers 		grandparents 
grootte 		bulk dimension extend size 
grootvader 		grandfather 
grot 		cave grotto 
groutjie 		ass donkey 
gryp 		clutch grab grasp grip seize 
grys 		grey 
gunsteling‐ 		advantageous favourable 
haai 		shark 
haalbaar 		achievable 
haan 		cock rooster 
haar 		her to her 
haarkapper 		barber hairdresser 
haas 		haste 
haastig 		hurried 
haat 		hate 
hael 		hail 
hakie 		clamp brace bracket parenthesis staple 
halfbroer 		half‐brother 
halfsuster 		half‐sister 
hallo 		hello 
hals 		neck 
hamburger 		hamburger 
hand 		hand 
handel 		business commerce trade 
handelaar 		merchant 
handlanger 		abetter accessory accomplice 
handtekening 		signature 
hang 		droop hang 
hanteer 		handle manipulate 
hap 		morsel mouthful 
hard 		loud 
hardloop 		run 
hare 		hair hairs 
hart 		heart 
hawe 		harbor harbour port 
heelal 		universe 
heeltemal 		at all entirely quite wholly 
heerlik 		agreeable enjoyable lovely nice pleasant 
heide 		heath 
heilig 		sanctify 
heks 		witch 
hel 		hell 
held 		hero 
helder 		bright clear light 
heldhaftig 		heroic 
heldin 		heroine 
hele 		entire overall whole 
helm 		helmet 
help 		abet aid assist help 
hemel 		heaven sky 
hemp 		shirt 
hen 		chicken fowl 
hengel 		fishing rod 
hengelaar 		angler 
herdenking 		recollection 
herder 		shepherd 
herfs 		autumn 
herhaal 		repeat 
herinnering 		memory recollection 
herkoms 		lineage 
heroïen 		heroin 
heroïne 		heroin 
hert 		deer 
heuning 		honey 
heup 		hip 
hierbo 		above 
hierdie 		these 
hierheen 		here hither this way 
hiervandaan 		from here hence 
higiënies 		hygienic 
hings 		stallion 
hitte 		heat 
hiëna 		hyaena 
hoed 		hat 
hoekom 		what for wherefore why 
hoender 		chicken hen 
hoer 		hooker whore 
hoerhuis 		brothel 
hoes 		cough 
hoeveel 		how many 
hoeveelste 		how many what number 
hoe 		how are you? how do you do? 
hoe 		what time 
hoe 		how far 
hof 		court 
hok 		cage 
hokkie 		hockey 
hom 		him to him 
hom 		interfere with 
hom 		think think about reflect on 
hond 		dog 
honderd 		hundred one hundred 
honger 		hungry 
honger 		be hungry 
hoofkwartier 		headquarters 
hoofpyn 		headache 
hoofsaaklik 		above all especially chiefly mainly principally 
hoofstad 		metropolis 
hoofweg 		major road 
hoop 		hope 
hoor 		hear 
horlosie 		watch 
horror 		horror 
hospitaal 		hospital 
hotel 		hotel 
hou 		hang onto hold 
houding 		behavior behaviour conduct deportment 
houer 		holder socket 
hout 		timber wood 
hou 		appreciate like 
huidig 		actual current present present‐day 
huis 		house 
huis 		home 
huldig 		honor honour 
hulle 		their 
hulle 		theirs 
hulp 		aid help 
hurk 		cower crouch squat 
huur 		hire 
huurmotor 		taxi 
huwelik 		marriage matrimony 
hy 		he him 
hyser 		elevator lift 
hê 		have have got 
ideaal 		ideal 
idee 		idea 
idioom 		idiom 
iemand 		a any anybody some somebody one someone some one 
iep 		elm 
iets 		anything something 
ignoreer 		ignore leave out of account 
immigreer 		immigrate 
immoreel 		abandoned nasty 
impak 		effect 
in 		a in inside into on per within 
inasem 		inhale 
inbreker 		burglar 
indeks 		index 
indien 		if provided that 
individueel 		individual 
indruk 		effect impression 
industrie 		industry 
ineenkrimp 		cower shrink 
informasie 		information 
ingenieur 		engineer 
inheems 		aboriginal domestic 
inhoud 		contents 
inleiding 		introduction preface 
inlewer 		deliver furnish supply 
inligting 		account information 
inligtingskantoor 		inquiry‐office 
inmaak 		preserve 
innig 		close intimate 
inrigting 		institute 
inruil 		interchange swap 
insameling 		collection 
insident 		event occasion occurence opportunity 
insig 		notion sense realization 
insit 		enter insert put in 
inskep 		dish up 
insluitend 		including inclusively 
inspekteur 		inspector 
inspektisto 		inspector 
inspuit 		inject 
inspuiting 		injection 
instel 		begin commence start 
instituut 		institute 
instruksie 		directions instruction 
inteendeel 		on the contrary otherwise 
intelligent 		intelligent sagacious 
intens 		acute intense intensive 
interessant 		interesting 
internasionaal 		international 
intusse 		all the time in the meantime meanwhile 
invoer 		import 
invul 		fill fill in fill up 
in 		be considered count 
in 		fast quickly swiftly 
in 		govern head up restrain 
in 		generally 
in 		pregnant 
in 		behind one's back underhand 
in 		in any event 
in 		acquaint inform report 
in 		toward towards with reference to 
isolasie 		insulation isolation 
item 		element fragment item particle 
ivoor 		ivory 
ja 		yes 
jaag 		race run 
jaar 		year 
jaarliks 		annual yearly 
jag 		yacht 
jager 		hunter 
jakkals 		jackal 
jaloers 		jealous 
jammer 		alas regrettably unfortunately 
jammer 		be sorry about regret 
jas 		coat overcoat 
jeens 		at by on upon 
joernalis 		journalist 
jongmens 		youngster youth 
jonk 		young 
josie 		devil 
jou 		thee to thee to you to thee 
joune 		yours 
juis 		accurate precise 
julle 		your 
julle 		yours 
juweel 		gem jewel 
juwelier 		jeweller 
jy‐en‐jou 		thee and thou 
jy 		thou you 
kaart 		map 
kaartjie 		bill ticket note 
kaartjieskantoor 		booking‐office 
kabeljou 		cod codfish 
kabinet 		cabinet 
kafeteria 		cafetaria 
kalkoen 		turkey 
kalm 		calm quiet 
kalmeer 		appease calm quiet soothe still 
kam 		comb 
kameel 		camel 
kameelperd 		giraffe 
kamer 		chamber room 
kamera 		camera 
kamp 		camping ground camping site 
kampeer 		camp be encamped lie encamped camp out 
kampeerterrein 		camping ground camping site 
kan 		be able to 
kanaal 		canal channel 
kandidaat 		candidate 
kangeroe 		kangaroo 
kanker 		cancer canker 
kans 		chance luck 
kanselleer 		abjure abolish abrogate annul cancel remit 
kant 		side 
kantoor 		office 
kantoorklerk 		clerk 
kapster 		hairdresser female hairdresser 
kaptein 		captain 
kar 		car 
karakter 		character nature personality 
karig 		in short supply scanty scarce 
karma 		karma 
kas 		cabinet closet cupboard sideboard 
kasset 		cassette 
kasteel 		castle 
kat 		cat 
katalogus 		catalogue directory 
katoliek 		Catholic 
katolisisme 		Catholisism 
keel 		throat 
keer 		occasion time 
kelder 		basement cellar 
kelkie 		cocktail 
kelner 		waiter 
ken 		be acquainted with know 
kenmerkend 		characteristic 
kennis 		acquaintance 
kennisgewing 		account information 
kerk 		church church‐building kirk 
kerrie 		curry 
kers 		candle 
kersboom 		Christmas tree 
keuse 		choice election 
kies 		choose elect pick out 
kiesel 		silicon 
kilogram 		kilo 
kilometer 		kilometre 
kind 		child offspring young 
kla 		complain 
klaar 		already by now yet 
klank 		sound 
klap 		hit knock strike 
klaploper 		cadger parasite sponger 
klas 		class 
klassiek 		classic classical 
klavier 		piano 
klee 		clothe dress 
kleefband 		adhesive tape 
klein 		diminutive little small 
kleindogter 		granddaughter 
kleingeld 		change 
kleinkind 		grandchild 
kleinseun 		grandson 
klere 		clothes clothing 
klets 		gossip 
kleur 		colour dye 
kleuterskool 		nursery school 
kliek 		clan 
klik 		clap click rattle 
klim 		climb 
klimaat 		climate 
kliniek 		clinic 
klink 		sound 
kliënt 		client customer 
klokkie 		bellflower Canterbury bell 
klomp 		bevy collection group heap herd set 
kloof 		ravine 
klub 		club society 
knie 		knee 
knip 		bolt 
knoop 		knot node 
kobalt 		cobalt 
kobra 		cobra 
kode 		code 
koei 		cow 
koel 		cool 
koepee 		compartment coupé 
koerant 		gazette magazine newspaper periodical 
koeël 		bullet 
koffer 		trunk 
koffie 		coffee 
kollega 		colleague 
kollege 		college 
kolom 		column pillar 
kolonie 		colony settlement 
kom 		come 
kombinasie 		combination 
kombuis 		kitchen 
komedie 		comedy 
komhalertjie 		Adam's apple 
kommandant 		commander 
kommentaar 		annotation note 
kommissie 		commission 
kompak 		compact 
kompartement 		compartment coupé 
kompetisie 		competition contest 
koms 		arrival 
kondukteur 		guard 
koneksie 		connection 
koning 		king 
koninkryk 		kingdom 
konsep 		draft rough draft 
konsert 		concert 
konsternasie 		alarm consternation 
konsul 		consul 
kontak 		contact 
kontant 		cash in cash 
kontrak 		contract 
kontrole 		administration management 
kontroleer 		audit check check up on supervise verify 
konyn 		rabbit 
kook 		boil 
koors 		ague fever 
koorsig 		feverish 
kop 		head pate 
kopdoek 		kerchief 
kopiereg 		copyright 
koppelaar 		clutch 
koppie 		cup 
koppies‐en‐pierings 		bellflower Canterbury bell 
kort 		short 
kos 		cost 
kostelik 		lovely 
kou 		chew 
koud 		bleak chilly cold 
koud 		get cold 
kous 		stocking 
kraal 		bead 
krag 		force strength vigour 
krap 		scratch 
kredietkaart 		credit card 
kreef 		crayfish 
kreëer 		create 
krisis 		crisis depression emergency 
kristal 		crystal 
kritiseer 		censure criticize 
krokodil 		crocodile 
kronkel 		meander twist wind around 
kropslaai 		lettuce 
kruier 		porter 
kruip 		crawl creep 
kruis 		cross 
kruisskyf 		steak beefsteak 
kruk 		crutch 
kry 		get have receive 
kubus 		cube 
kudde 		bevy collection group heap herd set 
kuier 		attend call on see visit 
kuikendief 		harrier kite 
kultuur 		culture 
kuns 		art 
kunsgalery 		art gallery 
kunstenaar 		artist 
kunstig 		artificial artistic 
kurk 		cork 
kursus 		class course 
kus 		kiss 
kussing 		cushion 
kwaai 		bad miserable nasty poor 
kwalifikasie 		ability qualification 
kwalifiseer 		qualify 
kwartier 		quarter of an hour 
kweek 		cultivate grow 
kwessie 		question 
kwytskelding 		acquittal 
kyker 		spectator 
laag 		layer 
laai 		drawer 
laat 		allow leave let release 
laatste 		last 
laerskool 		primary school 
lag 		laugh 
laken 		sheet 
lam 		lamb 
lamp 		lamp 
landbou 		agriculture farming tillage 
landbouer 		agrarian farmer 
landbouskool 		agricultural school 
landskap 		landscape scenery 
lang 		long 
langs 		at beside by near nearby near to next to 
langsaan 		nearby 
lank 		a long time for a long time long 
later 		later later on 
lawaai 		ado din noise 
leef 		be alive live 
leek 		layman 
leen 		borrow 
leer 		teach 
leerware 		leather goods 
lees 		read 
leeu 		lion 
legende 		legend 
lei 		conduct direct guide head lead 
leiding 		steering 
leier 		leader 
lek 		hole 
lekker 		agreeable enjoyable lovely nice pleasant 
lekkers 		delicacy tidbit sweet 
lektor 		lector lecturer 
lelie 		lily 
lelik 		nasty ugly 
lemming 		lemming 
lemoen 		orange 
lengte 		length 
lening 		loan 
lente 		spring springtime 
lepel 		spoon 
les 		lesson 
lessenaar 		desk lectern school desk 
lettergreep 		syllable 
letterkunde 		literature 
leunstoel 		armchair 
lewe 		life 
lewendig 		adroit agile alert brisk keen 
lewer 		liver 
leër 		army 
lid 		acolyte member supporter 
lidmaatskap 		membership 
liefde 		affection love 
liefhê 		love 
lieflik 		gentle soft sweet tender 
lief 		appreciate like 
liewer 		preferably 
lig 		light 
liggaam 		body 
ligroos 		pink 
lindeboom 		lime‐tree linden‐tree 
linguïs 		linguist 
linguïsties 		linguistic 
linkerkant 		left left side 
links 		on the left 
lisensie 		licence license 
liter 		liter litre 
literatuur 		literature 
logies 		logical 
lok 		attract decoy lure 
long 		lung 
loop 		flow 
lork 		larch 
lorkboom 		larch 
lot 		destiny fate 
lourier 		laurel 
lug 		air 
lughawe 		aerodrome airdrome airfield 
lugpos 		airmail 
lugposbrief 		air letter aerogramme 
lui 		lazy 
luiperd 		leopard 
luister 		listen 
luister 		listen 
lupien 		lupine 
lupine 		lupine 
lus 		disposal inclination tendency 
luukse 		deluxe de luxe luxurious 
lyf 		body 
lyk 		appear look 
lyn 		line 
lys 		list 
lê 		lie recline 
ma 		mother 
maag 		stomach 
maak 		achieve act do make perform 
maal 		occasion time 
maaltyd 		meal 
maan 		moon 
maand 		month 
maar 		but 
maer 		gaunt lean meager skimpy skinny thin 
mag 		force strength vigour 
makker 		buddy companion comrade pal 
maklik 		easy facile 
maksimum 		maximum 
mal 		crazy insane mad nuts 
malmokkie 		guinea‐pig 
mal 		be fond of love 
man 		husband 
mandjie 		basket 
mangaan 		manganese 
mango 		mango 
manlik 		male 
mariëteklokke 		bellflower Canterbury bell 
mark 		bazaar fair market 
marmotjie 		guinea‐pig 
marter 		marten 
masboom 		pine pine‐tree 
masjien 		engine machine 
masker 		mask 
massa 		accumulation crowd heap mass multitude pile 
mat 		carpet 
materieel 		material 
matig 		moderate reasonable 
medies 		medical 
medisyne 		drug medicine pharmaceutical 
medium 		average mean middle 
meebring 		bring along take along 
meedeel 		communicate report 
meen 		account accredit believe deem 
meer 		lake loch 
meeste 		most 
meganisme 		action 
meisie 		girl lass wench 
mekaar 		each other one another 
meld 		advertise announce give notice 
melk 		milk 
meng 		blend mingle mix shuffle 
mengsel 		admixture mixture 
menigte 		accumulation crowd heap mass multitude pile 
mening 		opinion 
mens 		man human being 
mensekind 		man human being 
menslik 		human 
merendeels 		for the greater part for the most part 
merk 		find notice perceive 
mes 		knife 
met 		with 
meter 		metre 
meubel 		piece of furniture 
middag 		good afternoon 
middagete 		dinner midday meal 
mielies 		corn Indian corn maize mealies 
miljoen 		million 
millimeter 		millimetre 
min 		little 
minder 		fewer less 
mineraal 		mineral 
minimum 		minimum 
minister 		minister 
minste 		fewest least 
minuut 		minute 
mis 		fog mist 
miskien 		maybe mayhap perchance perhaps possibly 
misterieus 		abstruse mysterious 
mite 		myth 
mode 		fashion mode 
modern 		modern 
moed 		courage 
moeder 		mother 
moeg 		tired 
moeilik 		difficult hard inconvenient 
moeilikheid 		difficulty trouble 
moeite 		effort 
moet 		have to must ought to should 
mol 		mole 
mond 		mouth 
monnik 		monk 
monster 		monster 
monument 		monument 
mooi 		beautiful fine handsome lovely 
moontlik 		possible 
moontlikheid 		possibility 
moordenaar 		murderer 
moreel 		moral 
morfologie 		morphology 
mossie 		sparrow 
mot 		moth 
motel 		motel 
motor 		car 
motorfiets 		motorcycle 
motorfietsryer 		motor‐cyclist 
motorhawe 		garage 
motoris 		motorist 
motreën 		drizzle drizzling rain 
muis 		mouse 
munt 		coin 
muntstuk 		coin 
mus 		cap 
museum 		museum 
musiek 		music 
musiekinstrument 		musical instrument 
muur 		wall 
muurbal 		squash 
my 		me to me 
myl 		mile 
myn 		mine 
mynbou 		mining 
myne 		mine 
myself 		myself 
môre 		tomorrow 
môreaand 		tomorrow evening 
môreoggend 		tomorrow morning 
na 		at to toward towards 
naaldwerk 		sew 
naam 		call 
naamlik 		namely viz. 
naand 		good evening 
naaste 		nearest next 
naasteliefde 		charity love of one's neighbour 
naburig 		adjacent nearby neighbouring 
naby 		at beside by near nearby near to next to 
nadat 		after 
nadelig 		detrimentally disadvantageously prejudicially 
nader 		approach 
naderkom 		advance approach come close come closer come on 
nael 		nail 
naelpolitoer 		nail‐varnish 
nag 		night 
nagereg 		dessert 
nagklub 		night club night spot 
nagvlinder 		moth 
nakomelingskap 		offspring 
nalatenskap 		estate 
namekaar 		consecutively 
nar 		buffoon jester 
narkotiseur 		anaesthesist 
nasien 		revise 
nasionaal 		national 
nasionaliteit 		nationality 
nat 		wet 
natuur 		nature 
natuurlik 		of course 
naverwantskap 		affiliation blood‐relationship affinity relationship 
navorsing 		investigation examination test 
navraag 		question 
naweek 		week‐end 
na 		at to toward towards 
na 		decently properly 
na 		as one pleases 
nee 		no 
neef 		cousin 
neem 		accept receive take take in 
nege 		nine 
negentien 		nineteen 
negentig 		ninety 
nek 		neck 
net 		exclusively just only 
netnou 		soon 
neuk 		fuck screw 
neus 		nose 
nie 		not 
niemand 		neither nobody none no‐one 
nier 		kidney 
nietemin 		but however nevertheless yet 
nig 		niece 
niggie 		cousin 
niks 		nothing 
niks 		nothing 
nodig 		necessary 
nodig 		need require 
noem 		mention 
nog 		still yet 
nogal 		a little rather some somewhat to some extent 
nog 		not yet 
nog 		additional another 
nommer 		number numeral 
noodhulp 		first aid 
nooi 		invite 
noordelik 		northern 
noordpool‐ 		Arctic 
noordwaarts 		north northward northwards 
noot 		bank‐note 
normaal 		normal 
notisie 		annotation note 
nou‐nou 		soon 
nou 		at present now 
nou 		just just now 
nuus 		news novelty something new 
nuuskierig 		agog inquisitive 
nuut 		new novel 
nuweling 		novice 
nywerheid 		industry 
nè 		isn't it isn't that so or not 
nêrens 		nowhere 
o 		oh 
oefen 		exercise practise 
oefening 		exercise practice 
oeros 		aurochs 
of 		or 
offisieel 		official 
olie 		oil 
olifant 		elephant 
olm 		elm 
om 		at by on upon 
omdat 		because for the reason that 
omgewing 		environment environs surroundings 
omsit 		put on 
omstandigheid 		circumstance 
omtrent 		about approximately 
om 		for to in order to per 
onaangenaam 		bleak dismal dreary horrible ghastly grisly nasty 
onafhanklik 		autonomic autonomous 
ondankbaar 		thankless ungrateful unthankful 
onder 		below beneath under underneath 
onderaan 		below downstairs underneath 
onderdruk 		suppress 
onderhoud 		conversation 
onderneming 		enterprise 
onderrig 		instruction 
ondersoek 		examine 
ondersteun 		abet support sustain 
ondertoe 		down 
ondervinding 		experience 
onderwerp 		theme topic subject 
onderwys 		education 
onderwyser 		instructor teacher 
onderwyseres 		teacher female teacher 
ongedierte 		vermin 
ongeduldig 		impatient 
ongeluk 		accident 
ongelukkig 		unfortunately 
ongenaakbaar 		inaccessible 
ongetroud 		single unmarried 
onjuis 		erroneous mistaken wrong 
onlangs 		recently 
onnatuurlik 		artificial 
onnodig 		needless 
ons 		us to us 
onskuldig 		guiltless innocent 
ons 		ours 
ontbied 		get send for 
ontbreek 		be absent be missing 
ontbyt 		breakfast 
ontdek 		discover uncover 
ontdekking 		discovery 
ontevrede 		discontented displeased dissatisfied 
onthaal 		treat 
onthou 		recall recollect remember 
ontklee 		undress 
ontkom 		escape flee 
ontlok 		draw out drive out express utter give utterance to pull out 
ontmoet 		come across encounter meet see 
ontploffing 		explosion 
ontslaan 		discharge dismiss fire sack 
ontsnap 		escape flee 
ontspanning 		distraction diversion 
ontvang 		get have receive 
ontvangsdame 		receptionist 
ontvoer 		abduct 
ontwikkel 		develop reveal 
ontwikkeling 		development evolution 
onvatbaar 		immune 
oog 		eye 
oogmerk 		aim goal purpose target 
ook 		also likewise too 
oom 		uncle 
oomblik 		instant moment 
oomskind 		cousin 
oop 		open 
oopmaak 		open open up 
oor 		ear 
oordeel 		judge 
oordra 		pass spend 
ooreenkoms 		accord accordance agreement concurrence 
ooreenstemming 		accord accordance agreement concurrence 
oorgenoeg 		abundant 
oorkant 		opposite 
oorlog 		war 
oorlog 		make war wage war 
oorsend 		send transmit 
oorsig 		abridgement abstract resumé summery 
oorskadu 		cast a shadow 
oorskry 		cross go beyond transfer 
oorsprong 		origin 
oorspronklik 		aboriginal original 
oorsteek 		cross 
oorstroom 		flood 
oortollig 		overflowing superfluous 
oortreding 		sin transgression 
oortree 		sin transgress 
oorweeg 		account consider esteem regard take into account 
oorwinning 		victory 
ooste 		east East 
oostelik 		eastern Oriental 
ooswaarts 		east eastward eastwards 
op 		a in inside into on per within 
opdrag 		commission errand 
openlik 		openly 
opera 		opera 
operasie 		operation surgical operation 
opereer 		operate 
opgaan 		ascend climb go up 
ophang 		hang 
ophef 		ado din noise 
ophou 		end come to an end end up expire 
opinie 		opinion 
opklaar 		clear 
oplaai 		meet pick up 
oplei 		breed bring up educate raise 
opleiding 		education 
oplewer 		afford bear produce 
oplossing 		solution 
opmerk 		notice 
opmerking 		observation 
oppas 		advert pay attention pay attention to watch out for 
oppervlakte 		area 
oppik 		get lay hold of pick up take 
oproep 		appeal to invoke 
opsegging 		abolition abrogation 
opsig 		relation 
opsit 		put on 
opskep 		dish up 
opstaan 		get up rise stand stand up 
opstandig 		insubordinate rebellious 
optel 		get lay hold of pick up take 
optree 		act take action 
optrek 		lever lift raise 
opvatting 		idea 
opvoering 		presentation 
opwen 		strech wind up 
opwinding 		agitation excitement 
op 		at the right time in time 
oral 		all about everywhere 
oranje 		orange‐coloured 
organisasie 		organization 
organiseer 		organize 
orgidee 		orchid 
orkes 		orchestra 
oseaan 		ocean 
oud 		old 
ouderdom 		age 
ouderwets 		old‐fashioned out of date 
oudmodies 		old‐fashioned out of date 
ouer 		parent 
ouerloos 		orphan 
ouers 		parents 
ouma 		granny 
oupa 		granddad 
outyds 		old‐fashioned out of date 
o 		woe 
pa 		father 
pad 		road route way 
padda 		toad 
pak 		pack package wrap up 
pakket 		pack 
pakkie 		packet parcel 
pakplek 		box‐room storage room 
pak 		costume outfit suit 
paling 		eel 
palladium 		palladium 
pampoen 		gourd pumpkin squash 
pan 		casserole saucepan 
pap 		empty void 
papaja 		papaya papaw 
papegaai 		parrot 
paradys 		paradise 
parasiet 		parasite 
parfuum 		perfume 
parkeer 		park 
parkeerplek 		car park lay‐by parking bay parking garage parking place 
pars 		squeeze out 
party 		celebration festival party 
pas 		fit 
passasier 		passenger 
pater 		father 
patroon 		pattern stencil template templet 
pawiljoen 		pavilion 
peer 		pear 
pensioen 		pension retirement 
pensioentrekker 		retired person 
pensionaris 		retired person 
peper 		pepper 
per 		a in inside into on per within 
perd 		horse 
perdry 		ride a horse 
permanent 		abiding lasting 
perron 		platform quay wharf 
pers 		press 
persent 		percent percentage 
perske 		peach 
persoon 		person 
persoonlik 		individual 
per 		by mistake 
pet 		cap 
petrol 		gasolene gasoline petrol 
piano 		piano 
piekniek 		picnic 
piekniek 		picnic 
pienk 		pink 
piesang 		banana 
pikswart 		pitch black 
pil 		pill 
pit 		core nucleus kernel pit 
pla 		tease 
plaas 		estate farm property ranch 
plaaslik 		local 
plaat 		dial disc record 
plaatsvind 		come about happen occur 
plak 		glue stick 
plan 		intention meaning plan 
plant 		plant 
plantasie 		plantation 
plastiek 		plastic 
plattelands 		rural 
pleeg 		achieve act do make perform 
pleegkind 		foster‐child 
pleegmoeder 		foster‐mother 
pleegouers 		foster‐parents 
pleegseun 		foster‐son 
pleegvader 		foster‐father 
plek 		place 
plesier 		fun pleasure 
plig 		duty obligation 
ploert 		cheat crook rogue 
plus 		plus 
poeding 		pudding 
poeier 		powder cosmetic powder 
poging 		attempt effort 
poliesman 		policeman 
polisie 		police 
polisiestasie 		police‐station 
politiek 		political 
polities 		political 
politikus 		politician 
polshorlosie 		watch wrist‐watch 
pomp 		pump 
ponie 		pony 
poot 		leg paw 
pop 		doll puppet 
populier 		poplar 
populêr 		popular 
porsie 		share 
pos 		post 
posgeld 		postage 
posisie 		position 
poskaart 		picture postcard 
poskantoor 		post office 
poswissel 		money order 
pot 		jug pot 
potblou 		bright blue 
pous 		pope 
pouse 		break intermission pause recess 
poësie 		poetry 
praat 		speak talk 
pragtig 		lovely 
prakties 		practical 
predikant 		pastor 
prent 		film motion picture movie 
presies 		exactly sharp 
presteer 		accomplish achieve attain get reach 
pretensieus 		arrogant 
preuts 		prudish 
primitief 		primitive 
prinsipaal 		rector 
privaat‐ 		private 
privaat 		private 
probeer 		attempt test try 
probleem 		problem trouble 
produk 		product 
produksie 		production 
produseer 		afford bear produce 
proe 		taste 
professioneel 		professional 
professor 		professor 
profyt 		benefit gain profit 
program 		programme 
projek 		plan project scheme 
prokureur 		jurist lawyer 
promosie 		promotion 
proses 		action lawsuit 
protes 		protest 
protesteer 		protest 
provinsie 		province 
provizore 		temporarily 
prys 		commend glorify laud praise 
psigiater 		psychiatrist 
puberteit 		adolescence puberty 
publiek 		public 
puik 		fine great 
puisie 		pimple 
punt 		dot period point spot 
puriteins 		puritan 
put 		well 
pyl 		arrow 
pyn 		ache pain 
pynappel 		pineapple 
pyp 		pipe 
raad 		advice counsel 
raadpleeg 		consult 
raadskamer 		boardroom 
raak 		become come about grow happen 
raamwerk 		cadre frame framework 
rabbi 		rabbi 
radio 		beam ray 
radium 		radium 
rakkie 		shelf 
ram 		ram tup 
rapport 		account record report 
ras 		breed race 
ratel 		badger 
ratkas 		gear‐box gear‐case 
reageer 		react respond 
rebel 		mutineer rebel 
rede 		cause reason 
ree 		roe 
reeds 		already by now yet 
reg 		jurisprudence law 
regeer 		control govern restrain rule 
regering 		administration government 
reghoekig 		right‐angle square 
regime 		régime 
register 		account book record register 
registreer 		record register 
regmaak 		fix repair 
regop 		directly straigh ahead 
regs 		on the right 
regterkant 		right‐hand side 
regtig 		genuinely indeed really truly 
reguit 		straight ahead straight along 
regverdig 		fair just righteous 
reis 		travel 
rekenaar 		computer 
rekenbord 		abacus 
rekening 		account bill invoice 
rekenmeester 		accountant 
rekenraam 		abacus ball‐frame counting‐frame 
rektig 		absolutely genuinly indeed really truly 
rem 		brake 
renoster 		rhino rhinoceros 
reptiel 		reptile 
republiek 		republic 
res 		remainder rest 
resep 		prescription recipe 
respek 		respect 
respekteer 		respect 
retoerkaartjie 		return‐ticket 
reuk 		odor odour scent smell 
reus 		giant 
rewolwer 		revolver 
reël 		arrange fix up 
reëlmatig 		even regular 
reën 		rain 
reënboog 		rainbow 
rig 		direct guide manage steer 
rigting 		direction 
ring 		ring 
ritus 		rite 
rivier 		river 
rob 		seal sea‐dog 
robot 		robot 
robyn 		ruby 
rodium 		rhodium 
roeier 		rower 
roer 		curl froth stir whip whirl 
roete 		route 
rog 		rye 
rok 		skirt 
rol 		part role rôle 
rolletjie 		roll 
rolprent 		film motion picture movie 
romp 		skirt 
rond 		round 
rood 		red 
roofdier 		beast of prey 
rooihond 		German measles 
rooikat 		lynx 
rook 		smoke 
room 		cream 
roos 		rose 
rooster 		schedule time‐table 
rot 		rat 
rots 		rock 
rou 		crude raw rough 
rubriek 		column header 
rug 		back 
rugryer 		cadger parasite sponger 
ruik 		smell 
rukkie 		instant moment 
rus 		repose rest 
rusie 		quarrel 
rusie 		quarrel wrangle 
ry 		ride 
rybewys 		driving‐licence 
ryk 		affluent rich wealthy well‐off 
ryp 		mature ripe 
rys 		rice 
saad 		seed 
saag 		saw 
saak 		affair business business deal case matter 
saal 		saddle 
saam 		together 
saambring 		bring along take along 
saamgaan 		go with 
saamstem 		agree with 
saamwerk 		cooperate co‐operate 
saam 		with 
saans 		in the evening 
sag 		soft 
sak 		pocket 
sakeman 		businessman 
salamander 		salamander 
salaris 		salary wage wages 
salmander 		salamander 
sambreel 		umbrella 
samelewing 		society 
sand 		sand 
sandaal 		sandal 
sanger 		singer 
sanksie 		sanction 
sap 		juice sap 
sardien 		sardine 
sebra 		zebra 
sedert 		since ever since 
see 		sea 
seeanemoon 		sea‐anemone 
seehond 		seal sea‐dog 
seekoei 		hippo hippopotamus 
seer 		painful 
seer 		ache be painful hurt 
seil 		sail 
seker 		certainly 
sekerheid 		certainty 
sekerlik 		certainly 
seker 		affirm assure 
sekondêr 		accessory adventitious secondary 
sekretaresse 		secretary 
seks 		sex 
sektor 		sector 
sekuriteitsbeampte 		security officer 
selde 		seldom 
selebrasie 		celebration 
self 		self herself himself itself 
selfs 		even 
sendeling 		missionary 
sensitief 		impressible sensitive 
sent 		cent 
sentimeter 		centimetre 
sentraal 		central 
sentrale 		exchange power station 
sertifikaat 		certificate testimony 
sertifiseer 		affirm assure 
servette 		napkin 
ses 		six 
sesde 		sixth 
sestien 		sixteen 
sestig 		sixty 
seun 		son 
sewe 		seven 
sewende 		seventh 
sewentien 		seventeen 
sewentig 		seventy 
seën 		bless 
siek 		ill sick 
sielkundige 		psychologist 
sien 		come across encounter meet see 
sieraad 		adornment decoration ornament 
sigaar 		cigar 
sigaret 		cigarette 
sigbaar 		visible 
sigeuner 		gypsy Gypsy 
silicium 		silicon 
silwer 		silver 
simbool 		symbol 
simfonie 		symphony 
simpatie 		sympathy 
sin 		sentence 
sing 		sing 
sinies 		cynical 
sinneloos 		absurd 
sit 		lay down place put put down 
sitkamer 		living‐room sitting‐room 
sitplek 		seat 
situasie 		circumstances condition situation 
sjampoe 		shampoo 
sjerrie 		sherry 
sjimpansee 		chimpanzee 
sjokolade 		chocolate 
skaak 		chess 
skaal 		scale 
skaamte 		shame 
skaam 		be ashamed 
skaap 		sheep 
skaapvleis 		mutton 
skaars 		barely hardly only just scarcely 
skade 		damage 
skadu 		shadow 
skakel 		telephone 
skakering 		hue nuance shade tint 
skandaal 		commotion scandal 
skare 		accumulation crowd heap mass multitude pile 
skat 		darling 
skeef 		oblique slanting 
skeer 		shave 
skema 		model pattern scheme 
skemer 		dusk 
skep 		create 
skerm 		screen 
skerp 		sharp 
skets 		design outline sketch 
ski 		ski 
skielik 		all of a sudden suddenly 
skiereiland 		peninsula 
skil 		bark husk peel shell 
skilderagtig 		picturesque 
skildery 		painting picture 
skilpad 		tortoise 
skip 		ship vessel 
skitterend 		bright brilliant 
skoen 		shoe 
skok 		agitate shake shock 
skone 		beautiful woman beauty 
skool 		bevy collection group heap herd set 
skoolvakansie 		school holidays 
skoon 		clean 
skoonbroer 		brother‐in‐law 
skoondogter 		daughter‐in‐law 
skoonma 		mother‐in‐law 
skoonmaak 		clean cleanse make clean purge 
skoonmoeder 		mother‐in‐law 
skoonouers 		parents‐in‐law 
skoonseun 		son‐in‐law 
skop 		kick 
skottelgoed 		forks knives and spoons 
skouer 		shoulder 
skraal 		gaunt lean meager skimpy skinny thin 
skreeu 		cry out scream shout 
skrif 		script writing 
skriftelik 		written 
skryf 		write 
skrywer 		author writer 
skuim 		foam froth 
skuld 		owe 
skuldig 		guilty 
skyf 		dial disc record 
skyn 		appear appear to be seem 
skêr 		scissors 
slaaf 		slave 
slaag 		succeed 
slaai 		salad 
slaap 		be asleep sleep 
slaapkamer 		bedroom 
slag 		blow 
slagoffer 		victim 
slagter 		butcher 
slang 		serpent snake 
slavin 		bondwoman slave female slave 
slee 		sledge sleigh 
sleep 		drag tow 
sleg 		bad miserable nasty poor 
slegs 		exclusively just only 
sleutel 		key wrench 
slim 		clever cunning sly smart 
sloot 		hole ditch pit 
sluit 		close be closed 
sluk 		swallow 
smaak 		taste 
smaaklik 		nice tasty 
smeek 		beseech 
smôrens 		in the morning 
snags 		at night by night during the night 
snawel 		beak bill 
sneeu 		snow 
sneeuwit 		snow white 
snelheid 		speed 
snelheidsgrens 		speed‐limit speed limit 
sny 		clip cut shear 
so 		about approximately 
soek 		look for seek 
soen 		kiss 
soet 		gentle soft sweet tender 
sofa 		sofa 
sog 		sow 
sokker 		football soccer 
sokkie 		sock 
solank 		all the time in the meantime meanwhile 
soldaat 		pawn soldier 
somer 		summer 
sommer 		preferably 
sommige 		a few any some 
somtyds 		several times sometimes 
son 		sun sunshine 
sonde 		sin transgression 
sonder 		without 
sonnig 		solair sun sun‐ of the sun 
soogdier 		mammal 
soort 		kind sort 
sorg 		care see take care worry 
sorgvuldig 		careful tender 
sosiaal 		social 
sous 		gravy sauce 
sout 		salt 
sowaar 		absolutely actually in fact 
sowat 		about approximately 
so 		as ... as so ... as 
so 		just just now 
so 		such such a that kind of 
spaar 		save spare 
spandeer 		dedicate devote 
spanning 		tension voltage 
speel 		play 
sperma 		sperm 
spesiaal 		particular special 
spesifiek 		specific 
spierwit 		snow white 
spiraal 		spiral 
spoed 		race run 
spoel 		bobbin coil spool 
spog 		boast brag 
spook 		ghost phantom 
sport 		sport 
sportgrond 		sports ground 
spring 		jump leap spring 
sprinkaan 		grasshopper locust 
sprong 		jump leap 
spuug 		spit 
spyskaart 		menu 
staal 		steel 
staan 		abide bear carry out endure put up with suffer 
staat 		realm state 
stad 		city town 
stadigaan 		gradually little by little 
staf 		staff 
staking 		strike 
stalhings 		stallion 
stam 		stem trunk tree‐trunk 
stamboom 		generation 
standaard 		norm standard 
standbeeld 		statue 
standpunt 		viewpoint 
stap 		march walk 
stapel 		accumulation crowd heap mass multitude pile 
stapper 		stroller 
stasie 		station 
steeds 		always ever 
steel 		steal 
steenkool 		coal 
stelling 		essay thesis 
stelsel 		system 
stem 		voice 
ster 		star 
sterf 		march off retreat withdraw 
sterk 		strong 
stert 		tail 
stewig 		firm robust sturdy 
stiefbroer 		step‐brother 
stiefdogter 		step‐daughter 
stiefkind 		step‐child 
stiefmoeder 		step‐mother 
stiefsuster 		step‐sister 
stiefvader 		step‐father 
stilhou 		halt come to a halt stop 
stilswygend 		silently 
stoel 		chair 
stoep 		porch veranda 
stok 		baton cane stick 
stop 		halt stop 
storie 		account narrative story tale 
stort 		shower 
straat 		street 
straf 		punishment 
strak 		strained 
strand 		beach 
strandwolf 		hyaena 
strategies 		strategic 
streek 		region 
strek 		run 
stroom 		flow 
struik 		bush shrub 
struktuur 		structure 
studeer 		study 
student 		academic student 
studie 		study 
stuk 		fragment lump piece 
stukkend 		broken out of order 
stuur 		send transmit 
styg 		ascend get up go up lift rise arise 
styl 		style 
subsidie 		subsidy 
suggestie 		the power of suggestion 
suide 		south 
suidelik 		south southern 
suidwaarts 		south southward southwards 
suiker 		sugar 
suikerriet 		sugar‐cane 
suip 		drink drink to excess 
suiwer 		pure 
sukses 		achievement success 
sultan 		sultan 
supermark 		supermarket 
surplus 		surplus 
suster 		nurse 
susterskind 		niece 
suurlemoen 		lemon 
suurlemoensap 		lemon juice 
swaai 		brandish fling swing wave wave about 
swaan 		swan 
swaar 		burdensome heavy onerous 
swaer 		brother‐in‐law 
swak 		faint light weak 
swanger 		pregnant 
swart 		black 
swarte 		Negro 
sweer 		swear 
swem 		float swim 
swembad 		pool swimming‐bath swimming‐pool 
swerf 		migrate roam wander wander about 
swerm 		swarm 
swerwer 		Bedouin 
swyn 		hog pig swine 
sy 		his 
syfer 		cipher digit figure numeral 
syne 		his 
sy 		defecate 
sê 		say tell 
taak 		job assigned job task 
taal 		language tongue 
taamlik 		a little rather some somewhat to some extent 
tabak 		tobacco 
tafel 		table 
tafeldoek 		table‐cloth 
tafelskuimer 		cadger parasite sponger 
tagtig 		eighty 
tak 		bough branch 
takbok 		deer 
taksisboom 		yew‐tree 
tamatie 		tomato 
tandarts 		dentist 
tandpyn 		toothache 
tans 		at present now 
tant 		aunt 
taxi 		taxi 
taxibestuurder 		taxidriver taxi‐driver 
taxidrywer 		taxidriver taxi‐driver 
te 		too too much 
teater 		theatre 
tee 		tea 
teel 		breed keep raise rear 
teen 		at by on upon 
teengif 		antidote 
teenoorgesteld 		reverse reversed 
teenstelling 		antithesis contradistinction contrast opposition 
teenwoordigheid 		presence 
teer 		dainty delicate fine refined 
tegelyk 		all the time in the meantime meanwhile 
tegnies 		technical 
tegnologie 		technology 
teken 		mark sign signal token 
teks 		lyric text 
tel 		count 
telefoon 		telephone 
telegrafeer 		telegraph 
telegram 		telegram 
televisie 		television TV 
televisiestel 		TV set television set 
telraam 		abacus ball‐frame counting‐frame 
tempel 		temple 
temperatuur 		temperature 
tenk 		cistern tank 
tennis 		tennis 
tensy 		unless 
tent 		tent 
ten 		chase hunt after hunt for pursue 
ten 		at least 
ten 		as to as regards concerning 
ten 		despite in spite of notwithstanding 
term 		term 
tert 		pie tart 
terug 		back 
terugbesorg 		give back return 
terugkom 		come back return 
terwyl 		for during whereas while whilst 
tevrede 		contented pleased satisfied 
te 		afoot on foot 
tien 		ten 
tier 		leopard 
tikster 		typist 
tipe 		type 
tipies 		characteristic 
tjek 		check cheque 
tjekboek 		cheque‐book 
toe 		at to toward towards 
toegang 		entrance portal 
toeganklik 		accessible 
toekoms 		future 
toemaak 		close shut 
toepas 		apply practice 
toeristeburo 		tourist bureau 
toernooi 		tournament 
toeskouer 		spectator 
toespreek 		accost address 
toestand 		circumstances condition situation 
toestel 		apparatus device set 
toeter 		hooter 
toetree 		join 
toets 		test 
toevlugsoord 		asylum 
toevoeg 		add 
tog 		certainly indeed rather surely 
toilet 		toilet 
toneel 		scene 
toneelspel 		acting 
tongvis 		sole 
toon 		indicate point out show 
toonbank 		counter 
top 		agreed okay 
toring 		castle tower 
tot 		until till 
totaal 		overall total 
totdat 		until till 
tot 		until till 
tot 		bye goodbye so long 
tou 		file line rank row turn 
towenaar 		enchanter magician sorcerer warlock wizard 
tower‐ 		magic 
traan 		tear 
tradisie 		tradition 
tradisioneel 		traditional 
tragedie 		tragedy 
transparant 		transparant 
trap 		staircase stairs 
trawant 		satellite 
tref 		catch hit run across strike 
trein 		train 
trek 		drag draw haul pull tug 
trommel 		drum 
troos 		comfort console 
trop 		bevy collection group heap herd set 
tropies 		tropical 
trots 		proud 
trottoir 		pavement sidewalk 
trou 		marry be married get married 
tuin 		garden 
tuinmaak 		gardening 
tuis 		at home 
tulp 		tulip 
tussen 		among between 
twaalf 		twelve 
twak 		tobacco 
twee 		two 
tweede 		second 
tweekeer 		twice 
tweeling 		twin 
twintig 		twenty 
twyfel 		doubt 
tyd 		time while 
tydelik 		provisional temporary 
tydens 		for during whereas while whilst 
tydperk 		age epoch era 
tydskrift 		periodical 
u 		your 
ui 		onion 
uit 		from out of 
uitbeeld 		depict represent 
uitdaging 		challenge 
uitdeel 		deal distribute 
uitdruk 		express 
uitdrukking 		expression 
uiteindelik 		at last finally ultimately 
uitgaan 		exit go out 
uitgawe 		edition 
uitgee 		issue publish 
uitgeput 		exhausted used up 
uitgesluit 		exclusive 
uitgestrek 		extensive spacious vast wide 
uitgewer 		publisher 
uithaal 		draw out drive out express utter give utterance to pull out 
uithou 		abide bear carry out endure put up with suffer 
uitleen 		advance lend 
uitnodiging 		invitation 
uitnooi 		invite 
uitpak 		unpack 
uitroei 		exterminate wipe out 
uitrusting 		accoutrement accoutrements equipment 
uitsig 		view 
uitslag 		conclusion effect result 
uitsluit 		exclude 
uitsonderlik 		exceptional 
uitspraak 		pronunciation 
uitstalling 		exhibition exposition 
uitstappie 		excursion outing sightseeing trip 
uitstekend 		fine very well 
uitvind 		invent 
uitvoer 		export 
uniek 		unique 
uniform 		uniform 
universiteit 		university 
uraan 		uranium 
uself 		yourself 
uur 		hour o'clock time 
u 		yours 
vader 		father 
vak 		branch compartment department pigeonhole section speciality 
vakant 		vacant 
val 		drop fall 
valk 		falcon 
vals 		false 
vampier 		vampire 
van 		surname 
vanaand 		this evening 
vanaf 		from since 
vandag 		today 
vang 		capture catch grapple 
vanmiddag 		this afternoon 
van 		from out of 
van 		naturally 
variasie 		variety 
vark 		hog pig swine 
varkie 		piglet 
vars 		fresh recent 
vars 		fresh water 
vas 		abiding lasting 
vashou 		hang onto hold 
vasmaak 		attach determine fasten fix affix make fast secure 
vasstel 		attach determine fasten fix affix make fast secure 
vasteland 		continent mainland 
vat 		capture catch grapple 
vee 		livestock 
veelvraat 		wolverine 
veertien 		fourteen 
veertig 		forty 
veg 		fight struggle 
veilig 		safe secure 
veiligheid 		safety security 
vel 		skin 
veld 		field 
veldspaat 		feldspar felspar 
veldsprinkaan 		grasshopper locust 
veldtog 		campaign 
venster 		window 
ver 		away 
veral 		above all especially 
verander 		alter change 
verantwoordelik 		accountable responsible 
verbaas 		amaze 
verbaas 		marvel marvel at wonder 
verband 		bandage 
verbeelding 		imagination 
verbeeld 		fancy imagine 
verbind 		combine 
verbinding 		connection 
verbleik 		fade 
verblyf 		stay 
verborge 		hidden 
verbrand 		burn 
verbrands 		darn 
verbruiker 		consumer 
verby 		beyond past 
verbygaan 		pass pass by 
verbyganger 		passer‐by 
verbykom 		pass pass by 
verbysteek 		overhaul overtake pass 
verbysterd 		dazed perplexed upset 
verdedig 		defend 
verdien 		earn gain win 
verdieping 		floor storey story 
verduidelik 		account for explain 
verduideliking 		account explanation 
verdwaal 		lose one's way 
verdwyn 		disappear 
vereis 		demand postulate require 
vereiste 		requisite 
vereniging 		association 
vergadering 		meeting 
vergeef 		forgive pardon 
vergeet 		forget 
vergelding 		compensation reward 
vergelyk 		compare 
vergelyking 		comparison 
vergifnis 		absolution pardon 
verhaal 		story history 
verhole 		hidden 
verhouding 		proportion rate 
verhuis 		move 
verjaarsdag 		birthday 
verkeer 		traffic 
verkeerd 		erroneous mistaken wrong 
verkeersknoop 		traffic block traffic congestion traffic jam traffic tie‐up 
verkeersreëls 		traffic rules 
verkies 		choose elect pick out 
verklaar 		declare state 
verklaring 		declaration proclamation 
verkoop 		dispose of sell vend 
verkoopsman 		salesman 
verlaat 		abandon forsake desert leave quit 
verlaging 		decrease lowering 
verlang 		desire wish 
verlang 		ache for 
verlede 		past 
verlies 		loss 
verlof 		furlough leave pass 
verloofde 		bride fiancée 
verloor 		lose 
verlos 		release 
verlossing 		salvage salvation recovery 
verlëe 		in distress 
vermaak 		entertainment 
vermeld 		mention 
verminder 		abate abridge decrease lessen 
vermink 		top truncate 
vermoë 		ability 
vermy 		avoid evade 
verneder 		abase 
veronderstel 		hypothesize 
veroorsaak 		activate cause give rise to 
verorber 		eat up 
verplaas 		move transfer 
verpleeg 		attend nurse tend to 
verpleegster 		nurse 
verplig 		compel force 
verpligting 		duty obligation 
verraad 		betrayal treachery 
verrassing 		surprise 
verruklik 		delightful lovely 
vers 		verse 
versamel 		collect gather pick up 
versameling 		collection 
verseker 		insure 
versekering 		insurance 
versie 		version 
versigtig 		careful cautious 
verskeie 		several 
verskil 		differ be different 
verskillend 		different 
verskole 		hidden 
verskoon 		excuse me 
verskriklik 		awfully 
verskyn 		appear emerge perform 
verslaan 		defeat win over 
verslag 		account record report 
verslank 		slim 
versoek 		request 
versoeking 		temptation 
verstaan 		understand realize 
verstel 		adjust put right 
vertaal 		translate 
vertaling 		translation 
verteenwoordiger 		agent representative 
vertel 		narrate relate tell 
vertolk 		interpret 
vertolking 		interpretation 
vertoning 		presentation 
vertoon 		indicate point out show 
vertraging 		delay retardation 
vertrek 		absent onself depart go away leave 
vertroue 		confidence faith trust 
vertroue 		rely on trust in 
vertrouwe 		have faith have faith in trust 
vervaardig 		fabricate manufacture 
vervang 		take the place of 
vervelig 		boring stodgy 
vervoer 		transport 
verwag 		abide expect wait await wait for 
verwant 		affined akin related 
verwantskap 		affiliation blood‐relationship affinity relationship 
verwantskapsbetrekking 		affiliation blood‐relationship affinity relationship 
verwar 		entangle implicate 
verward 		dazed perplexed upset 
verwerf 		achieve acquire attain get obtain 
verwysing 		reference 
veselperske 		mango 
vet 		fat fatty greasy 
vetterig 		fat fatty greasy 
vier 		four 
vierde 		fourth 
viering 		celebration 
vinger 		finger 
vinnig 		fast quick rapid speedy swift 
viool 		violin 
viooltjie 		violet 
vir 		at to toward towards 
virus 		virus 
vis 		fish 
visie 		opinion 
visser 		fisherman 
visvang 		fish 
vitamien 		vitamin 
vitamine 		vitamin 
vla 		cream 
vlag 		banner flag 
vlam 		flame 
vlei 		flatter 
vleis 		meat 
vleisbraai 		barbecue 
vleuel 		wing 
vlieg 		fly 
vliegtuig 		aeroplane airplane plane 
vliegveld 		aerodrome airdrome airfield 
vlierboom 		elder 
vloei 		flow 
vloeistof 		liquid 
vlug 		flee run away 
voedsel 		food nourishment 
voegwoord 		conjunction 
voel 		feel sense 
voertuig 		vehicle 
voetslaner 		stroller 
vol 		complete full 
volg 		follow 
volgende 		following next 
volgens 		according as according to as by 
volledig 		entire overall whole 
volstruis 		ostrich 
volume 		volume 
volwasse 		adult full‐grown 
vol 		fill fill in fill up 
voor 		before in front of 
voorbeeld 		example 
voorberei 		prepare 
voordeel 		advantage benefit 
voorgereg 		entrée 
voorgrond 		fore 
voorheen 		ahead formerly previously 
voorkom 		prevent 
voorkop 		forehead 
voorletter 		initial 
voormalige 		former last previous prior 
voornaam 		first name 
voorraad 		supply 
voorreg 		privilege 
voorsit 		serve 
voorsitter 		chairman president 
voorskrif 		regulation 
voorspelling 		prophecy 
voorstad 		suburb 
voort 		ahead foreward on 
voorval 		event occasion occurence opportunity 
voorwoord 		foreword 
voor 		before previous to 
vorentoe 		ahead foreward on 
vorm 		form shape 
voël 		bird 
vra 		ask 
vraag 		question 
vragmotor 		lorry truck 
vrede 		peace 
vreedsaam 		peaceful 
vreemd 		alien foreign strange 
vrees 		fear 
vreeslik 		awfully 
vreugde 		gladness joy 
vriend 		friend 
vriendelik 		affable friendly good‐natured kind 
vriendelikheid 		kindness 
vriendin 		friend 
vries 		freeze 
vrieshok 		freezer 
vroeg 		early 
vroegtydig 		early 
vroeër 		ahead formerly previously 
vroeëre 		former last previous prior 
vrolik 		cheerful gay merry 
vrou 		wife 
vroulik 		female feminine 
vrug 		fruit 
vrugbaar 		fertile 
vrugteloos 		abortive useless 
vryf 		rub 
vryheer 		baron 
vryheid 		freedom 
vrymaak 		release 
vrywilliger 		volunteer 
vuil 		dirty filthy nasty soiled unclean 
vuis 		fist 
vulkaan 		volcano 
vurk 		fork 
vuur 		fire 
vuurhoutjie 		match 
vyand 		adversary enemy 
vyandelik 		adverse hostile 
vyf 		five 
vyfde 		fifth 
vyftien 		fifteen 
vyftig 		fifty 
waag 		dare 
waai 		blow 
waar 		where 
waarborg 		guarantee warrant 
waarde 		value worth 
waardeer 		appreciate 
waardevol 		costly valuable 
waarheen 		where where ... to whither 
waarheid 		truth 
waarin 		wherein 
waarmee 		whereby 
waarnatoe 		where where ... to whither 
waarom 		what for wherefore why 
waarsku 		caution warn 
waarskuwing 		warning 
waarskynlik 		probably 
waarvandaan 		from where whence 
waar 		where where ... to whither 
waatlemoen 		water‐melon 
wag 		abide expect wait await wait for 
wagkamer 		waiting‐room waiting room 
wag 		abide expect wait await wait for 
walvis 		whale 
wandel 		go for a walk stroll 
wandelaar 		stroller 
wandelpad 		path 
wang 		cheek 
want 		as because for since 
ware 		goods wares 
warm 		warm 
was 		wax 
wat 		what 
water 		water 
watter 		which 
wedstryd 		competition contest 
weduwee 		widow 
week 		soften up 
weekliks 		weekly 
weeldeartikel 		luxury 
weens 		because of on account of 
weer 		afresh again all over again anew 
weeskind 		orphan 
weet 		know know how 
weggesteek 		hidden 
weghardloop 		abscond 
wegsteek 		put away stow 
wegstuur 		dismiss turn away 
weier 		refuse reject 
weiering 		refusal 
wekker 		alarm alarmclock 
welke 		which 
welkom 		welcome 
welvaart 		well‐being 
wen 		earn gain win 
wenk 		hint tip 
wenkbrou 		brow eyebrow 
werk 		function operate run work 
werker 		hand laborer labourer operative worker working man workman 
werkersklas 		working class working classes 
werkgewer 		employer 
werklik 		true 
werklikheid 		actuality 
werkloos 		unemployed 
werkloosheid 		unemployment 
werknemer 		employee 
werktuigkundige 		mechanic 
werkwoord 		verb 
wesel 		weasel 
westelik 		western 
wet 		law 
wetenskap 		science 
wewenaar 		widower 
whisky 		whisky whiskey 
wie 		who 
wiel 		wheel 
wie 		of which which one's whose 
wil 		be willing to want wish 
wildebees 		gnu wildebeest 
wilde 		wild boar 
wilgerboom 		willow 
wind 		wind 
winkel 		boutique shop store 
winkelvenster 		show window 
wins 		gain profit 
winter 		winter 
wiskunde 		mathematics 
wiskundig 		mathematical 
wissel 		interchange swap 
wit 		white 
witmens 		European white man 
woekerplant 		parasite 
woestynbewoner 		Bedouin 
wol 		wool 
wolf 		wolf 
wolvin 		she‐wolf 
wond 		injury wound 
wonder 		ask oneself wonder 
wonderbaarlik 		miraculous 
woning 		abode accommodation dwelling residence 
woon 		dwell live 
woonstel 		apartment flat 
woord 		word 
woordeboek 		dictionary vocabulary 
word 		become come about grow happen 
wors 		sausage 
wortel 		carrot 
wreedaardig 		cruel 
wurm 		worm 
wyn 		wine 
wys 		manner mode way 
wyse 		manner mode way 
wysheid 		wisdom 
wysie 		melody tune 
wêreld 		world 
xeres 		sherry 
xilofoon 		xylophone 
yoghurt 		yoghourt yoghurt 
ys 		ice icecream 
yster 		iron 
ytterbium 		ytterbium 
zirkonium 		zirconium 
bak, 		jug box container vessel 
'n 		a an 
'n 		a little rather 
'n 		a few any some 
'n 		recently 
'n 		an hour's walk 
