Aandster 		Venus 
Abessinies 		abessynisch 
Abessinië 		Abessinien 
Abessiniër 		Abessinier 
Achilles 		Achilles 
Adam 		Adam 
Adriatiese See 		Adria Adriatisches Meer 
Afgaan 		Afghane 
Afgaans 		afghanisch 
Afganistan 		Afghanistan 
Afrika 		Afrika 
Afrikaan 		Afrikaner 
Afrikaans 		afrikanisch 
Afrikaner 		Afrikaander Afrikander Bure 
Afrikanertroos 		Kaffee 
Afro‐Asiaties 		afro‐asiatisch 
Agter‐Indië 		Hinterindien 
Aken 		Aachen 
Albaans 		albanesisch albanisch 
Albanees 		albanesisch albanisch 
Albanies 		albanesisch albanisch 
Albaniese taal 		Albanesisch Albanisch 
Albanië 		Albanien 
Algerië 		Algerien 
Algeryn 		Algerier 
Algeryns 		algerisch 
Allah 		Allah 
Allerheilige 		Allerheiligen 
Allersiele 		Allerseelen 
Alpe 		Alpen 
Amerika 		Amerika 
Amerikaans 		amerikanisch 
Amerikaner 		Amerikaner 
Anatolië 		Anatolien 
Angel‐Sakser 		Angelsachse 
Angel‐Saksies 		angelsächsisch 
Anglikaans 		anglikanisch 
Angola 		Angola 
Annunsiasie 		Mariä Verkündigung 
Antille 		Antillen 
April 		April 
Arabier 		Araber 
Arabies 		arabisch 
Arabië 		Arabien 
Ardenne 		Ardennen Ardennerwald 
Argentinië 		Argentinien 
Argentyn 		Argentinier 
Argentyns 		argentinisch 
Argus 		Argus 
Aries 		arisch 
Ariër 		Arier 
Armenies 		armenisch 
Armenië 		Armenien 
Armeniër 		Armenier 
Asdag 		Aschermittwoch 
Asepoestertjie 		Aschenbrödel 
Asiaat 		Asiat 
Asiaties 		asiatisch 
Asië 		Asien 
Assiries 		assyrisch 
Assirië 		Assyrien 
Assiriër 		Assyrer 
Atheens 		athenisch 
Athene 		Athene 
Athener 		Athener 
Atlanties 		Atlantik‐ 
Atlantiese Oseaan 		Atlantischer Ozean 
Atlas 		Atlas 
Augias 		Augias 
Augiasstal 		Augiasstall 
Augustus 		August 
Aurora 		Aurora 
Australies 		australisch 
Australië 		Australien 
Australiër 		Australier 
Babilonies 		babylonisch 
Babilonië 		Babylonien 
Balkan 		Balkan 
Balties 		baltisch 
Baltiese See 		Baltisches Meer Ostsee 
Bantoe‐ 		Bantu‐ 
Bantoe 		Bantu 
Bask 		Baske 
Baskies 		baskisch 
Bataaf 		Bataver 
Bataviaan 		Bataver 
Batavier 		Bataver 
Beier 		Bayer 
Beiere 		Bayern 
Beiers 		bayerisch bayrisch 
Belg 		Belgier 
Belgies 		belgisch 
België 		Belgien 
Belgrado 		Belgrad 
Benediktyner 		Benediktiner 
Benediktynermonnik 		Benediktiner 
Benelux 		Benelux 
Bengaals 		bengalisch 
Bengaalse vuur 		bengalisches Feuer 
Bengale 		Bengalen 
Berlyn 		Berlin 
Berlyner 		Berliner 
Berlyns 		berliner 
Bern 		Bern 
Betlehem 		Bethlehem 
Betsjoeanaland 		Botswana 
Birma 		Birma 
Birmees 		birmanisch 
Bisantium 		Byzanz 
Bisantyns 		byzantinisch 
Bloubaard 		Blaubart 
Boeddha 		Buddha 
Boekarest 		Bukarest 
Boer 		Afrikaander Afrikander Bure 
Boesman 		Buschmann 
Boheems 		böhmisch 
Boheme 		Böhmen 
Boliwië 		Bolivien 
Brabander 		Brabanter 
Brabant 		Brabant 
Brabants 		brabantisch 
Brasiliaan 		Brasilianer 
Brasiliaans 		brasilianisch 
Brasilië 		Brasilien 
Bretagne 		Bretagne die Bretagne 
Brit 		Brite 
Brits 		britisch 
Brunswyk 		Braunschweig 
Brussel 		Brüssel 
Brussels 		brüsseler 
Brusselse spruitjies 		Rosenkohl 
Bulgaar 		Bulgare 
Bulgaars 		bulgarisch 
Bulgarye 		Bulgarien 
Bybel 		Bibel 
Caesar 		Cäsar 
Calvyn 		Kalvin 
Chileen 		Chilene 
Chileens 		chilenisch 
Chili 		Chile 
China 		China 
Chinees 		chinesisch 
Christen 		Christ 
Christendom 		Christentum 
Christus 		Christus 
Cipries 		zyprisch 
Ciprioot 		Zypriot 
Ciprus 		Zypern 
Dalmasië 		Dalmatien 
Deen 		Däne 
Deens 		dänisch 
Denemarke 		Dänemark 
Desember 		Dezember 
Dinsdag 		Dienstag 
Donau 		Donau 
Donderdag 		Donnerstag 
Driekoninge 		Dreikönigsfest 
Driekoningefees 		Dreikönigsfest 
Duits 		Deutsch deutsche Sprache 
Duitser 		Deutscher 
Duitse taal 		Deutsch deutsche Sprache 
Duitsland 		Deutschland 
Edam 		Edam 
Eden 		Eden 
Egipte 		Ägypten 
Egiptenaar 		Ägypter 
Egipties 		egyptisch 
Eksodus 		Exodus 
Elsasies 		elsässisch 
Elsasser 		Elsässer 
Engeland 		England 
Engels 		englisch 
Engelsman 		Engländer 
Eskimo 		Eskimo 
Esperanto 		Esperanto 
Est 		Este 
Estland 		Estland 
Ests 		estisch 
Ethiopië 		Äthiopien 
Europa 		Europa 
Europeaan 		Europäer 
Europees 		europäisch 
Europese bison 		Wisent 
Europeër 		Europäer 
Februarie 		Februar 
Fins 		finnländisch 
Frankryk 		Frankreich 
Frans 		französisch 
Franse taal 		Französisch französische Sprache 
Genesis 		Genesis 
Geneve 		Genf 
Genua 		Genua 
Germaan 		Germane 
God 		Gott 
Goties 		gotisch 
Griek 		Grieche 
Griekeland 		Griechenland 
Grieks 		griechisch 
Groenland 		Grönland 
Groot‐Brittanje 		Britannien 
Havanna 		Havana 
Hebreeus 		hebräisch 
Hebreër 		Hebräer Jude 
Helleens 		altgriechisch hellenisch 
Hindoe 		Hindu 
Holland 		Holland 
Hollander 		Holländer 
Hollands 		holländisch 
Hongaar 		Ungar 
Hongaars 		ungarisch 
Hongarye 		Ungarn 
Ier 		Ire 
Ierland 		Irland 
Indiaan 		Indianer 
Indies 		indisch 
Indiese tier 		Tiger 
Indië 		India Indien 
Indiër 		Inder 
Indo‐China 		Hinterindien 
Indo‐Sjina 		Hinterindien 
Islam 		Islam 
Israel 		Israel 
Israeliet 		Hebräer Jude 
Italiaan 		Italiener 
Italiaans 		italienisch 
Italianer 		Italiener 
Italië 		Italien 
Januarie 		Januar 
Japannees 		japanisch 
Japanner 		Japaner 
Japans 		japanisch 
Jood 		Hebräer Jude 
Joods 		jüdisch 
Julie 		Juli 
Junie 		Juni 
Kalifornië 		Kalifornien 
Kanada 		Kanada 
Kanadees 		kanadisch 
Kanaries 		kanarisch 
Kanariese Eilande 		Kanarische Inseln 
Kapitool 		Kapitol 
Karpate 		Karpathen 
Kaïro 		Kairo 
Kelties 		gälisch 
Kersfees 		Weihnachten 
Keulen 		Köln 
Kopenhagen 		Kopenhagen 
Kroasië 		Kroatien 
Kuba 		Kuba 
Kubaan 		Kubaner 
Lap 		Lappländer 
Lapland 		Lappland 
Laplander 		Lappländer 
Latyn 		Latein 
Latyns 		lateinisch 
Leiden 		Leiden 
Litaue 		Litauen 
Litauer 		Lithauer 
Litaus 		lithauisch 
Londen 		London 
Lotaringe 		Lothringen 
Lucifer 		Luzifer 
Luik 		Lüttich 
Lusern 		Luzern 
Maandag 		Montag 
Maart 		März 
Madonna 		Madonna 
Madrid 		Madrid 
Maria‐ligmis 		Lichtmeß 
Marokko 		Marokko 
Mei 		Mai 
Moedermaagd 		Madonna 
Mohammedanisme 		Islam 
Nederlander 		Holländer Niederländer 
Nederlands 		holländisch niederländisch 
Noor 		Norweger 
Noors 		norwegisch 
Noorweegs 		norwegisch 
Noorweë 		Norwegen 
Noorweër 		Norweger 
November 		November 
Nuwejaarsdag 		Neujahrstag 
Oekraine 		Ukraine die Ukraine 
Oktober 		Oktober 
Oos‐Duitsland 		Deutsche Demokratische Republik DDR 
Oossee 		Baltisches Meer Ostsee 
Oostenryk 		Österreich 
Oostenryker 		Österreicher 
Oostenryks 		österreichisch 
Paasfees 		Ostern 
Parys 		Paris 
Pase 		Ostern 
Peking 		Peking 
Persies 		persisch 
Pireneë 		Pyrenäen 
Pole 		Polen 
Pool 		Pole 
Pools 		polnisch 
Portugees 		portugiesisch 
Roemeen 		Rumäne 
Roemenië 		Rumänien 
Roemeniër 		Rumäne 
Rome 		Rom 
Rooihuid 		Indianer 
Rus 		Russe 
Rusland 		Rußland 
Russies 		russisch 
Satan 		Satanas Teufel 
September 		September 
Serwies 		serbisch 
Serwiër 		Serbe 
Sjina 		China 
Sjinees 		chinesisch 
Skot 		Schotte 
Skotland 		Schottland 
Skots 		schottisch 
Spaans 		spanisch 
Spaanse taal 		Spanisch spanische Sprache 
Spanje 		Spanien 
Steenbok 		Steinbock 
Suid‐Afrika 		Südafrika 
Suid‐Amerika 		Südamerika 
Suidpool‐ 		antarktisch südpolar 
Swede 		Schweden 
Sweed 		Schwede 
Sweeds 		schwedisch 
Switser 		schweizerisch 
Switserland 		Schweiz die Schweiz 
Tsjeggies 		tschechisch 
Turk 		Türke 
Turks 		türkisch 
Turkye 		Türkei die Türkei 
VSA 		Vereinigten Staaten 
Vatikaan 		Vatikan 
Venus 		Venus 
Vlaams 		flämisch flandrisch 
Vlaandere 		Flandern 
Vrouedag 		Lichtmeß 
Vrydag 		Freitag 
Waleland 		Wallonien 
Wallis 		Wales 
Westers 		westlich 
Woensdag 		Mittwoch 
Wolga 		Wolga 
Ysland 		Island 
Zeus 		Zeus 
a 		ach o ho oh 
aag 		weh wehe 
aai 		schmeicheln 
aaklig 		wiederwärtig 
aakligheid 		Abscheu Greuel 
aal 		Aal 
aalbessie 		Johannisbeere 
aalbessiebos 		Johannisbeerstrauch 
aalmoes 		Almosen 
aalwee 		Aloe 
aalwyn 		Aloe 
aambeie 		Hämorrhoiden 
aamborstigheid 		Asthma 
aan 		an in nach zu 
aanbehoort 		gehören angehören zugehören 
aanbel 		anläuten klingeln anklingeln 
aanbesteding 		Lieferungsausschreibung Verdingung 
aanbestee 		öffentlich ausschreiben verdingen 
aanbetref 		angehen anlangen betreffen 
aanbetrou 		betrauen mit vertrauen mit Vertrauen setzen in zutrauen 
aanbeveel 		empfehlen 
aanbeveelbaar 		empfehlungswert 
aanbevelenswaardig 		empfehlungswert 
aanbeveling 		Empfehlung 
aanbid 		anbeten verehren vergöttern 
aanbidbaar 		anbetenswert 
aanbiddelik 		anbetenswert 
aanbieding 		Anerbieten Offerte 
aanblik 		Anblick Aussehen 
aanbly 		bleiben übrigbleiben 
aanbod 		Anerbieten Offerte 
aanbou 		Anbau 
aanbrand 		anbrennen 
aanbrandsteker 		Funke 
aanbreek 		anbrechen 
aanbring 		bringen anbringen eintragen heranbringen überbringen 
aand 		Abend 
aandag 		Achtung Aufmerksamkeit 
aandagtig 		aufmerksam 
aandagtigheid 		Zuvorkommenheit 
aandblad 		Abendzeitung 
aandeel 		Aktie Anteilschein 
aandeelhebber 		Aktieninhaber Aktionär 
aandeelhouer 		Aktieninhaber Aktionär 
aandenking 		Andenken 
aandete 		Abendessen Abendmahl Souper 
aandgrou 		Zwielicht 
aandien 		ankündigen anzeigen avisieren melden anmelden verkünden 
aandiening 		Annonce Anzeige Inserat 
aandkoerant 		Abendzeitung 
aandoen 		berühren 
aandoening 		Affekt Bewegung Rührung Gemütsbewegung 
aandoenlik 		ergreifend 
aandra 		bringen anbringen eintragen heranbringen überbringen 
aandraag 		bringen anbringen eintragen heranbringen überbringen 
aandrang 		Andrang 
aandrif 		Andrang Andrift Antrieb Impuls Trieb 
aandring 		andringen beharren auf drängen trotzen 
aandryf 		anfeuern jagen treiben vor sich hertreiben 
aandrywe 		anfeuern jagen treiben vor sich hertreiben 
aandskemering 		Zwielicht 
aandui 		andeuten weisen anweisen zeigen 
aaneen‐ 		aneinander‐ 
aaneen 		aneinander beisammen gesamt insgesamt zugleich zusammen 
aaneenbind 		verbinden verknüpfen 
aaneenskakeling 		Aneinanderreihung Reihenfolge Verkettung 
aaneensluit 		verdichten 
aaneenvoeg 		fügen gesellen vereinigen 
aanfluiting 		Hohn Spott Spotten 
aangee 		angeben anzeigen denunzieren hinterbringen 
aangenaam 		behaglich herrlich genehm angenehm 
aangesien 		da weil 
aangeskote 		angeheitert 
aangetroud 		Schwieger‐ 
aangetroude broer 		Schwager 
aangewing 		Anzeige 
aangifte 		Angabe Anzeige 
aangrensend 		angrenzend anstoßend 
aangry 		bewegen erschüttern rühren 
aanhaal 		anführen erwähnen nennen zitieren 
aanhaling 		Zitat 
aanhang 		Anhang 
aanhanklik 		anhänglich zugetan ergeben 
aanhou 		tierzüchten 
aanhoudelik 		fest 
aanhoudend 		fest 
aanhouding 		Arrest Haft 
aankla 		anklagen beschuldigen 
aanklaag 		anklagen beschuldigen 
aanklae 		anklagen beschuldigen 
aankoms 		Ankunft Eintreffen 
aankondig 		ankündigen anzeigen avisieren melden anmelden verkünden 
aankondiging 		Annonce Anzeige Inserat 
aankyker 		Zuschauer 
aanland 		ankommen eintreffen gelangen zukommen herzukommen 
aanloksel 		Anreiz 
aanlonk 		gaffen 
aanloop 		Anlauf 
aanlê 		stranden 
aanmaak 		anfertigen fabrizieren herstellen verfertigen 
aanmaan 		anhalten vermahnen zureden 
aanmaning 		Ermahnung Zuspruch 
aanminlik 		allerliebst anmutig hold lieblich reizend 
aanmoedig 		ermannen ermutigen 
aanneem 		annehmen empfangen genehmigen 
aanneemlik 		glaubhaft 
aanpak 		erproben probieren prüfen versuchen 
aanplakbiljet 		Affiche Anschlag Anschlagzettel 
aanprys 		empfehlen 
aanprysing 		Empfehlung 
aanraai 		raten beraten ratgeben 
aanraak 		rühren anrühren berühren tangieren 
aanrading 		Rat Ratschlag 
aanraking 		Berührung 
aanrand 		ein Anschlag ausführen ein Attentat ausführen 
aanranding 		Anschlag Attentat 
aanroep 		anrufen zurufen 
aans 		eventuell möglicherweise vielleicht wohl 
aansien 		Anblick Aussehen 
aansies 		eventuell möglicherweise vielleicht wohl 
aansig 		Anblick Aussehen 
aansit 		antun anziehen 
aanskakel 		anstellen 
aanskerp 		schleifen wetzen 
aanslag 		Anschlag Attentat 
aansluiting 		Union 
aansoek doen 		erstreben sich bestreben sich bewerben um trachten nach 
aanspreeklik 		verantwortlich 
aanstaande 		bevorstehend kommend künftig nächst nahe 
aansteker 		Funke 
aansterf 		erben beerben 
aanstoot 		Ärgernis Skandal 
aansyn 		Bestehen Dasein Existenz 
aansê 		ankündigen anzeigen avisieren melden anmelden verkünden 
aantal 		Anzahl Zahl 
aanteken 		registrieren 
aantekening 		Aufzeichnung Note Notiz 
aantonende wys 		Indikativ 
aantoon 		andeuten weisen anweisen zeigen 
aantrek 		antun anziehen 
aantrekkingskrag 		Anziehungskraft 
aanvaar 		annehmen empfangen genehmigen 
aanvaarding 		Annahme Aufnahme Übernahme Zusage 
aanval 		anfallen angreifen ausfallen befallen überfallen 
aanvallig 		allerliebst anmutig hold lieblich reizend 
aanvalligheid 		Anmut 
aanvang 		anbrechen anfangen beginnen 
aanvangsletter 		Initial 
aanvanklik 		anfänglich 
aanvul 		vervollständigen 
aanwesig 		anwesend 
aan die ander kant 		anderseits 
aan die brand steek 		zünden entzünden 
aan die een kant 		einerseits 
aan my 		mir 
aan wie 		wem 
aap 		Affe 
aar 		Ähre 
aarbei 		Erdbeere 
aarbeiboomvrug 		Erdbeerbaum 
aard 		Charakter Gemüt 
aardbewing 		Erdbeben 
aardbol 		Erdball Erdkugel 
aarde 		Boden Erdboden Erde Grund Land Terrain 
aardgees 		Gnom 
aardhommel 		Hummel 
aardig 		hübsch 
aardkloot 		Erdball Erdkugel 
aardkunde 		Geologie 
aardmannetjie 		Gnom 
aardmeetkunde 		Feldmeßkunst Geodäsie Vermessungskunst 
aardmeting 		Feldmeßkunst Geodäsie Vermessungskunst 
aardrykskunde 		Erdbeschreibung Erdkunde Geographie 
aards 		irdisch terrestrisch 
aardskudding 		Erdbeben 
aardtrilling 		Erdbeben 
aars 		After 
aartappel 		Erdapfel Kartoffel 
aartsbiskop 		Erzbischof 
aartsherog 		Großherzog 
aartspriester 		Pontifex 
aartsvader 		Erzvater Patriarch 
aas 		Anreiz 
aasvoël 		Geier 
ab 		Abt 
abakus 		Abakus 
abc 		Alphabet 
abdominaal 		den Unterbauch betreffend 
abdy 		Abtei 
abeel 		Espe Zitterpappel 
ablatief 		Ablativ 
abonnement 		Abonnement 
absensie 		Abwesenheit 
absent 		abwesend 
abses 		Abszeß Eiterbeule Geschwulst 
absint 		Absinth 
absolutisme 		Absolutismus 
abstrak 		abstrakt begrifflich unwirklich 
absurd 		abgeschmackt absurd ungereimt widersinnig 
absurditeit 		Verdrehtheit 
abuis 		Fehler Irrtum Versehen 
achternadraai 		Erfolg Ergebnis Resultat 
acre 		Acker 
adagio 		Adagio 
adder 		Natter 
adekwaat 		adäquat angemessen entsprechend 
adel 		Adel 
adelaar 		Adler 
adem 		Atem Hauch 
ademhaling 		Atmen Atmung 
adieu 		adieu auf Wiedersehen lebe wohl 
adjektief 		Adjektiv Eigenschaftswort 
adjektiwies 		adjektivisch 
administrasie 		Verwaltung 
administrateur 		Verwalter Verweser 
administreer 		administrieren verwalten 
admiraal 		Admiral 
adoreer 		anbeten verehren vergöttern 
adres 		Adresse 
adresseer 		adressieren 
adverbium 		Adverb Umstandswort 
adverteer 		ankündigen anzeigen avisieren melden anmelden verkünden 
advertensie 		Annonce Anzeige Inserat 
advies 		Avis Ankündigung Benachrichtigung 
adviseer 		raten beraten ratgeben 
afbreek 		abbrechen 
afdeling 		Abteilung Fach 
afdelingswinkel 		Geschäft Kaufladen Lagerhaus Magazin Warenhaus 
afding 		dingen feilschen markten 
afdwaal 		sich verirren 
affiks 		Affix Zusatzsilbe 
affêre 		Angelegenheit Ding Sache Werk 
affêring 		Angelegenheit Ding Sache Werk 
afgee 		ausbreiten 
afgelope 		vorig 
afgod 		Abgott Götze Idol 
afgrond 		Abgrund Tiefe 
afgryse 		Abscheu Greuel 
afhaal 		zurücklegen 
afhanklik 		abhängig 
afkappingsteken 		Apostroph 
afklim 		aussteigen 
afkondig 		ausrufen proklamieren 
aflewer 		liefern 
afluiter 		Verschluß 
afmeting 		Ausdehnung Dimension 
afoes 		einernten schneiden 
aforisme 		Aphorismo Gedankensplitter 
afraai 		entraten 
afros 		verhauen 
afrot 		abfaulen 
afruim 		abschaffen beseitigen entfernen fortschaffen wegbringen 
afruk 		abreißen losreißen pflücken abpflügen 
afry 		abfahren abreisen 
afsend 		abfertigen befördern expedieren fortsenden spedieren 
afsender 		Absender 
afset 		Absatz Debit Vertrieb 
afsetgebied 		Markt 
afsien 		entsagen verzichten 
afsit 		abnehmen abschneiden amputieren 
afskaafsel 		Span 
afskaf 		abschaffen beseitigen entfernen fortschaffen wegbringen 
afskaffer 		Abstinenzler 
afskei 		absondern abteilen abtrennen scheiden 
afskeid 		Abschied Valet 
afskeiding 		Abteilung 
afskeur 		abreißen losreißen pflücken abpflügen 
afskeuring 		Schisma 
afskiet 		entladen 
afskilder 		malen 
afskrif 		Abdruck Abschrift Kopie Nachbildung 
afskrik 		Abscheu Greuel 
afskryf 		amortisieren löschen 
afskuwelik 		entsetzlich furchtbar gräßlich schrecklich 
afslaan 		abschweifen abweichen 
afslag 		Nachlaß Rabatt Vergünstigung Vergütung 
afsluit 		hindern sperren versperren 
afsluiting 		Gehege Hürde Schranke 
afsmeek 		abbetteln 
afsny 		abschneiden 
afsonder 		absondern abteilen abtrennen scheiden 
afsonderlik 		abgesondert besonder einzeln seperat 
afsper 		hindern sperren versperren 
afsplits 		sich überwerfen 
afspoel 		gurgeln spülen 
afspraak 		Einverständnis Übereinkunft 
afspreek 		sich verständigen übereinkommen verabreden vereinbaren 
afstaan 		abtreten nachgeben weichen 
afstam 		entspringen entstehen herkommen stammen abstammen 
afstammeling 		Abkomme Abkömmling Epigone 
afstand 		Zession 
afstand doen van 		abtreten nachgeben weichen 
afsteek 		abschneiden 
afstempel 		abstempeln 
afstof 		abstauben 
afstomp 		abstumpfen 
afstoot 		verdrängen 
afstroop 		abdecken häuten 
afstuit 		abprallen 
afsydig 		abgesondert besonder einzeln seperat 
afsydigheid 		Besonderheit 
afsê 		annullieren für null und nichtig erklären kassieren 
aftandig 		abgelebt baufällig gebrechlich hinfällig 
aftands 		abgelebt baufällig gebrechlich hinfällig 
aftap 		ableiten herleiten 
afteken 		zeichnen abzeichnen 
aftel 		abrechnen 
aftreding 		Austritt 
aftree 		abdanken 
aftrek 		Absatz Debit Vertrieb 
afvaardig 		abordnen deputieren 
afvaart 		Abfahrt 
afval 		fallen 
afvallig 		abtrünnig 
afvallige 		Renegat 
afvee 		wischen 
afveeg 		wischen 
afvloei 		verfließen 
afvoer 		fortführen wegbringen 
afvries 		abfrieren 
afvuur 		abfeuern abschießen 
afwaarts 		abwärts herab herunter hinab hinunter 
afwagting 		Anwartschaft 
afwater 		drainieren entwässern 
afweer 		behaupten beschützen verteidigen 
afwen 		abgewöhnen entwöhnen 
afwerk 		ausarbeiten 
afwerp 		erzeugen hervorbringen produzieren 
afwesigheid 		Abwesenheit 
afwesig wees 		fehlen mangeln ermangeln 
afwikkel 		abrechnen liquidieren 
afwimpel 		ausmerzen 
afwis 		wischen 
afwyk 		abweichen 
afwyking 		Anomalie Unregelmäßigkeit 
afwys 		ausmerzen 
afwysing 		Verweigerung Weigerung 
ag 		Achtung Aufmerksamkeit 
agaat 		Achat 
agbaar 		achtbar 
ageer 		agieren handeln verfahren vorgehen wirken 
agenda 		Agenda Notizbuch 
agent 		Agent Geschäftsbesorger 
agentskap 		Agentur 
aggewing 		Zuvorkommenheit 
aggregaat 		Aggregat Haufen 
agio 		Agio Aufgeld 
agiteer 		agitieren 
agnaat 		Agnat 
agteloos 		achtlos fahrlässig 
agtelosig 		achtlos fahrlässig 
agtenswaard 		achtbar 
agtenswaardig 		achtbar 
agter 		hinter 
agteraan 		hinten 
agterbly 		zurückbleiben 
agterboeg 		Heck 
agterdog 		Argwohn Verdacht 
agterdogtig 		argwöhnisch 
agtereen 		hinter einander 
agtereenvolgens 		hinter einander 
agterent 		After Arsch Gesäß 
agtergrond 		Boden Grund 
agterhoede 		Nachhut 
agterhou 		verschweigen 
agterin 		hinten 
agterkleinseun 		Großenkel Urenkel 
agterlaag 		Anstand Hinterhalt Versteck 
agterlaat 		hinterlassen 
agterloop 		sich verspäten 
agterlosig 		achtlos fahrlässig 
agtermiddag 		Nachmittag 
agternaam 		Familienname 
agternadoen 		imitieren nachahmen nachbilden 
agternadraai 		Folge Konsequenz 
agterneef 		Großneffe 
agternig 		Großnichte 
agterniggie 		Großnichte 
agterskip 		Heck 
agterstand 		Ausstand 
agterste 		letzte letzter letztes 
agtersten 		Heck 
agterstewe 		Heck 
agteruit 		zurück 
agtervoegsel 		Affix Zusatzsilbe 
agtervolg 		fahnden nachzusetzen verfolgen 
agterwaarts 		zurück 
agterweë laat 		unterlassen 
agter wees 		sich verspäten 
agtien 		achtzehn 
agting 		Achtung Verehrung 
ag slaan op 		achtgeben aufpassen beachten zusehen 
ahorn 		Ahorn 
aikôna 		durchaus nicht ganz und gar nicht ganz nicht 
air 		Anblick Aussehen 
akademie 		Akademie 
akant 		Akanthus Bärenklau 
akasia 		Akazie 
akelei 		Aglei Glockenblume 
akkedis 		Eidechse 
akkeldis 		Eidechse 
akker 		Acker 
akkerboom 		Eiche 
akkerbou 		Ackerbau 
akkerdis 		Eidechse 
akklamasie 		Beifall 
akklimatiseer 		akklimatisieren 
akkompanjeer 		begleiten 
akkompanjement 		Geleit 
akkompanjis 		Gefährte 
akkoord 		Abkommen Einklang Übereinkommen Übereinkunft Übereinstimmung 
akkordeon 		Ziehharmonika 
akkumulator 		Akkumulator 
akkuraat 		akkurat genau 
akkusatief 		Akkusativ 
akoestiek 		Akustik 
akoliet 		Akoluth Meßdiener 
akoniet 		Akonit 
akrobaat 		Akrobat 
aksent 		Akzent Betonung Ton 
aksepteer 		annehmen empfangen genehmigen 
aksie 		Handlung Tat 
aksioma 		Axiom Grundsatz 
aksionaris 		Aktieninhaber Aktionär 
aksioom 		Axiom Grundsatz 
aksyns 		Akzise Verbrauchssteuer 
akteur 		Schauspieler 
aktief 		aktiv tätig 
aktivis 		Aufwiegler 
aktueel 		aktuell gegenwärtig 
akwarel 		Aquarell 
akwarium 		Aquarium 
al 		bereits schon 
alarm 		Alarm 
albas 		Alabaster 
albei 		beide 
album 		Album 
albumine 		Eiweiß 
alchemie 		Alchemie Alchimie 
aldaar 		da dort 
aldeur 		fortwährend unaufhörlich 
alfabet 		Alphabet 
alg 		Alge 
alge 		Alge 
algebra 		Algebra Buchstabenrechnung 
algemeen 		allgemein 
algodedom 		Pantheismus 
alhaas 		bald alsbald baldig 
alhoewel 		obgleich obschon wenn auch zwar 
alibi 		Alibi 
alimentasie 		Alimente Unterhalt 
alinea 		Absatz Alinea 
aljare 		alljährlich 
alkohol 		Alkohol Spritus 
alkoholisme 		Alkoholismus 
alle 		alle 
alledaags 		abgedroschen banal fade 
allee 		Allee Baumgang 
alleen 		allein bloß erst lediglich nur 
alleenhandel 		Monopol 
alleenheerser 		Autokrat Selbstherrscher 
alleenheerskapy 		Autokratie Selbstherrschaft 
alleenspraak 		Monolog 
alleenverkoop 		Monopol 
allegaartjie 		Gemisch 
allegorie 		Allegorie Sinnbild 
allegro 		Allegro 
allengs 		allmählich nach und nach sukzessive 
allengskens 		allmählich nach und nach sukzessive 
allenig 		allein alleinig bloß einzig 
aller 		jedermanns jedes 
alleraardigst 		allerliebst 
allerbekoorliks 		allerliebst 
allerhande 		allerhand jeglicher 
allerlei 		allerhand jeglicher 
allerweë 		allenthalben allerorten überall 
alles 		alles 
allesbehalwe 		durchaus nicht ganz und gar nicht ganz nicht 
allesins 		allweg auf jede Weise 
alliasie 		Legierung 
allig 		eventuell möglicherweise vielleicht wohl 
alligator 		Alligator 
allooi 		Legierung 
allopatie 		Allopathie 
alluvie 		Alluvium 
alluvio 		Alluvium 
alluvium 		Alluvium 
almag 		Allmacht 
almal se 		jedermanns jedes 
almanak 		Almanach 
almeteens 		alsbald flugs gleich sofort sogleich umgehend 
alom 		allenthalben allerorten überall 
alomvattend 		universal 
alpakka 		Alpaka 
alperoos 		Alpenrose Rosenbaum 
alras 		bald alsbald baldig 
alreeds 		bereits schon 
alruin 		Alraun 
alsem 		Beifuß 
alt 		Altstimme 
altaar 		Altar 
altaardienaar 		Akoluth Meßdiener 
altans 		wenigstens 
altemit 		eventuell möglicherweise vielleicht wohl 
altemits 		eventuell möglicherweise vielleicht wohl 
altemitters 		eventuell möglicherweise vielleicht wohl 
alternatief 		Alternative 
altoos 		allemal allzeit fortwährend immer jederzeit stets 
altstem 		Altstimme 
altwee 		beide 
altyd 		allemal allzeit fortwährend immer jederzeit stets 
altyddurend 		endlos unendlich 
aluin 		Alaun 
aluminium 		Aluminium 
alvermoë 		Allmacht 
alvorens 		bevor ehe 
alwaar 		wo woselbst 
alweer 		abermalig abermals von neuem wieder 
alwetend 		allwissend 
al's 		alles 
al die 		alle 
amalgaam 		Amalgam 
amandel 		Mandel 
amarant 		Tausendschön 
amasone 		Amazone 
amateur 		Amateur Liebhaber 
ambag 		Beruf Gewerbe Handwerk 
ambassade 		Gesandtschaft 
ambassadeur 		Botschafter Gesandter 
amber 		Ambra 
ambieer 		erstreben sich bestreben sich bewerben um trachten nach 
ambigeer 		zweifeln bezweifeln 
ambisie 		Ehrgeiz 
ambisieus 		ehrgeizig 
ambroos 		Ambrosia Götterspeise 
ambrosyn 		Ambrosia Götterspeise 
amen 		amen 
ametis 		Amethyst 
ameublement 		Hausgerät Mobilär 
amfibie 		Amphibie 
amfiteater 		Amphitheater 
amfora 		Amphora 
ammoniak 		Ammoniak 
ammonium 		Ammonium 
ammunisie 		Munition 
amnestie 		Amnestie Begnadigung Straferlaß 
amok 		Tollwut 
amorf 		amorph 
amortiseer 		amortisieren löschen 
amp 		Amt Anstellung Dienst 
amper 		kaum 
ampertjies 		kaum 
ampgenoot 		Kollegium 
ampsbroer 		Amtsbruder Amtsgenosse Genosse Kollege 
amptelik 		amtlich 
amptenaarstand 		Behörde 
ampul 		Birne 
amputeer 		abnehmen abschneiden amputieren 
ampère 		Ampère 
amulet 		Amulett 
amuseer 		amüsieren belustigen ergötzen unterhalten 
anachronisme 		Anachronismus 
anagram 		Anagram 
analfabeet 		Analphabet 
analiseer 		analysieren auflösen zergliedern 
analogie 		Analogie 
ananas 		Ananas 
anapes 		Anapäst 
anargie 		Anarchie 
anargisme 		Anarchismus 
anatomie 		Anatomie Zergliederungskunst 
ander 		anderer anders sonst 
anderland 		Ausland 
anderlander 		Ausländer 
anders 		andernfalls anders sonst 
andyvie 		Endivie 
anekdote 		Anekdote 
anemie 		Blutarmut 
anemoon 		Anemone 
angel 		Angelhaken 
angelier 		Nelke 
angina 		Angina Bräune 
angst 		Angst 
angstig 		grausig 
angsvallig 		skrupulös 
angswekkend 		grausig 
aniline 		Anilin 
animo 		Gemüt Seele 
anker 		Anker 
annekseer 		annektieren einverleiben 
annonseer 		ankündigen anzeigen avisieren melden anmelden verkünden 
annulleer 		annullieren für null und nichtig erklären kassieren 
anomalie 		Anomalie Unregelmäßigkeit 
anoniem 		anonym ungenannt 
ansjovis 		Anchovis 
antenne 		Fühler Fühlhorn 
antichris 		Antichrist 
antiek 		altertümlich antik 
antiloop 		Antilope 
antimonium 		Antimon 
antimoon 		Antimon 
antipatie 		Abneigung Antipathie Wiederwillen 
antipatiek 		wiederwärtig 
antipirien 		Antipyrin 
antipirine 		Antipyrin 
antipode 		Antipode Gegenfüßler 
antisepties 		antiseptisch fäulniswidrig 
antisipeer 		antizipieren vorausnehmen 
antrasiet 		Anthrazit 
antropologie 		Anthropologie Menschenkunde 
antwoord 		antworten beantworten entgegnen erwidern 
anus 		After 
anys 		Anis 
aorta 		Aorta 
apart 		abgesondert besonder einzeln seperat 
apatie 		Apathie Teilnahmslosigkeit 
apaties 		indolent 
apekool 		Gallimathias Unsinn 
apogeum 		Apogäum Erdferne 
apokalips 		Apokalypse Offenbarung 
apokrief 		apokryph 
apopleksie 		Schlag Schlagfluß 
apostel 		Apostel 
apostroof 		Apostroph 
apoteose 		Apotheose Vergötterung 
apparaat 		Apparat Vorrichtung 
appartement 		Appartement Etagenwohnung Gemach 
appel 		Apfel 
appelboom 		Apfelbaum 
appeldrank 		Apfelwein Obstwein Zider 
appelkoos 		Aprikose Marille 
appelwyn 		Apfelwein Obstwein Zider 
applikant 		Aspirant Bewerber 
apploudiseer 		applaudieren Beifall spenden 
applous 		Applaus Beifall 
appèl 		Appellation Berufung 
aprilblom 		Chrysanthemum 
apteek 		Apotheke 
apteker 		Apotheker 
aptyt 		Appetit 
arabesk 		Arabeske 
arak 		Arrak Reisbranntwein 
araroet 		Arrowroot 
arbei 		arbeiten 
arbeid 		Arbeit 
arbeider 		Arbeiter 
arbeidsaam 		arbeitsam geschäftig 
arbeidsdag 		Werktag Wochentag 
arbeidsloosheid 		Arbeitlosigkeit 
are 		Ar 
area 		Flächeninhalt 
arena 		Arena Kampfplatz 
arend 		Adler 
argaïes 		veraltet 
argaïsme 		Archaismus 
argeologie 		Archäologie Altertumskunde 
argipel 		Archipel Inselgruppe Inselmeer 
argitek 		Architekt 
argitraaf 		Architrav 
argon 		Argon 
argot 		Gaunersprache Slang 
argument 		Argument Beweis 
argumenteer 		argumentieren beweisen 
argwaan 		Argwohn Verdacht 
argwanend 		argwöhnisch 
aria 		Arie 
aristokraat 		Aristokrat Edelmann 
ark 		Arche 
arm 		Arm 
armband 		Armband 
armoede 		Armut 
arnika 		Arnika 
aroma 		Aroma Duft 
arrestant 		Arrestant 
arrestasie 		Arrest Haft 
arresteer 		arretieren festnehmen verhaften 
arsenaal 		Zeughaus 
arsenik 		Arsen 
arsenikum 		Arsen 
arterie 		Arterie Pulsader Schlagader 
artesies 		artesisch 
artikel 		Artikel 
artillerie 		Artillerie 
artis 		Artist 
artisjok 		Artischocke 
artritis 		Gicht 
arts 		Arzt Doktor 
as 		Asche 
asbes 		Asbest 
asem 		atmen 
asetileen 		Azetylen 
asfalt 		Asphalt Erdpech 
asfiksie 		Scheintod 
asiel 		Asyl Zufluchtsstätte 
asjoublief 		bitte 
askeet 		Asket 
asketisme 		Askese 
asma 		Asthma 
asof 		als ob gleichsam 
aspek 		Anblick Aussehen 
aspersie 		Spargel 
asseblief 		bitte 
assimileer 		ähnlich machen assimilieren 
assisteer 		assistieren beistehen helfen 
assistent 		Assistent 
assuransie 		Assekuranz Versicherung 
assureer 		versichern 
aster 		Aster 
asteroïde 		Asteroide 
asteroïed 		Asteroide 
astigmatisme 		Astigmatismus 
astrakan 		Astrachan 
astrologie 		Astrologie Sterndeutung 
astronomie 		Astronomie Himmelskunde Sternkunde 
astronoom 		Astronom 
asyn 		Essig 
atavisme 		Ahnenähnlichkeit 
ateïs 		Atheist 
ateïsme 		Atheismus Atheïsmus Gottesleugnung 
athenaeum 		Athenäum 
atleet 		Athlet 
atmosfeer 		Atmosphäre 
atomisme 		Atomismus 
atonie 		Atonie 
atoom 		Atom 
atrofie 		Athrophie Darrsucht 
attensie 		Achtung Aufmerksamkeit 
attent 		aufmerksam 
auditorium 		Auditorium Hörsaal 
auto‐da‐fé 		Glaubensgericht Glaubenshandlung 
avonturier 		Abenteurer 
avontuur 		Abenteuer 
awend 		Abend 
aërometer 		Aerometer Luftmesser 
aërostaat 		Ärostat Ballon Luftballon 
a foei tog 		bedauerlich leider 
a ja a 		allerdings bestimmt freilich gewiß immerhin wohl zwar 
a nee a 		durchaus nicht ganz und gar nicht ganz nicht 
baadjie 		Jacke Männerrock 
baai 		Bai Bucht 
baaierd 		Chaos 
baaiklere 		Badeanzug 
baaikostuum 		Badeanzug 
baan 		Breite 
baanbreker 		Bahnbrecher Pionier 
baantjie 		Posten 
baar 		Welle Woge 
baard 		Bart 
baarmoeder 		Gebärmutter Uterus 
baars 		Barsch 
baas 		Befehlshaber Chef Haupt Häupling Herr Oberhaupt Vorsteher 
baat 		Ertrag Gewinn Interesse Nutzen Überschuß Verdienst Vorteil 
baatsug 		Egoismus Selbstsucht 
baatsugtigheid 		Egoismus Selbstsucht 
baccarat 		Kartenhazardspiel 
bad 		Bad 
badgas 		Badegast 
badhuis 		Bad 
badkamer 		Bad 
badklere 		Badeanzug 
badkostuum 		Badeanzug 
badkuip 		Bad 
badpak 		Badeanzug 
badplaas 		Badeort 
badshuis 		Bad 
bagasie 		Bagage Gepäck Verpackung 
bagasiebak 		Gepäckraum 
bagatel 		Bagatelle Kleinigkeit 
baie 		viel zahlreich 
bajonet 		Bajonett 
bak 		backen 
bakatel 		Bagatelle Kleinigkeit 
bakbaard 		Backenbart 
bakboord 		Backbord 
bakkebaard 		Backenbart 
bakker 		Bäcker 
baksteen 		Backstein Ziegel Ziegelstein 
bakterie 		Bakterie 
bakteriologie 		Bakterienkunde 
bal 		Ball 
balans 		Gleichgewicht 
baldakyn 		Baldachin 
balderja 		Baldrian 
balderjan 		Baldrian 
balk 		Balken 
balkon 		Altan Balkon 
ballade 		Ballade 
ballast 		Ballast 
ballingskap 		Acht Exil Verbannung 
ballistiek 		Ballistik 
ballon 		Ballon 
balsem 		Balsam 
balustrade 		Balustrade Geländer Schranke 
bamboes 		Bambus 
banaal 		abgedroschen banal fade 
banana 		Banane 
band 		Binde Streifen 
bandiet 		Bandit Räuber 
bang 		bang 
bank 		Bank 
bankier 		Bankier 
bankrot 		Bankerott Fallissement Fallit 
bankrot raak 		fallieren 
bannelingskap 		Acht Exil Verbannung 
barak 		Baracke Lagerhütte 
barbaar 		Barbar 
barbarisme 		Barbarismus Sprachwidrigkeit 
barbier 		Barbier 
bard 		Barde Sänger 
bariton 		Bariton 
barnsteen 		Bernstein 
barometer 		Barometer 
baron 		Baron Freiherr 
barones 		Freifrau 
barrikade 		Barrikade Verhau 
barrière 		Barriere Schranke 
bars 		spalten 
bas‐relief 		Basrelief 
basaar 		Basar Markt Warenhaus 
basalt 		Basalt 
basil 		Bazillus 
basiliek 		Basilika 
basilika 		Basilika 
basilisk 		Basilisk 
bassin 		Bassin Wasserbecken 
bastion 		Bastei Bastion Bollwerk 
bataljon 		Bataillon 
battery 		Akkumulator 
bazaar 		Basar Markt Warenhaus 
bed 		Bett Bettstelle 
bedaar 		beruhigen 
bedags 		tags 
bedank 		danken sich bedanken verdanken 
bedanking 		Verweigerung Weigerung 
beddeken 		Bettdecke Decke 
beddekussing 		Kissen Kopfkissen 
bedding 		Beet 
bedeel 		ausstatten dotieren 
bedehuis 		Kirche 
bedek 		belegen decken bedecken einhüllen verhüllen zudecken 
bedelaar 		Bettler 
bedenking 		Anbetracht Erwägung 
bedenktyd 		Bedenkzeit 
bederf 		beschädigen Schaden zufügen verderben verletzen 
bederfwerend 		antiseptisch fäulniswidrig 
bederwe 		verderben verschlechtern verschlimmern 
bedevaart 		Wallfahrt 
bedien 		dienen bedienen 
bediende 		Dienstbote Magd 
bediening 		Bedienung Dienst 
bedil 		schikanieren Kleinigkeiten tadeln wegen 
beding 		Bedingung Klausel Vorbehalt 
bedinging 		Bedingung Klausel Vorbehalt 
bedink 		bedenken erwägen sich überlegen 
bedissel 		arrangieren einrichten ordnen anorden veranstalten 
bedkussing 		Kissen Kopfkissen 
bedlaken 		Betttuch Bettlaken Laken 
bedoel 		absehen bezwecken trachten nach zielen 
bedoeling 		Absicht Plan 
bedol 		irre toll verrückt wahnsinnig 
bedorwe 		faul faulig 
bedot 		narren mystifizieren zum besten halten 
bedrag 		Betrag Summe 
bedreig 		bevorstehen dräuhen drohen bedrohen 
bedreiging 		Bedrohung Drohung 
bedremmeld 		bestürtzt 
bedrewe 		geübt 
bedrewenheid 		Geschicklichkeit Gewandtheit 
bedrieg 		äffen betrügen hintergehen täuschen 
bedrieglik 		verfänglich 
bedrieëry 		Betrug Täuschung Trug Unterschleif 
bedrië 		äffen betrügen hintergehen täuschen 
bedroef 		bekümmern betrüben 
bedroefdheid 		Betrübnis 
bedroewe 		bekümmern betrüben 
bedrog 		Betrug Täuschung Trug Unterschleif 
bedruk 		traurig 
bedruktheid 		Betrübnis 
bedryf 		Unternehmung 
bedrywe 		anfertigen herstellen leiten machen tun zurücklegen 
bedrywigheid 		Tätigkeit 
bedug 		besorgt unruhig 
bedugtheid 		Bangigkeit Unruhe 
beduidenis 		Bedeuting Bezeichnung Meinung 
bedwing 		zügeln 
beef 		beben zittern zucken 
beek 		Bach 
beeld 		Ansicht Bild 
beeldend 		plastisch 
beelderig 		entzückend 
beeldhou 		hauen skulptieren 
beeldhouwerk 		Bildhauerwerk Bildwerk 
beeldig 		entzückend 
beeldskoon 		herrlich stattlich wunderbar 
beeldspraak 		Metapher 
beeltenis 		Ansicht Bild 
been 		Bein 
beer 		Bär 
beerklou 		Akanthus Bärenklau 
beerwyfie 		Bärin 
bees 		Tier 
beesfilet 		Filet Lendenstück 
beesvleis 		Rindfleisch 
beet 		Beete Mangold Runkelrübe 
beetgryp 		erbeuten ergreifen ertappen erwischen fangen fassen 
beethê 		narren mystifizieren zum besten halten 
beetkry 		erbeuten ergreifen ertappen erwischen fangen fassen 
beetneem 		erbeuten ergreifen ertappen erwischen fangen fassen 
beetnemery 		Mystifikation 
beetpak 		erbeuten ergreifen ertappen erwischen fangen fassen 
beetvat 		erbeuten ergreifen ertappen erwischen fangen fassen 
befaamd 		berühmt 
befaamdheid 		Fama Gerücht Ruf 
begaaf 		begabt 
begaafdheid 		Talent 
begaan 		anfertigen herstellen leiten machen tun zurücklegen 
begeef hom 		fahren gehen treten 
begeer 		gelüsten 
begeerbaar 		erwünscht 
begeerlik 		erwünscht 
begeerte 		Gelüst Gierde Habsucht 
begeester 		begeistern einflößen eingeben inspirieren 
begelei 		begleiten 
begeleider 		Gefährte 
begeleiding 		Geleit 
begeleier 		Gefährte 
begenadig 		entschuldigen verzeihen 
begenadiging 		Begnadigung Vergebung Verzeihung 
begerig 		begierig habgierig lüstern 
begerigheid 		Gelüst Gierde Habsucht 
begewe hom 		fahren gehen treten 
begiftig 		schenken beschenken stiften verehren verschenken 
begin 		anbrechen anfangen beginnen 
beginletter 		Initial 
beginsel 		Element 
beginselverklaring 		Programm 
begluur 		belauschen spionieren 
begogel 		bezaubern verhexen verzaubern 
begogelsing 		Zauber 
begoël 		bezaubern verhexen verzaubern 
begoëlsing 		Zauber 
begraaf 		beerdigen 
begraafplaas 		Friedhof Gottesacker Kirchhof 
begraafplek 		Friedhof Gottesacker Kirchhof 
begrafnis 		Begräbnis 
begrawe 		beerdigen 
begrawing 		Begräbnis 
begrens 		begrenzen beschränken einschränken 
begrip 		Gedanke Idee Vorstellung 
begroet 		grüßen begrüßen bewillkommnen 
begroot 		abschätzen bewerten schätzen einschätzen 
begryp 		begreifen erfassen verstehen 
begrypbaar 		begreiflich faßbar verständlich 
begryplik 		begreiflich faßbar verständlich 
begunstig 		begünstigen 
begunstigde 		Favorit Günstling 
begunstiging 		Gnade Gunst Huld Vergünstigung 
begyn 		Beguine 
begyntjie 		Beguine 
behaag 		behagen belieben gefallen konvenieren 
behaaglik 		behaglich herrlich genehm angenehm 
behaaglikheid 		Annehmlichkeit 
behaagsiek 		gefallsüchtig kokett 
behaal 		erbeuten erlangen erringen habhaft werden sich erwerben 
behalwe 		ausgenommen 
behandel 		behandeln heilen kurieren 
behandeling 		Behandlung 
behang 		Tapete 
behangsel 		Tapete 
behangselpapier 		Tapete 
behartig 		versorgen 
beheer 		Verwaltung 
beheers 		herrschen beherrschen regieren 
beheerser 		Herrscher Statthalter 
beheersing 		Regieren Regierung 
beheks 		bezaubern verhexen verzaubern 
behels 		enthalten 
behendig 		anstellig behende fix geschickt geübt gewandt 
behendigheid 		Geschicklichkeit Gewandtheit 
behoed 		wahren 
behoedsaamheid 		Vorsicht 
behoef 		benötigen brauchen nötig haben 
behoefte 		Bedarf Bedürfnis 
behoeftig 		unvermögend 
behoor 		gehören angehören zugehören 
behoorlik 		gehörig 
behoorlikheidshalwe 		zurecht 
behoort 		gehören angehören zugehören 
behou 		aufbewahren behalten bergen erhalten konservieren 
behoud 		Heil 
behoudend 		konservativ 
behoudenis 		Heil 
behoudensgesind 		konservativ 
beiaard 		Glockenspiel 
beide 		beide 
beidersyds 		beiderseitig beiderseits 
beier 		hallen klingen läuten schallen tönen 
beitel 		meißeln ziselieren 
bejaard 		alt bejahrt betagt 
bejammer 		bedauern 
bejammerenswaardig 		bedauerlich bedauernswert 
bek‐en‐klouseer 		Mundschwamm 
bek 		Schnabel 
bekeer 		bekehren umstimmen 
bekeerling 		Proselyt 
beken 		anerkennen gestehen eingestehen 
bekend 		bekannt 
bekendheid 		Bekanntschaft 
bekendmaak 		ausrufen proklamieren 
bekendmaking 		Proklamation 
bekendstel 		ausrufen proklamieren 
bekentenis 		Bekenntnis Eingeständnis Geständnis 
beker 		Becher Pokal 
bekken 		Zimbel 
beklaag 		bemitleiden Mitleid haben sich erbarmen 
beklaaglik 		erbärmlich 
beklad 		afterreden anschwärzen fälschlich beschuldigen verleumden 
beklae 		bemitleiden Mitleid haben sich erbarmen 
beklaenswaardig 		erbärmlich 
beklag 		Beschwerde Klage 
beklagenswaardig 		erbärmlich 
beklag doen 		klagen sich beklagen verklagen 
beklee 		bekleiden besetzen einnehmen in Anspruch nehmen 
bekleed 		beziehen überziehen 
beknibbel 		dingen feilschen markten 
beknor 		schelten vorwerfen Vorwürfe machen 
bekom 		bekommen empfangen erhalten 
bekommerd 		besorgt 
bekommering 		Bangigkeit Unruhe 
bekommernis 		Bangigkeit Unruhe 
bekonkel 		intriguieren Ränke anzetteln 
bekoor 		in Versuchung führen versuchen 
bekoorlik 		allerliebst anmutig hold lieblich reizend 
bekoorlikheid 		Anmut 
bekoring 		Versuchung 
bekort 		abkürzen verkürzen 
bekprater 		Großtuer 
bekragtig 		bekräftigen bestätigen konfirmieren 
bekragtiging 		Firmelung 
bekritiseer 		begutachten kritisieren 
bekrompe 		schmal 
bekroon 		prämiieren preiskrönen 
bekryg 		bekriegen 
bekvegter 		Großtuer 
bekwaald 		kaum 
bekwaam 		begabt fähig imstande tüchtig 
bekwaamheid 		Kapazität 
bel 		anläuten klingeln anklingeln 
belaai 		beauftragen belasten laden aufladen beladen 
belaglik 		lächerlich 
beland 		ankommen eintreffen gelangen zukommen herzukommen 
belang 		Tragweite 
belangende 		betreffs 
belangrik 		arg bedeutend bedeutsam beträchtlich erheblich ernst wichtig 
belangrykheid 		Tragweite 
belangstelling 		Interesse 
belas 		beauftragen belasten laden aufladen beladen 
belaster 		afterreden anschwärzen fälschlich beschuldigen verleumden 
belasting 		Abgabe Steuer Steuerabgabe 
beledig 		beleidigen schelten schimpfen beschimpfen 
beledigend 		anzüglich beleidigend verletzend 
belediging 		Anstoß Beleidigung Kränkung 
beleef 		erleben 
beleg 		einkleiden investieren 
beleid 		Politik 
belemmer 		behelligen hindern behindern inhibieren stören verhindern 
belemmering 		Schranke 
belendend 		angrenzend anstoßend 
belet 		Hindernis 
beletsel 		Hindernis 
belewe 		erleben 
belewenis 		Erfahrung 
belewing 		Erfahrung 
beleë 		reif 
beleënheid 		Reife 
beleër 		belagern 
beleëring 		Belagerung 
belief 		bitte 
belladonna 		Belladonna Tollkirsche 
belletrie 		Belletristik 
beloer 		belauschen spionieren 
belofte 		Gelöbnis Versprechen Zusage 
beloning 		Belohnung Lohn 
beloof 		geloben verheißen versprechen zusagen 
beloon 		lohnen belohnen vergelten 
belowe 		geloben verheißen versprechen zusagen 
belroos 		Rose Rotlauf 
beluister 		anhören horchen aushorchen zuhören 
beluistering 		Verhör 
belus 		begierig habgierig lüstern 
belus wees op 		gelüsten 
bely 		beichten 
belydenis 		Beichte 
belê 		einkleiden investieren 
bemagtig 		greifen angreifen ergreifen 
bemanning 		Mannschaft 
bemerk 		bemerken 
bemerkbaar 		bemerkbar 
bemes 		düngen 
bemiddel 		vermitteln 
bemiddeld 		wohlhabend 
bemin 		gern haben lieben mögen 
beminde 		Geliebte 
beminnaar 		Freier 
bemoedig 		ermannen ermutigen 
bemoeienis 		Anstrengung 
bemoeigees 		Fürwitz Indiskretion 
bemoeilik 		erschweren 
bemoeisiek 		indiskret 
bemoeisug 		Fürwitz Indiskretion 
bemoeisugtig 		indiskret 
bemoontlik 		ermöglichen möglich machen 
benaam 		heißen nennen benennen ernennen 
benadeel 		beeinträchtigen 
benaming 		Name 
benardheid 		Hemmnis Lästiges Verlegenheit 
bende 		Bande Horde Rotte Troß 
benede 		unten 
benedeverdieping 		Erdgeschoß 
benedy 		segnen 
beneem 		abräumen fortnehmen entziehen wegnehmen 
benefice 		Benefiz 
beneficevoorstelling 		Benefiz 
benepe 		armselig 
beneweld 		angeheitert 
benewens 		zuzüglich 
benodig 		erforderlich nötig notwendig 
benoem 		heißen nennen benennen ernennen 
benoeming 		Nomade 
benou 		beängstigen beunruhigen 
benoud 		besorgt unruhig 
benoudheid 		Angst Unruhe 
benouend 		erstickend schwül Stick‐ stickig 
bensien 		Benzin 
bensine 		Benzin 
bensol 		Benzol 
benul 		Gedanke Idee Vorstellung 
benut 		anwenden benutzen brauchen gebrauchen verwenden verwerten 
benuttig 		anwenden benutzen brauchen gebrauchen verwenden verwerten 
beny 		beneiden 
beoefen 		praktizieren 
beoog 		absehen bezwecken trachten nach zielen 
beoordeel 		begutachten kritisieren 
beoorlog 		bekriegen 
beoorloog 		bekriegen 
bepaal 		bestimmen definieren 
bepaling 		Bestimmung 
bepantsering 		Harnisch Küraß Panzer 
beperk 		begrenzen beschränken einschränken 
bepleister 		in Stuck arbeiten 
beploe 		pflügen 
beploege 		pflügen 
beploë 		pflügen 
bepoeier 		pudern stäuben 
bepraat 		bereden besprechen sprechen über 
beproef 		bekümmern betrüben 
beproewe 		bekümmern betrüben 
beraadslaag 		überlegen 
beraam 		entwerfen planen projektieren 
beraming 		Entwurf Plan Projekt 
beredder 		arrangieren einrichten ordnen anorden veranstalten 
beredenering 		Räsonement 
berei 		bereiten vorbereiten 
bereid 		bereit erbötig fertig 
bereiding 		Bereitung Vorbereitung 
bereidvaardigheid 		Gefälligkeit 
bereidwillig 		bereitwillig 
bereik 		erlangen erzielen reichen erreichen 
bereken 		erachten kalkulieren rechnen berechnen 
berekening 		Kalkul 
berg 		Berg 
bergamot 		Bergamotte 
berging 		Heil 
bergkristal 		Quarz 
bergpik 		Asphalt Erdpech 
berig 		Auskunft Bericht Bescheid 
beril 		Beryll 
berin 		Bärin 
berispe 		zurechtweisen 
berisping 		Tadel 
berk 		Birke 
berkeboom 		Birke 
beroemd 		berühmt 
beroemdheid 		Berühmtheit 
beroep 		Appellation Berufung 
beroeps‐ 		beruflich Berufs‐ berufsmäßig Gewerbe‐ gewerbsmäßig 
beroer 		agitieren 
beroerd 		böse schlecht 
beroerte 		Schlag Schlagfluß 
berokken 		antun bewirken veranlassen verursachen zufügen 
beroof 		berauben 
berooid 		unvermögend 
berou 		Buße 
berowe 		berauben 
berower 		Freibeuter Wegelagerer 
berusting 		Resignation 
berym 		reimen 
besadig 		mäßig 
besef 		begreifen erfassen verstehen 
besem 		Besen 
besending 		Sendung 
beset 		trächtig schwanger 
besete 		irre toll verrückt wahnsinnig 
besetene 		Irre 
besetting 		Besatzung Garnison 
beseël 		bekräftigen bestätigen konfirmieren 
besie 		Grille Heimchen 
besiel 		begeistern 
besieling 		Begeisterung Enthusiasmus 
besien 		sehen ansehen 
besig 		besetzt 
besigheid 		Beschäftigung 
besighou 		zerstreuen 
besinksel 		Hefe 
besinning 		Bewußtsein 
besit 		Besitz Besitztum Besitzung Eigentum Gut 
besitlik voornaamwoord 		Possessivpronomen Possessivum 
besitter 		Eigentümer Inhaber 
besitting 		Besitz Besitztum Besitzung Eigentum Gut 
beskaaf 		bilden gesittet machen zivilisieren 
beskaam 		beschämen blamieren 
beskadig 		beschädigen Schaden zufügen verderben verletzen 
beskadiging 		Verderbnis 
beskawe 		bilden gesittet machen zivilisieren 
beskawing 		Aufklärung Bildung Gesittung Zivilisation 
beskeid 		Dokument Urkunde 
beskeidenheid 		Diskretion 
beskeie 		diskret verschwiegen 
beskerm 		begünstigen beschirmen protektieren schützen beschützen 
beskermheer 		Patron Schirmherr 
beskermheerskap 		Patronat 
beskermheilige 		Patron Schirmherr 
beskiet 		beschießen bombardieren 
beskik 		arrangieren einrichten ordnen anorden veranstalten 
beskikking 		Einrichtung Zusammenstellung 
beskimmel 		schimmeln verschimmeln 
beskimmeld 		moderig 
beskinder 		afterreden anschwärzen fälschlich beschuldigen verleumden 
beskonke 		berauscht trunken betrunken 
beskonkenheid 		Betrunkenheit 
beskrywing 		Beschreibung 
beslis 		absolut ausdrücklich durchaus unausbleiblich unfehlbar 
besluit 		beschließen entscheiden sich entschließen 
besoedel 		beschmutzen einschmutzen sudeln 
besoedeling 		Pollution 
besoek 		Besuch Visite 
bespaar 		erübrigen sparen ersparen 
bestaan 		bestehen da sein existieren vorhanden sein 
beste 		best 
besteding 		Aufwand Ausgabe Auslage 
bestel 		bestellen 
bestelling 		Auftrag Bestellung 
bestuur 		dirigieren führen richten steuern 
bestuurder 		Dirigent Inhaber 
beswaar 		Einrede Einwand Einwendung Einwurf Gegenrede 
betaal 		zahlen abzahlen auszahlen bezahlen einzahlen entrichten 
betaam 		gehören schicken sich gehören ziemen 
beteken 		bedeuten bezeichnen 
betekenis 		Bedeuting Bezeichnung Meinung 
beter 		besser 
betrekking 		Posten 
betyds 		beizeiten zeitig zur rechten Zeit 
beuk 		Buche 
beurs 		Stipendium 
bevat 		enthalten 
bevestig 		bejahen ja sagen 
bevolking 		Bevölkerung 
bevorder 		promovieren 
bevordering 		Promotion 
bevrug 		trächtig schwanger 
bewaar 		aufbewahren behalten bergen erhalten konservieren 
beweeg 		bewegen erregen 
beweging 		Bewegung 
bewonder 		bewundern 
bewys 		Ausweis Beweis Beleg 
beëdig 		beeidigen vereidigen 
beëindig 		beschließen enden beenden endigen beendigen erledigen 
beëindiging 		Ende 
beërf 		erben beerben 
beërwe 		erben beerben 
beïndruk 		Eindruck machen 
beïnvloed 		beeinflussen Einfluß haben auf einwirken 
biblioteek 		Bibliothek 
bibliotekaris 		Bibliothekar 
bid 		beten 
bieg 		beichten 
bier 		Bier 
biljart 		Billard 
billik 		billig gerecht 
bind 		binden verbinden 
binne 		in nach pro zu 
binnelands 		einheimisch 
biologie 		Biologie Lebenslehre 
bioskoop 		Kino 
biskop 		Bischof 
bismut 		Wismut 
bison 		Bison 
bitter 		bitter 
blaarslaai 		Kopfsalat Lattich Salat 
blaas 		blasen wehen 
bladsy 		Folio Seite 
blank 		weiß 
blanke 		Europäer 
blind 		blind 
blink 		blank 
bloed 		Blut 
bloeding 		Blutung 
bloedverwant 		Verwandter 
bloese 		Bluse 
blok 		Block Klotz 
blom 		Blume 
blou 		blau 
blus 		auslöschen dämpfen 
bly 		bleiben übrigbleiben 
bo 		oberhalb über 
bobbejaan 		Pavian 
boek 		Buch 
boereplaas 		Bauernhof Besitzung Gut Landgut 
boete 		Geldstrafe 
boetekaartjie 		Protokoll 
boikot 		boykottieren sperren 
boks 		Büchse Schachtel 
bokser 		Boxer 
bondel 		Bund Bündel Büschel Fascikel 
boom 		Baum 
boor 		Bohrer 
bord 		Teller 
bordeel 		Bordell 
bors 		Brust Busen 
bos 		Forst Wald 
botsing 		Kollision 
bottel 		Flasche 
botter 		Butter 
braai 		braten rösten 
brand 		brennen 
brandewyn 		Branntwein Schnaps 
brandweer 		Feuerwehr 
breek 		brechen abbrechen aufbrechen 
brein 		Gehirn Hirn 
brief 		Brief 
briefkaart 		Postkarte 
bril 		Augengläser Brille 
bring 		bringen anbringen eintragen heranbringen überbringen 
brinjal 		Eierpflanze 
broei 		brüten 
broer 		Bruder 
broerskind 		Nichte 
bron 		Born Quelle 
brons 		Bronze Erz 
brood 		Brot 
brosjure 		Broschüre 
brug 		Brücke 
bruin 		braun 
buffel 		Büffel 
buffer 		Puffer 
buig 		biegen beugen flektieren 
buis 		Rohr Röhre Schlauch 
buite 		außer außerhalb 
buiteland 		Ausland 
bul 		Stier 
burger 		Bürger 
buro 		Amt Büro 
bus 		Autobus Bus 
buurman 		Nachbar 
by 		an bei neben 
bybel 		Bibel 
bylae 		Anhang Beilage Supplement Zugabe Zusatz Zuschlag Zuschuß 
bymekaar 		aneinander beisammen gesamt insgesamt zugleich zusammen 
bymekaarbring 		sammeln einsammeln 
byna 		beinahe fast nahezu schier ungefähr 
byt 		beißen 
byvoeg 		addieren beifügen zufügen 
bywoord 		Adverb Umstandswort 
by benadering 		annähernd etwa ungefähr 
bêre 		einschließen 
bêreplek 		Gewahrsam 
casino 		Gesellschaftshaus Kasino 
chaos 		Chaos 
chemie 		Chemie 
chirurg 		Chirurg Wundarzt 
chloor 		Chlor 
daad 		Handlung Tat 
daag 		anweisen assignieren überweisen 
daagliks 		täglich 
daar 		da dort 
daaraan 		darüber 
daarby 		damit 
daardie 		die jene 
daarmee 		dadurch 
daarna 		dann darauf hernach hierauf hinten hinterher nachher später 
daarom 		dafür darum deshalb 
daarso 		da dort 
daarvandaan 		daher 
daarvoor 		dafür dazu 
daar gunder 		da dort 
dadelik 		gleich sogleich 
dag 		Tag 
dan 		damals dann alsdann danach hierauf 
dank 		danken sich bedanken verdanken 
dankbaar 		dankbar 
dankie 		danke 
danksy 		dank 
dans 		tanzen 
dapperheid 		Mut 
darem 		tatsächlich 
das 		Halsbinde Krawatte Schlips 
dat 		daß 
datum 		Datum 
deeglik 		außerordentlich höchst überaus ungemein 
deel 		Anteil Teil 
deelneem 		mitmachen teilnehmen 
deelnemer 		Sozius 
deels 		teils 
definisie 		Bestimmung 
definitief 		absolut ausdrücklich durchaus unausbleiblich unfehlbar 
deftig 		hübsch schön 
dek 		belegen decken bedecken einhüllen verhüllen zudecken 
deken 		Bettdecke Decke 
dekor 		Auszeichnung Dekoration Schmückung 
delikaat 		delikat fein gelinde zart 
demokrasie 		Demokratie 
den 		Fichte Tanne 
denneboom 		Fichte Tanne 
departement 		Departement 
deponeer 		deponieren hinterlegen 
dertien 		dreizehn 
dertig 		dreißig 
destyds 		damals dann alsdann danach hierauf 
deur 		durch kraft mit mittelst vermittels 
deurbring 		angeben herreichen verbringen zubringen 
deurdat 		da weil 
deurmaak 		erleben 
deurmekaar 		bestürtzt 
deursnee 		Profil 
diamant 		Diamant 
die 		das der die 
dieet 		Diät 
dief 		Dieb 
diens 		Dienst 
diep 		tief 
diepte 		Tiefe 
dier 		Tier 
dieselfde 		dasselbe derselbe dieselbe 
digter 		Dichter Poet 
dikwels 		häufig oft 
dimensie 		Ausdehnung Dimension 
dinee 		Diner Mittagessen 
ding 		Angelegenheit Ding Sache Werk 
dink 		bedünken befinden dafür halten erachten meinen 
diploma 		Diplom Prüfungszeugnis Urkunde 
direk 		aufrecht direkt gerad gradlinig unmittelbar 
direkteur 		Direktor Leiter Vorsteher 
dissipline 		Disziplin 
dit 		das dies jenes 
dit daardie 		das dies jenes 
dit hierdie 		dies 
dié 		die jene 
dobbel 		spekulieren 
doel 		Ziel Zweck 
doen 		anfertigen herstellen leiten machen tun zurücklegen 
dogter 		Tochter 
dokter 		Arzt Doktor 
doktrine 		Doktrin Lehre 
dokument 		Dokument Urkunde 
dom 		albern dumm 
dominee 		Pastor Pfarrer 
donasie 		Angebinde Gabe Geschenk Spende Vermächtnis 
donderbui 		Gewitter 
donker 		dunkel düster trübe 
donkie 		Esel 
dood 		gestorben tot verstorben 
doodmaak 		auslöschen dämpfen 
doodskiet 		erschießen füsilieren 
doof 		taub 
doop 		Taufe 
doos 		Büchse Schachtel 
dor 		trocken 
dorp 		Dorf Ort 
dors wees 		dürsten 
dosent 		Dozent 
dra 		tragen 
draagbaar 		Bahre Träger 
draai 		abschweifen abweichen 
dragtig 		trächtig schwanger 
drama 		Drama Schauspiel 
dreigement 		Bedrohung Drohung 
drie 		drei 
drink 		saufen zechen 
dromedaris 		Dromedar 
dronk 		berauscht trunken betrunken 
droog 		trocken 
druif 		Traube Weintraube 
druk 		beklemmen drücken bedrücken pressen zwängen 
drup 		träufeln triefen tropfen 
dryf 		schwimmen 
duidelik 		ausdrücklich 
duim 		Daumen 
duin 		Düne 
duisend 		tausend 
duister 		dunkel finster 
duiwel 		Teufel 
dukaat 		Dukaten 
durf 		Mut 
dus 		folglich 
duur 		teuer wert 
dwerg 		Zwerg 
dwing 		zwingen 
edel 		edel edelmütig erhaben 
eed 		Eid 
eekhoring 		Eichhorn Eichhörnchen 
eekhorinkie 		Eichhorn Eichhörnchen 
een‐en‐twintig 		einundzwanzig 
een 		ein eine eins 
eend 		Ente 
eendag 		ehemals einmal einst einstens einstmals irgendwann je jemals 
eenheid 		Einigkeit Einheit 
eensaam 		einsam 
eenvoud 		Einfachkeit 
een en twintig 		einundzwanzig 
eerlik 		anständig bieder ehrlich honett rechtschaffen 
eers 		ehemals einmal einst einstens einstmals irgendwann je jemals 
eerskomende 		bevorstehend kommend künftig nächst nahe 
eerste 		erste erster erstes 
eetkamer 		Speisesaal Speisezimmer 
eetservies 		Geschirr Tisch‐Service 
effek 		Effekt Wirkung 
effektief 		effektiv faktisch tatsächlich wirklich 
eggenoot 		Ehemann Gatte Gemahl Gespons 
eggo 		Echo Widerhall 
egter 		aber doch dennoch jedoch 
ei 		Ei 
eie 		eigen 
eienaar 		Inhaber 
eienaardig 		befremdend kurios seltsam sonderbar wunderlich 
eierplant 		Eierpflanze 
eiervrug 		Eierpflanze 
eik 		Eiche 
eiland 		Eiland Insel 
einde 		Ende 
eindig 		beschließen enden beenden endigen beendigen erledigen 
eintlik 		eigentlich 
ekonomies 		haushälterisch ökonomisch sparsam wirtschaftlich 
eksamen 		Examen 
eksperiment 		Experiment Versuch 
ekstase 		Ekstase Entzückung 
ekstra 		besonders extra 
ekstreem 		äußerster extrem 
eland 		Elch Elen Elentier 
elders 		anderswo 
elegant 		elegant geschmackvoll 
elegie 		Elegie Klagelied 
elektrisiteit 		Elektrizität 
elementêr 		elementar 
elf 		elf 
els 		Erle 
elsboom 		Erle 
emigreer 		auswandern 
emosie 		Affekt Bewegung Gemütsbewegung Krankheit Rührung 
en 		und 
energie 		Energie Tatkraft Willenskraft 
enige 		ein paar einige einiger einiges etliche manche 
enigiemand 		ein gewisser einer irgend einer irgendwer jemand 
enigiets 		etwas irgendetwas irgendwas 
enigste 		allein alleinig bloß einzig 
enkele 		ein paar einige einiger einiges etliche manche 
ens. 		u.s.w. 
erediens 		Gottesdienst 
erf 		erben beerben 
erg 		arg bedeutend bedeutsam beträchtlich erheblich ernst wichtig 
erken 		bekräftigen bestätigen konfirmieren 
ernstig 		arg bedeutend bedeutsam beträchtlich erheblich ernst wichtig 
ertjie 		Erbse 
ervare 		bewandert erfahren gewiegt kundig 
ervaring 		Erfahrung 
esel 		Esel 
esperantis 		Esperantist 
ete 		Essen Fraß Mahlzeit 
ewe 		gleich 
ewig 		ewig 
fabriek 		Fabrik 
faktor 		Faktor 
familie 		Familie 
familielid 		Verwandter 
fase 		Phase 
fasiliteer 		erleichtern 
fee 		Fee 
feit 		Tatsache 
ferm 		fest befestigt haltbar wiederstandsfähig 
fiets 		Fahrrad Rad Rover 
fiks 		gesund heil 
film 		Film 
firma 		Firma 
flard 		Fetzen Hader Lappen 
fliekhuis 		Kino 
flikker 		flackern 
floreer 		blühen 
flou word 		in Ohnmacht fallen ohnmächtig werden 
fluit 		Flöte 
fooitjie 		Trinkgeld 
forel 		Forelle 
formasie 		Formation 
fossiel 		Fossil 
fout 		Fehler Irrtum Versehen 
framboos 		Himbeere 
funksie 		Funktion Tätigkeit Wirksamkeit 
gaaf 		gut gütig 
gaan 		fahren gehen treten 
gaan staan 		halten anhalten Halt machen stocken stoppen 
gade 		Frau Gemahlin 
galery 		Galerie Stollen Wandelgang 
gans 		Gans 
garage 		Garage 
gas 		Gas 
gasvry 		gastlich 
gat 		Loch 
geadresseerde 		Adressat Empfänger 
gebed 		Gebet 
gebeur 		geschehen passieren sich ereignen stattfinden vorkommen 
gebeurtenis 		Begebenheit 
gebied 		Flächeninhalt 
geboorte 		Geburt 
gebore 		gebürtig 
gebou 		Bau Bauwerk Gebäude 
gebruik 		Angewohnheit Brauch Gebrauch Gepflogenheit Gewohnheit Usus 
gedaante 		Form Gestalt 
gedagte 		Gedanke 
gedeelte 		Anteil Teil 
gedeeltelik 		teils 
gedek 		trächtig schwanger 
gedig 		Gedicht Poem 
gedra hom 		sich aufführen sich benehmen sich betragen sich verhalten 
geduld 		Geduld 
geduldig 		geduldig 
gedurende 		während 
gee 		erteilen geben angeben herreichen 
geel 		gelb 
gees 		Gemüt Seele 
geesdrif 		Begeisterung Enthusiasmus 
geheim 		geheim heimlich verborgen verstohlen 
gehoorsaam 		folgen befolgen gehörchen 
gehoorstuk 		Hörer 
geld 		Geld 
geldstuk 		Geldstück Münze 
geleentheid 		Begebenheit Gelegenheit Geschehnis Ereignis Fall Vorfall 
geliefde 		Geliebte 
geluk 		Glück 
gelukkig 		glücklig 
gelukkig wees 		Glück haben 
gelykheid 		Gleichheit 
gemiddeld 		mittlere mittlerer mittleres Mittel‐ 
genealogie 		Genealogie Geschlechtsregister 
genealogies 		genealogisch 
geneig 		geneigt zu 
generaal 		Feldherr General 
generasie 		Generation Geschlecht 
geniet 		frohlocken sich freuen 
genoeg 		auskömmlich genügend ziemlich zulänglich 
genot 		Freude Genuß Vergnügen Wohlgefallen 
geparenteer 		verwandt anverwandt 
geraamte 		Gebein Gerippe Knochengerüst Skelett 
gereed 		bereit erbötig fertig 
gereedskap 		Gerät Utensilien Zeug 
geregtigheid 		Gerechtigkeit Justiz 
gerieflik 		bequem gemächlich wohnlich 
geruime tyd 		lange 
gesag 		Autorität Gewalt 
gesels 		reden sprechen 
gesig 		Aussehen Äußere Gesicht Miene 
gesin 		Familie 
geskenk 		Angebinde Gabe Geschenk Spende Vermächtnis 
geskie 		geschehen passieren sich ereignen stattfinden vorkommen 
geskiedenis 		Geschichte Historie 
geskikt 		angemessen füglich geeignet zeitgemäß 
geslag 		Generation Geschlecht 
geslaglys 		Generation Geschlecht 
geslagregister 		Generation Geschlecht 
gesond 		gesund heil 
gesondheid 		Gesundheit 
gespanne 		gespannt 
gesprek 		Gespräch Unterhaltung Unterredung 
getroud 		verheirated 
geur 		Geruch 
geveg 		Kampf Schlacht 
gevolglik 		folglich 
geweldig 		heftig 
gewete 		Gewissen 
gewig 		Gewicht Wucht 
gewild 		populär volkstümlich 
gewoon 		gewöhnlich 
gewoond wees 		sich gewöhnen 
gewoonte 		Angewohnheit Brauch Gebrauch Gepflogenheit Gewohnheit Usus 
gier 		Geier 
giet 		gießen schütten 
giftig 		giftig 
gil 		heulen zetern 
gimnastiek 		Gymnastik 
ginder 		da dort 
ginds 		da dort 
gister 		gestern 
glad nie 		durchaus nicht ganz und gar nicht ganz nicht 
glas 		Glas 
gleuf 		Falz 
glimlag 		lächeln 
glo 		glauben 
gly 		gleiten glitschen rutschen 
god 		Gott 
godsdiens 		Glaube Religion 
godsdienstig 		fromm gottesfürchtig 
goed 		gut gütig 
goedkoop 		billig 
gooi 		schleudern werfen 
gordyn 		Gardine Vorhang 
gou 		flugs geschwind schnell 
goud 		Gold 
goue 		golden Gold‐ 
gou maak 		eilen sputen 
graad 		Grad Staffel Stufe 
graag 		bereit bereitwillig gern 
gram 		Gramm 
grammatika 		Grammatik Sprachlehre 
gras 		Gras 
gratis 		unentgeltlich 
grens 		Grenze Schranke 
gretig 		begierig habgierig lüstern 
griep 		Grippe 
groen 		grün 
groente 		Gemüse 
groep 		Gruppe 
groet 		grüßen begrüßen bewillkommnen 
grondwet 		Konstitution Verfassung 
groot 		groß 
grootmoeder 		Großmutter 
grootouers 		Großeltern 
grootte 		Ausdehnung Bereich Dimension Fassung Gehalt Umfang 
grootvader 		Großvater 
grot 		Grotte 
groutjie 		Esel 
gryp 		greifen angreifen ergreifen 
grys 		grau 
gunsteling‐ 		gewogen gnädig günstig hold 
haai 		Hai Haifisch 
haalbaar 		ausführbar 
haan 		Hahn 
haar 		ihr 
haarkapper 		Friseur Frisör 
haarself 		sich 
haas 		Hase 
haastig 		geschwind hurtig rasch schnell 
haat 		Haß 
hael 		Hagel 
hakie 		Klammer Krampe 
hals 		Hals 
hand 		Hand 
handel 		Handel 
handelaar 		Händler Kaufmann 
handstuk 		Hörer 
handtekening 		Unterschrift 
hang 		hängen 
hanteer 		handhaben manipulieren 
hard 		laut 
hardloop 		laufen 
hare 		Haar Haare 
hart 		Gemüt Herz 
hartlik 		herzlich 
hawe 		Hafen 
heelal 		Universum Weltall 
heeltemal 		ganz gänzlich gar 
heerlik 		behaglich herrlich genehm angenehm 
heide 		Heide 
heilig 		heiligen weihen 
heks 		Hexe 
hel 		Dschehenna 
held 		Held Heroe Heros 
helder 		hell licht lichtvoll 
heldhaftig 		heroisch 
heldin 		Heldin 
hele 		ganz total 
helm 		Helm Sturmhaube 
help 		assistieren beistehen helfen 
hemel 		Himmel 
hemp 		Hemd 
hen 		Henne 
hengel 		Angelrute 
herder 		Hirt Senner 
herfs 		Herbst 
herhaal 		entgegnen 
herinnering 		Andenken Erinnerung Gedächtnis 
herkoms 		Abkunft Abstammung Herkunft Ursprung 
heroïen 		Heroin 
heroïne 		Heroin 
hert 		Hirsch 
heuning 		Honig 
heup 		Hanke Hüfte 
hierdie 		diese dieses dieser 
hierheen 		hierher hierhin nach hier 
higiënies 		gesundheitlich 
hings 		Hengst 
hiëna 		Hyäne 
hoed 		Hut 
hoekom 		weshalb weswegen 
hoender 		Huhn 
hoerhuis 		Bordell 
hoes 		husten 
hoeveel 		wieviel 
hok 		Bauer Käfig 
hom 		ihm 
homself 		sich 
hom besin 		bedenken erwägen sich überlegen 
hond 		Hund 
honderd 		hundert 
honger 		hungrig 
hoofpyn 		Kopfschmerzen 
hoofsaaklik 		besonders eigens insbesondere vornehmlich vorzüglich zumal 
hoofstad 		Metropole 
hoop 		hoffen 
hoor 		hören vernehmen 
horlosie 		Uhr 
hospitaal 		Hospital Hospiz Krankenhaus 
hotel 		Hotel 
hou 		halten aufhalten 
houding 		Aufführung Benehmen Betragen Gebahren Verhalten 
houer 		Besteck Etui Gehäuse 
hout 		Holz 
hou van 		achten mögen schätzen wertschätzen würdigen 
hoërskool 		Oberschule 
huidig 		heutig 
huis 		Haus 
huisves 		unterbringen 
huis toe 		nach Hause 
huldig 		ehren beehren verehren 
hulle 		ihre 
hulleself 		sich 
hulp 		Beihilfe Beistand Handreichung 
hurk 		kauern 
huur 		mieten 
huurmotor 		Taxe Taxi 
huwelik 		Ehe 
hy 		er ihm ihn seiner 
hyser 		Aufzug Fahrstuhl Lift 
hê 		besitzen haben innehaben 
idee 		Gedanke Idee Vorstellung 
idioom 		Dialekt Idiom Mundart 
iemand 		ein gewisser einer irgend einer irgendwer jemand 
iep 		Rüster Ulme 
iets 		etwas irgendetwas irgendwas 
ignoreer 		ignorieren nicht berücksichtigen unbeachtet lassen 
impak 		Wirksamkeit 
in 		in nach pro zu 
indeks 		Index Register Verzeichnis 
indien 		falls insofern wenn wofern 
individueel 		individuell 
indruk 		Effekt Wirkung 
industrie 		Gewerbe Industrie 
informasie 		Auskunft Bericht Bescheid 
ingenieur 		Ingenieur 
inheems 		einheimisch 
inhoud 		Inhalt 
inlewer 		liefern 
inligting 		Auskunft Bericht Bescheid 
inligtingskantoor 		Auskunftstelle 
inmaak 		einlegen einmachen 
innig 		gemütlich innig intim vertraulich vertraut 
inrigting 		Anstalt Institut 
inruil 		austauschen auswechseln umtauschen vertauschen verwechseln 
insident 		Ereignis 
insig 		Auffassung Begriff Verständnis 
insit 		stecken 
insluitend 		einschießlich inklusive 
inspektisto 		Aufsichtsbeamter Inspektor 
inspuit 		einspritzen injizieren 
instel 		anbrechen anfangen beginnen 
instituut 		Anstalt Institut 
instruksie 		Belehrung Instruktion Verhaltungsbefehl Weisung 
inteendeel 		dagegen entgegengesetzt gegenteils hingegen im Gegensatz 
intelligent 		einsichtsvoll intelligent verständig 
intens 		intensiv 
internasionaal 		international 
intusse 		einstweilen indes inzwischen unterdessen 
invoer 		importieren 
invul 		ausfüllen erfüllen 
in alleryl 		flugs geschwind schnell 
in bedwang hou 		herrschen beherrschen regieren 
in die algemeen 		generell überhaupt 
in die ander tyd 		schwanger 
in die geheim 		insgeheim verstohlen 
in kennis stel 		Auskunft geben benachrichten informieren mitteilen 
in verband met 		betreffs bezüglich 
ivoor 		Elfenbein 
ja 		ja doch 
jaag 		eilen rennen 
jaar 		Jahr 
jaarliks 		jährlich 
jag 		Jacht Yacht 
jager 		Jäger Weidmann 
jakkals 		Schakal 
jaloers 		eifersüchtig 
jammer 		bedauerlich leider 
jammer wees 		bedauern 
jas 		Mantel Paletot Überrock Überzieher 
jeens 		um 
joernalis 		Journalist 
jokkie 		Jockei 
jongmens 		Jüngling 
jonk 		jugendlich jung 
josie 		Teufel 
jou 		dir 
joune 		der deine das deine die deine 
juis 		bestimmt bündig exakt genau präzis präzise pünktlich 
julle 		dein deinig euer eurige Ihr ihrige 
julle s'n 		der deine der euere der Ihre 
juweel 		Gemme 
juwelier 		Juwelier 
jy 		du Sie 
kaart 		Karte 
kaartjie 		Billett Fahrkarte Karte 
kabeljou 		Dorsch Kabeljau 
kabinet 		Kabinett 
kak 		Auswurf Exkrement Kot Unrat 
kalkoen 		Truthahn 
kalm 		fromm gelassen ruhig sanft 
kalmeer 		beruhigen 
kam 		kämmen 
kameel 		Kamel 
kameelperd 		Giraffe 
kamer 		Gemach Stube Zimmer 
kamp 		Campingplatz Zeltplatz 
kampeerterrein 		Campingplatz Zeltplatz 
kan 		dürfen können vermögen 
kanaal 		Graben Kanal 
kandidaat 		Aspirant Bewerber 
kangeroe 		Kängeruh 
kans 		Chance 
kanselleer 		annullieren für null und nichtig erklären kassieren 
kant 		Flanke Seite 
kantoor 		Büro Geschäftszimmer Kontor 
kantoorklerk 		Angestellte Kanzlist 
kap 		bröckeln abbröckeln krümeln abkrümeln 
kaptein 		Hauptmann Kapitän 
kar 		Auto 
karakter 		Charakter Gemüt 
kas 		Schrank 
kasset 		Kassette 
kasteel 		Burg Kastell Schloß 
kat 		Katze 
katalogus 		Katalog Verzeichnis 
katolisisme 		Katholizismus 
keel 		Gurgel Kehle 
keer 		Mal 
kelder 		Keller 
kelner 		Kellner 
ken 		kennen 
kennis 		Bekannter 
kennisgewing 		Auskunft Bericht Bescheid 
kers 		Kerze Licht 
keuse 		Auslese Wahl 
kies 		auslesen wählen auswählen erwählen 
kiesel 		Silicium Silizium 
kilogram 		Kilogramm 
kilometer 		Kilometer 
kind 		Abkomme Abkömmling Ableger Sproß Sprößling 
kiosk 		Kiosk 
kla 		klagen sich beklagen verklagen 
klaar 		bereits schon 
klank 		Hall Klang Laut Schall Ton 
klap 		klopfen schlagen 
klaploper 		Parasit Schmarotzer 
klas 		Klasse 
klassiek 		klassisch 
klavier 		Klavier 
klee 		anziehen kleiden ankleiden bekleiden 
klein 		gering klein 
kleindogter 		Enkelin 
kleingeld 		Kleingeld 
kleinseun 		Enkel 
klere 		Kleider 
kleur 		Farbe 
kleurryk 		bunt 
klier 		Drüse 
klik 		klacken klappen schnalzen 
klim 		klettern klimmen 
klimaat 		Klima 
kliniek 		Klinik 
klink 		gellen klingen läuten tönen 
kliënt 		Klient Kunde 
klomp 		Ar 
kloof 		Schlucht 
klub 		Klub 
knal 		erschallen 
knie 		Knie 
knip 		Verschluß 
knippie 		Kniff 
knoop 		Knoten 
kobalt 		Kobalt 
kodeks 		Kodex 
koei 		Kuh 
koel 		kühl 
koepee 		Abteil Coupé Kupee 
koerant 		Zeitung 
koeël 		Kugel 
koffer 		Koffer 
koffie 		Kaffee 
kollega 		Amtsbruder Amtsgenosse Genosse Kollege 
kollege 		Kollegium 
kolom 		Kolumne Säule Spalte 
kolonie 		Ansiedelei Ansiedlung Kolonie 
kom 		kommen 
kombuis 		Küche 
komedie 		Komödie Lustspiel 
kommandant 		Befehlshaber 
kommentaar 		Erläuterung Kommentar 
kommissie 		Courtage 
kompak 		fest kompakt massig 
kompartement 		Abteil Coupé Kupee 
kompetisie 		Konkurrenz‐Prüfung Preisausschreiben Wettbewerb 
koms 		Ankunft Eintreffen 
kondor 		Kondor 
kondukteur 		Aufseher Führer Kondukteur Schaffner 
koning 		König 
koninkryk 		Königreich 
konsep 		Brouillon 
konsert 		Musikaufführung Konzert 
konsul 		Konsul 
kontak 		Berührung Kontakt 
kontant 		bar kontant 
kontrak 		Akkord Traktat Vertrag 
kontrole 		Verwaltung 
kontroleer 		kontrollieren nachsehen überwachen 
konyn 		Kaninchen 
kook 		brausen kochen sieden wallen 
koors 		Fieber 
kop 		Kopf 
kopiereg 		Verlagsrecht 
koppelaar 		Kupplung 
koppie 		Tasse 
kort 		kurz 
kos 		kosten 
kosmetiek 		Kosmetik 
kostelik 		herrlich stattlich wunderbar 
kou 		kauen 
kous 		Strumpf 
krag 		Gewalt Kraft 
krap 		kratzen ritzen 
kreef 		Krebs 
kreëer 		schaffen erschaffen 
krimpvark 		Igel 
krisis 		Krisis Krise 
kristal 		Kristall 
kriterium 		Kriterium 
kritiseer 		begutachten kritisieren 
krokodil 		Krokodil 
kronkel 		sich schlängeln 
kropslaai 		Kopfsalat Lattich Salat 
kruier 		Dienstmann Gepäckträger Träger 
kruip 		kriechen 
kruis 		Kreuz 
kruisskyf 		Beefsteak 
kry 		bekommen empfangen erhalten 
kubus 		Kubus Würfel 
kudde 		Ar 
kuier 		besuchen einen Besuch abstatten 
kultuur 		Kultur 
kunstenaar 		Artist 
kunstig 		anstellig behende fix geschickt geübt gewandt 
kurk 		Kork Pfropfen Stöpsel 
kursus 		Kurs Kursus 
kus 		Kuß 
kussing 		Kissen 
kwaai 		böse schlecht 
kwalifiseer 		qualifizieren 
kwartier 		Viertel Viertelstunde 
kwessie 		Frage 
kyker 		Zuschauer 
laag 		Scheibe Schicht 
laai 		Lade Schublade Tischlade 
laat 		lassen überlassen unterlassen zurücklassen 
laatste 		letzte letzter letztes 
lag 		lachen 
laken 		Betttuch Bettlaken Laken 
lam 		Lamm 
lama 		Lama 
lamp 		Lampe 
landbou 		Ackerbau 
landskap 		Landschaft 
lang 		lang 
langdurig 		weitläufig 
langs 		an bei neben 
langsaan 		beiläufig dabei daneben 
lank 		lange 
later 		dann darauf hernach hierauf hinten hinterher nachher später 
lawaai 		Aufsehen Braus 
leef 		leben 
leek 		Laie 
leen 		borgen entlehnen 
leer 		lehren belehren instruieren unterrichten unterweisen 
leerling 		Zögling 
lees 		lesen 
leeu 		Löwe 
leeuwyfie 		Löwin 
legende 		Legende 
lei 		führen leiten lenken 
leiding 		Estrade 
leier 		Führer 
lek 		Loch 
lekker 		behaglich herrlich genehm angenehm 
lektor 		Lektor 
lelie 		Lilie 
lelik 		häßlich 
lemoen 		Apfelsine Orange Pomeranze 
lening 		Anleihe Borg Leihen 
lente 		Frühjahr Frühling Lenz 
lepel 		Löffel 
les 		Lehraufgabe Lektion Unterrichtsstunde 
lessenaar 		Pult 
lettergreep 		Silbe 
letterkunde 		Literatur 
leunstoel 		Fauteuil Lehnstuhl 
lewe 		Leben 
lewendig 		aufgeweckt flink frisch gewandt hurtig munter wach 
lewer 		Leber 
leër 		Armee Heer 
lid 		Anhänger Glied 
liefhê 		gern haben lieben mögen 
lieflik 		süß 
lief wees vir 		achten mögen schätzen wertschätzen würdigen 
liewer 		lieber 
lig 		Licht 
liggaam 		Körper Leib 
lindeboom 		Linde Lindenbaum 
linguïstiek 		Linguistik 
links 		links 
linne 		Leinenzeug Wäsche 
lisensie 		Erlaubnis Gewerbeschein Lizenz 
liter 		Liter 
literatuur 		Literatur 
logies 		logisch 
lok 		ködern locken 
long 		Lunge 
loop 		fließen rinnen strömen 
lork 		Lärche 
lorkboom 		Lärche 
lot 		Bestimmung 
lourier 		Lorbeer Lorbeerbaum 
lug 		Luft 
lui 		faul 
luiperd 		Leopard 
luister 		anhören horchen aushorchen zuhören 
luister naar 		anhören horchen aushorchen zuhören 
lupien 		Wölfin 
lupine 		Wölfin 
lus 		Inklination Lust 
luukse 		luxuriös 
lyf 		Körper Leib 
lyk 		Kadaver Leiche 
lyn 		Linie Strich Zeile 
lys 		Liste Verzeichnis 
lê 		gelegen sein liegen 
ma 		Mutter 
maag 		Magen 
maak 		anfertigen herstellen leiten machen tun zurücklegen 
maal 		Mal 
maaltyd 		Essen Fraß Mahlzeit 
maan 		Mond 
maand 		Monat 
maar 		aber allein dagegen sondern 
maer 		mager 
mag 		Gewalt Kraft 
makker 		Genosse Kamerad 
maklik 		geläufig leicht mühelos nicht schwierig 
mal 		irre toll verrückt wahnsinnig 
malmok 		Murmeltier 
malmokkie 		Meerschweinchen 
mal wees oor 		mögen 
man 		Ehemann Gatte Gemahl Gespons 
mandjie 		Korb 
mangaan 		Mangan 
mark 		Basar Markt Warenhaus 
marmotjie 		Meerschweinchen 
marter 		Marder 
masboom 		Föhre Kiefer 
masjien 		Maschine 
masker 		Maske 
massa 		Haufen Menge Stapel 
mat 		Teppich 
materieel 		materiell 
matig 		mäßig 
medies 		medizinisch 
medium 		mittlere mittlerer mittleres Mittel‐ 
meebring 		mitbringen mitnehmen 
meedeel 		anschließen mitteilen teilhaftig machen verbinden 
meen 		glauben 
meer 		See 
meeste 		meist am meisten 
meganisme 		Mechanismus 
meisie 		Dirne Mädchen 
mekaar 		einander 
meld 		ankündigen anzeigen avisieren melden anmelden verkünden 
melk 		Milch 
meng 		mengen mischen 
mengsel 		Gemisch 
menigte 		Haufen Menge Stapel 
mening 		Äußerung Gesinnung Gutdünken Meinung 
mens 		Mensch 
mensekind 		Mensch 
merk 		auffassen perzipieren wahrnehmen 
merrie 		Stute 
merrieperd 		Stute 
mes 		Messer 
met 		in Begleitung von mit zusammen mit zuzüglich 
meter 		Meter 
meubel 		Möbel 
middagete 		Diner Mittagessen 
mielies 		Mais 
miljoen 		Million 
millimeter 		Millimeter 
min 		wenig 
minder 		weniger 
mineraal 		Mineral 
minister 		Minister 
minste 		mindest wenigst 
minuut 		Minute 
mis 		Nebel 
miskien 		eventuell möglicherweise vielleicht wohl 
misterieus 		geheimnissvoll mysteriös 
mite 		Mythus 
mode 		Mode Weise 
modern 		modern 
moed 		Mut 
moedeloos 		verzagt 
moeder 		Mutter 
moeg 		matt müde 
moeilik 		schwer 
moeilikheid 		Schwierigkeit 
moeite 		Mühe Mühsal 
moet 		müssen sollen 
mol 		Maulwurf 
mond 		Mund 
monnik 		Mönch 
monster 		Monstrum Ungeheuer Ungetüm Unhold 
monument 		Denkmal Monument 
mooi 		hübsch schön 
moontlik 		angängig etwaige 
moreel 		moralisch sittlich 
mossie 		Spatz Sperling 
mot 		Motte 
motor 		Auto 
motorfiets 		Kraftfahrrad Motorrad 
motorhawe 		Garage 
muis 		Maus 
munt 		Geldstück Münze 
muntstuk 		Geldstück Münze 
mus 		Mütze 
museum 		Museum 
musiek 		Musik 
muur 		Mauer Wand 
my 		mir 
myl 		Meile 
myn 		Bergwerk 
myne 		der meine die meine das meine 
môre 		morgen 
na 		an in nach zu 
naaldwerk doen 		heften nähen 
naam 		heißen nennen benennen ernennen 
naamlik 		zwar 
naburig 		angrenzend anstoßend benachbart 
naby 		an bei neben 
nadat 		nachdem 
naderkom 		bevorstehen 
nael 		Nagel 
nag 		Nacht 
nagereg 		Dessert Nachtisch 
nagvlinder 		Motte 
nakomelingskap 		Generation Nachkommenschaft Nachwuchs 
namekaar 		hinter einander 
nar 		Hanswurst Harlekin 
narkose 		Betäubung Narkose 
nasien 		revidieren 
nasionaal 		national 
nasionaliteit 		Staatsangehörigkeit 
nat 		naß 
natuur 		Natur 
natuurlik 		verständlich 
naverwantskap 		Verwandtschaft 
navorsing 		Examen 
navraag 		Frage 
na ... toe 		an in nach zu 
na behore 		zurecht 
nee 		kein nicht 
neef 		Cousin Vetter 
neem 		annehmen empfangen genehmigen 
nege 		neun 
negentien 		neunzehn 
negentig 		neunzig 
nek 		Hals 
net 		allein bloß erst lediglich nur 
netnou 		bald alsbald baldig 
neus 		Nase 
nie 		nein 
niemand nie 		keine keiner keines niemand 
nier 		Niere 
nietemin 		aber doch dennoch jedoch 
nig 		Nichte 
niggie 		Base Kusine 
niks 		nichts 
niks nie 		nichts 
nodig hê 		benötigen brauchen nötig haben 
noem 		nennen 
nog 		noch 
nogal 		ein bischen ein wenig etwas ziemlich 
nommer 		Nummer 
noodhulp 		Erste Hilfe Unfallhilfe 
nooi 		einladen 
noordelik 		nördlich 
noordpool‐ 		arktisch nordpolar 
noot 		Bon Schein 
normaal 		normal 
notisie 		Aufzeichnung Note Notiz 
nou‐nou 		bald alsbald baldig 
nou 		jetzt gegenwärtig nun 
nou net 		eben gerade just soeben 
nuus 		Neues Neuheit Neuigkeit 
nuuskierig 		neugierig 
nuut 		neu 
nuweling 		Novize 
nywerheid 		Gewerbe Industrie 
nêrens nie 		nirgends 
o 		ach o ho oh 
oefen 		exerzieren üben einüben 
oefening 		Exerzitium Übung 
oeros 		Auerochs Ur 
of 		oder 
offisieel 		amtlich offiziell 
olie 		Öl 
olifant 		Elefant 
olm 		Rüster Ulme 
om 		um 
omdat 		da weil 
omgewing 		Umgebung 
omsit 		antun anziehen 
omstandigheid 		Bewandnis Umstand 
omtrent 		annähernd etwa ungefähr 
om te 		für um um zu 
onaangenaam 		wiederwärtig 
ondankbaar 		undankbar 
onder 		unter unterhalb 
onderaan 		unten 
onderdaan 		Untertan 
onderdruk 		erpressen unterdrücken 
onderhoud 		Gespräch Unterhaltung Unterredung 
onderklere 		Wäsche 
onderneming 		Unternehmung 
ondersoek 		examinieren inspizieren nachsehen prüfen untersuchen 
ondersteun 		stemmen unterhalten unterstützen 
ondertoe 		abwärts herab herunter hinab hinunter 
ondervinding 		Erfahrung 
onderwerp 		Thema 
onderwys 		Unterricht 
onderwyser 		Lehrer 
onderwyseres 		Lehrerin 
ongeduldig 		ungeduldig 
ongeluk 		Unfall 
ongelukkig 		unglücklig 
onjuis 		falsch irrig 
onreg 		Unbill Unrecht 
ons 		uns 
onskuldig 		harmlos 
ons s'n 		der unsere das unsere 
ontbied 		entbieten holen kommen lassen 
ontbreek 		fehlen mangeln ermangeln 
ontbyt 		Frühstück 
ontdek 		abdecken entdecken enthüllen 
onthaal 		Bewirtung Speisung 
onthou 		behalten gedenken sich erinnern 
ontklee 		entkleiden 
ontlok 		ausschließen aussondern 
ontmoet 		antreffen begegnen 
ontploffing 		Explosion 
ontslaan 		abdanken entlassen verabschieden 
ontspan 		sich zerstreuen 
ontspanning 		Erholung 
ontvang 		bekommen empfangen erhalten 
ontvangs 		Empfang Erhalten 
onvatbaar 		immun 
oog 		Auge 
oogmerk 		Ziel Zweck 
ooi 		Mutterschaf 
ook 		auch ebenfalls gleichfalls 
oom 		Onkel 
oomblik 		Augenblick Moment 
oomskind 		Cousin Vetter 
oop 		offen 
oopgaan 		aufgehen 
oopmaak 		aufmachen öffnen 
oor 		Ohr 
oordeel 		richten urteilen beurteilen 
oordra 		angeben herreichen verbringen zubringen 
ooreenkoms 		Abkommen Einklang Übereinkommen Übereinkunft Übereinstimmung 
ooreenstemming 		Abkommen Einklang Übereinkommen Übereinkunft Übereinstimmung 
oorgang 		Übertritt 
oorleef 		überleben 
oorlog 		Krieg 
oorlog voer 		kriegen Krieg führen 
oorsend 		schicken senden einsenden 
oorsending 		Sendung 
oorsig 		Übersicht 
oorskry 		entern übergeben übertreten 
oorsprong 		Genesis 
oorspronklik 		ursprünglich Ursprungs‐ 
oorsteek 		entern übergeben übertreten 
oortreding 		Sünde 
oortree 		sündigen sich versündigen 
oorweeg 		berücksichtigen betrachten erwägen sich überlegen 
oorwinning 		Sieg 
ooste 		Orient Osten 
oostelik 		östlich 
ooswaarts 		nach Osten ostwärts 
op 		in nach pro zu 
opdrag 		Auftrag Bestellung Kommission 
opera 		Oper 
operasie 		Operation 
opereer 		operieren 
opgaan 		steigen ersteigen 
ophang 		anhängen aufhängen erhängen henken 
ophef 		Aufsehen Braus 
ophou 		enden endigen 
opinie 		Äußerung Gesinnung Gutdünken Meinung 
opklaar 		erhellen 
oplaai 		entflammen 
oplei 		aufziehen bilden erziehen züchten 
opleiding 		Erziehung 
oplewer 		erzeugen hervorbringen produzieren 
oplossing 		Auflösung 
opmerk 		bemerken 
opmerking 		Anschauung 
oppas 		achtgeben aufpassen beachten zusehen 
opperbevelhebber 		Generalissimus Oberfeldherr 
oppervlakte 		Flächeninhalt 
oppik 		fassen nehmen 
opraak 		zehren 
oproep 		anrufen zurufen 
opsig 		Beziehung Hinsicht Verbindung Verhältnis 
opsit 		antun anziehen 
opstaan 		aufstehen sich stellen 
opstandig 		abtrünnig widerspenstig 
optel 		fassen nehmen 
optree 		agieren handeln verfahren vorgehen wirken 
optrek 		heben aufheben erheben zücken 
opvatting 		Gedanke Idee Vorstellung 
opvoering 		Darbietung Darreichung Darstellung Vorlegung Vorstellung 
opwen 		aufziehen spannen anspannen ausspannen straffen 
op die proef stel 		erproben 
op tyd 		beizeiten zeitig zur rechten Zeit 
oral 		allenthalben allerorten überall 
organisasie 		Einrichtung Organisation 
organiseer 		einrichten organisieren 
orgidee 		Orchidee 
orkes 		Orchester 
oseaan 		Ozean Weltmeer 
otter 		Fischotter 
oud 		alt bejahrt betagt 
ouderdom 		Alter 
ouerloos 		verwaist Waisen‐ 
ouers 		Eltern 
o wêreld 		weh wehe 
pa 		Vater 
pad 		Bahn Chaussee Strecke Weg 
padda 		Kröte 
pak 		packen einpacken 
pakket 		Ballen Paket 
pakkie 		Bündel Päckchen Paket 
pakplek 		Gewahrsam 
pak klere 		Anzug Gewand Kostüm Tracht 
paling 		Aal 
palladium 		Palladium 
pampoen 		Kürbis 
pan 		Bratpfanne Kasserole Kochpfanne Pfanne 
pap 		leer 
papegaai 		Papagei 
paradys 		Paradies 
parasiet 		Parasit Schmarotzer 
parfuum 		Parfüm 
party 		Feier Fest 
pas 		behagen fügen ziemen geziemen 
passasier 		Fahrgast Passagier 
pater 		Pater 
pawiljoen 		Pavillon 
peer 		Birne 
peil 		sondieren 
pensioentrekker 		Emeritus 
pensionaris 		Emeritus 
peper 		Pfeffer 
per 		in nach pro zu 
perd 		Gaul Pferd 
permanent 		fest 
perron 		Bahnsteig Kai 
persent 		Prozent 
persentasie 		Prozent 
persepsie 		Auffassung Wahrnehmung 
perske 		Pfirsich 
persoon 		Person 
persoonlik 		individuell 
petrol 		Benzin 
piano 		Klavier 
piekniek 		Picknick 
piesang 		Banane 
pil 		Pille 
pit 		Kern Obststein 
plaas 		Bauernhof Besitzung Gut Landgut 
plaaslik 		lokal örtlich 
plaat 		Diskus Wurfscheibe 
plaatsvind 		geschehen passieren sich ereignen stattfinden vorkommen 
plak 		kleben leimen 
plan 		Absicht Plan 
plant 		Anlage Pflanzen Anpflanzen Pflanzung Anpflanzung 
pleeg 		anfertigen herstellen leiten machen tun zurücklegen 
plek 		Anstalt Gelaß Ort Platz Stelle 
plesier 		Freude Genuß Vergnügen Wohlgefallen 
plig 		Gebühr 
ploert 		Gauner Halunke Schuft Schurke Spitzbube 
plooi 		furchen 
pluimvee 		Federvieh 
poeding 		Pudding 
poeier 		Puder 
poging 		Bemühung Mühe Mühsal Versuch 
poliesman 		Polizist Schutzmann 
polisie 		Polizei 
polisiestasie 		Polizeiamt Polizeiwache 
politiek 		politisch 
polities 		politisch 
pomp 		pumpen 
poot 		Bein Pfote Unterschenkel 
pop 		Puppe 
populier 		Pappel 
populêr 		populär volkstümlich 
porsie 		Anteil Portion Ration 
pos 		zur Post geben zur Post tragen 
posbus 		Postfach 
posgeld 		Frankatur Porto 
poskantoor 		Postamt 
pot 		Hafen Kanne Krug Topf 
pous 		Papst 
pouse 		Pause 
poësie 		Dichtkunst Dichtung Poesie 
praat 		reden sprechen 
pragtig 		herrlich stattlich wunderbar 
prakties 		praktisch 
predikant 		Pastor Pfarrer 
prent 		Film 
president 		Präsident 
presies 		bündig 
presteer 		erlangen erzielen reichen erreichen 
pretensieus 		anspruchsvoll 
preuts 		prüde zimperlich 
primitief 		primitiv 
prinsipaal 		Rektor 
privaat‐ 		privat 
privaat 		privat 
probeer 		erproben probieren prüfen versuchen 
probleem 		Problem 
produk 		Erzeugung Produktion 
produksie 		Erzeugung Produktion 
produseer 		erzeugen hervorbringen produzieren 
proe 		kosten schmecken 
professioneel 		beruflich Berufs‐ berufsmäßig Gewerbe‐ gewerbsmäßig 
professor 		Professor 
profyt 		Gewinn Überschuß Verdienst Vorteil 
program 		Programm 
projek 		Entwurf Plan Projekt 
prokureur 		Jurist Rechtsgelehrter 
promosie 		Avancement 
proses 		Prozeß 
protes 		Einspruch 
protesteer 		anfechten beanstanden Einspruch erheben protestieren 
provinsie 		Provinz 
prys 		loben preisen rühmen verherrlichen 
publiek 		öffentlich 
puik 		ausgezeichnet gediegen trefflich vortrefflich vorzüglich 
puisie 		Finne Pickel 
punt 		Punkt 
put 		Brunnen 
pyl 		Pfeil 
pyn 		Schmerz Weh 
pynappel 		Ananas 
pyp 		Pfeife 
questionnaire 		Formular 
raad 		Rat Ratschlag 
raadpleeg 		befragen konsultieren nachschlagen zu Rate ziehen 
raak 		geschehen vorkommen werden zu stande kommen 
raamwerk 		Einfassung Rahmen 
raas 		stürmen toben 
rabbi 		Rabbiner 
radio 		Strahl 
radium 		Radium 
rakkie 		Bordbrett Brett Regal Wandbrett 
ram 		Widder 
rapport 		Bericht Meldung Rapport Referat Vortrag 
ras 		Rasse 
ratel 		Dachs 
rebel 		Aufrührer Insurgent Rebell 
rede 		Anlaß Grund Ursache Veranlassung 
ree 		Reh 
reeds 		bereits schon 
reg 		Befugnis Recht 
regeer 		herrschen beherrschen regieren 
reghoekig 		rechtwinklig 
regime 		Regierungsform 
registreer 		registrieren 
regmaak 		reparieren 
regop 		aufrecht direkt gerade geradeaus geradeswegs geradezu 
regs 		rechts 
regterkant 		Steuerbord 
regtig 		tatsächlich 
regverdig 		billig gerecht 
reis 		reisen 
rekenbord 		Rechenbrett 
rekening 		Faktura Rechnung Warenrechnung 
rekenmeester 		Buchrevisor 
rekenraam 		Abakus Kugelmaschine Rechenmaschine 
rektig 		fürwahr wahrhaftig wahrlich wirklich 
rem 		Bremse 
renoster 		Nashorn 
reparasie 		Reparatur 
republiek 		Freistaat Republik 
res 		Bestand Nachbleibsel Rückstand Überbleibsel 
resep 		Rezept 
respek 		Achtung Ehrfurcht Respekt 
respekteer 		Achtung erweisen respektieren 
reuk 		Geruch 
reus 		Gigant Riese 
revolusionêr 		Revolutionär 
rewolwer 		Revolver 
reël 		arrangieren einrichten ordnen anorden veranstalten 
reën 		regnen 
reënboog 		Regenbogen 
reënjas 		Regenmantel 
rig 		dirigieren führen richten steuern 
rigting 		Kurs Richtung 
ring 		Ring 
ritus 		Ritus 
rivier 		Fluß 
rob 		Seehund 
robyn 		Rubin 
roer 		quirlen 
rog 		Roggen 
rok 		Rock Frauenrock 
rol 		Rolle 
rolletjie 		Brötchen Semmel 
rolprent 		Film 
rolystervark 		Igel 
romp 		Rock Frauenrock 
rond 		rund 
rondkyk 		umsehen 
rood 		rot 
rooikat 		Luchs 
rook 		rauchen 
room 		Rahm Sahne 
roos 		Rose 
rooster 		Gitter 
rot 		Ratte 
rots 		Fels Felsen Steinmasse 
rou 		arg rauh roh 
rubriek 		Rubrik 
rug 		Rücken 
rugryer 		Parasit Schmarotzer 
ruik 		riechen wittern 
rukkie 		Augenblick Moment 
rus 		ruhen sich ausruhen 
rusie 		Fehde Hader Streit Zank Zwiespalt Zwietracht Zwist 
ry 		reiten 
rybewys 		Fahrerschein Führerschein 
ryk 		ausgiebig reich vermögend 
rykdom 		Reichtum 
ryp 		reif 
rys 		Reis 
saad 		Same 
saag 		sägen 
saak 		Angelegenheit Ding Sache Werk 
saal 		Sattel 
saam 		aneinander beisammen gesamt insgesamt zugleich zusammen 
saambring 		mitbringen mitnehmen 
saamgaan 		sich treffen sich versammeln zusammenkommen zusammentreffen 
saam met 		in Begleitung von mit zusammen mit zuzüglich 
saans 		abends 
sag 		weich 
sago 		Sago 
sak 		Tasche 
sakeman 		Händler Kaufmann 
sal 		werden 
salamander 		Molch Salamander 
salaris 		Gage Gehalt Salär 
salmander 		Molch Salamander 
sambreel 		Regenschirm 
samelewing 		Gesellschaft 
sand 		Sand 
sandaal 		Sandale 
sanger 		Berufssänger Kantor Sänger 
sanksie 		Sanktion 
sap 		Saft 
sardien 		Sardelle 
sebra 		Zebra 
sedert 		seit 
see 		Meer See 
seehond 		Seehund 
seekoei 		Flußpferd 
seer wees 		Schmerz verursachen schmerzen wehe tun 
seil 		Segel 
seker 		allerdings bestimmt freilich gewiß immerhin wohl zwar 
sekerheid 		Bestimmtheit Gewißheit Sicherheit Zuversicht 
sekerlik 		allerdings bestimmt freilich gewiß immerhin wohl zwar 
seker maak 		behaupten bestätigen vergewissern 
sektor 		Sektor 
selde 		selten 
self 		selber selbst 
selfs 		gar ja selbst sogar 
sendeling 		Missionar 
sensitief 		empfindlich empfindsam sensibel 
sent 		Cent 
sentimeter 		Centimeter Zentimeter 
sentraal 		zentral 
sertifikaat 		Attest Testimonium Zeugnis Zertifikat 
sertifiseer 		behaupten bestätigen vergewissern 
servette 		Serviette 
ses 		sechs 
sestien 		sechzehn 
sestig 		sechzig 
seun 		Sohn 
sewe 		sieben 
sewentien 		siebzehn 
sewentig 		siebzig 
seën 		segnen 
siek 		krank 
sien 		antreffen begegnen 
sieraad 		Verzierung Zierat 
sigaar 		Zigarre 
sigaret 		Zigarette 
sigbaar 		augenscheinlich bemerkbar ersichtlich 
sigeuner 		Zigeuner 
silicium 		Silicium Silizium 
silwer 		Silber 
simbool 		Symbol 
simfonie 		Symphonie 
simpatie 		Sympathie 
simpatiseer 		sympathisieren 
sin 		Phrase Redensart Satz 
sing 		singen 
sinies 		zynisch 
sinneloos 		widersinnig 
sit 		legen setzen stecken stellen 
sitkamer 		Wohnzimmer 
situasie 		Fassung Lage Situation Zustand 
sjokolade 		Schokolade 
skaak 		Schach Schachspiel 
skaal 		Maßstab Skala 
skaam hom 		sich schämen 
skaap 		Hammel Schaf 
skaapkameel 		Lama 
skaapvleis 		Hammelfleisch 
skaars 		kaum 
skadu 		Schatten 
skakel 		anrufen telephonieren 
skakering 		Abstufung Nuance Schattierung Ton 
skandaal 		Ärgernis Skandal 
skare 		Haufen Menge Stapel 
skat 		Schatz Tresor 
skatkis 		Tresor 
skeef 		indirekt obliquus schief schräg 
skeer 		barbieren rasieren 
skema 		Schema 
skemer 		Zwielicht 
skep 		schaffen erschaffen 
skerm 		Schutzwand 
skerp 		scharf 
skets 		Entwurf Skizze 
skielik 		jäh 
skiereiland 		Halbinsel 
skil 		Borke Hülse Rinde Schale 
skilderagtig 		malerisch 
skildery 		Bild Gemälde 
skilpad 		Schildkröte 
skip 		Schiff 
skitterend 		blank 
skoen 		Schuh 
skok 		rütteln schütteln schüttern erschüttern 
skool 		Ar 
skoon 		blank rein reinlich sauber 
skoonbroer 		Schwager 
skoonseun 		Eidam Schwiegersohn 
skop 		stampfen trampeln 
skottelgoed 		Gedeck Service 
skouer 		Achsel Schulter 
skraal 		mager 
skreeu 		schreien 
skrif 		Handschrift 
skriftelik 		Schrift‐ schriftlich 
skryf 		schreiben 
skrywer 		Schriftsteller Verfasser 
skuim 		schaumen 
skuld 		schulden schuldig sein 
skuldig 		schuldig 
skyf 		Diskus Wurfscheibe 
skyn 		scheinen 
skêr 		Schere 
slaaf 		Knecht Sklave 
slaag 		Erfolg haben gelingen 
slaai 		Salat 
slaap 		schlafen 
slaapkamer 		Schlafzimmer 
slag 		Hieb Schlag Streich 
slagter 		Fleischer 
slang 		Schlange 
sleep 		schleppen nachschleppen 
sleg 		böse schlecht 
slegs 		allein bloß erst lediglich nur 
sleutel 		Schlüssel 
slim 		abgefeimt arglistig gerieben gewiegt gewitzigt listig schlau 
slinger 		schmeißen 
sloot 		Graben 
sluit 		zufallen 
sluk 		schlingen schlucken 
smaak 		schmecken 
smaaklik 		delikat 
smeek 		beschwören flehen 
smeerlap 		Wicht 
snags 		nachts nächtlicherweile 
snawel 		Schnabel 
sneeu 		schneien 
snelheid 		Eile Geschwindigkeit Hast 
snelheidsgrens 		Höchstgeschwindigkeit 
sny 		scheren abscheren schneiden abschneiden 
so 		annähernd etwa ungefähr 
soek 		ausschauen nach suchen aufsuchen 
soen 		küssen 
soet 		süß 
sofa 		Couch Sofa 
sog 		Sau 
sokkie 		Halbstrumpf Socke 
solank 		einstweilen indes inzwischen unterdessen 
soldaat 		Soldat 
somer 		Sommer 
sommer 		lieber 
sommige 		ein paar einige einiger einiges etliche manche 
somtyds 		manchmal 
son 		Sonne 
sonde 		Sünde 
sonder 		ohne 
soort 		Abart Art Gattung Schlag Sorte 
sorg 		Sorge tragen sorgen 
sorgvuldig 		sorgfältig sorgsam 
sosiaal 		sozial 
sous 		Brühe Sauce Soße Tunke 
sout 		Salz 
sowaar 		freilich tatsächlich 
sowat 		annähernd etwa ungefähr 
so ... soos 		ebenso ... wie sowohl ... als 
so net 		eben gerade just soeben 
so 'n 		derartige derartiger derartiges solche solcher solches 
spaar 		erübrigen sparen ersparen 
spaarbank 		Sparkasse 
spaargeld 		Ersparnis 
spandeer 		weihen widmen zueignen 
speel 		spielen 
speler 		Spieler 
sperma 		Samen Sperma 
spesiaal 		spezial speziell 
spesifiek 		spezifisch 
spiraal 		Spirale 
spoed 		eilen rennen 
spoel 		Haspel Spule 
spog 		ausposaunen brüsten prahlen renommieren 
spook 		Geist Gespenst Phantom Spuk 
sport 		Sport 
spring 		springen 
sprinkaan 		Grashüpfer Heuschrecke 
sprong 		Sprung 
spuug 		speien spucken 
spyskaart 		Menü Speisekarte 
staal 		Stahl 
staan 		aushalten austragen 
staat 		Reich Staat 
stad 		Ort Stadt 
stadigaan 		allmählich nach und nach sukzessive 
staf 		Stab 
staking 		Streik Strike 
stalhings 		Hengst 
stam 		Stamm 
stamboom 		Generation Geschlecht 
standaard 		Norm Richtschnur 
standbeeld 		Bildsäule Standbild Statue 
standpunt 		Standpunkt 
stap 		gehen laufen marschieren treten 
stapel 		Haufen Menge Stapel 
stasie 		Bahnhof 
stedeling 		Bürger Städter 
steeds 		allemal allzeit fortwährend immer jederzeit stets 
steel 		entwenden stehlen 
steenkool 		Kohle 
stelling 		These 
stelsel 		System 
stem 		Stimme 
ster 		Stern 
sterf 		sterben 
sterk 		kräftig stark 
stert 		Bürzel Fahne Lunte Rute Schleppe Schwanz Schweif Sterz Wedel 
stewig 		fest befestigt haltbar wiederstandsfähig 
stilhou 		halten anhalten Halt machen stocken stoppen 
stoel 		Stuhl 
stoep 		Veranda 
stok 		Stab Stecken Stock 
stop 		anhalten bremsen sperren 
storie 		Erzählung Geschichte 
stort 		Brause Dusche Sturzbad 
straat 		Straße 
straf 		Bestrafung Strafe 
strak 		gespannt 
strand 		Strand 
strandwolf 		Hyäne 
streek 		Bereich Gebiet Gegend Region 
strek 		sich erstrecken 
stroom 		fließen rinnen strömen 
struik 		Gebüsch Staude Strauch 
struktuur 		Bildung Struktur 
studeer 		studieren 
student 		Student 
studie 		Studium 
stuk 		Bruch Bruchstück Fragment Stück 
stukkend 		defekt 
stuur 		schicken senden einsenden 
styg 		aufgehen sich erheben steigen 
styl 		Stil 
subsidie 		Subvention 
suggestie 		Suggestion 
suide 		Süden 
suidelik 		südlich 
suidwaarts 		nach Süden südwärts 
suiker 		Zucker 
suinig 		haushälterisch ökonomisch sparsam wirtschaftlich 
suip 		saufen zechen 
suiwer 		rein 
sukses 		Erfolg Gelingen 
sultan 		Sultan 
suster 		Krankenschwester 
susterskind 		Nichte 
suurlemoen 		Zitrone 
swaai 		schlingen schwingen 
swaan 		Schwan 
swaer 		Schwager 
swak 		flau gelinde schwach 
swanger 		schwanger 
swart 		schwarz 
swarte 		Neger 
sweer 		beeidigen schwören beschwören 
swem 		schwimmen 
swerf 		wandern 
swerm 		Gewimmel 
swerwer 		Beduine 
swyn 		Schwein 
sy 		sein 
syfer 		Zahl Zahlzeichen Ziffer 
syne 		der seine das seine die seine 
sê 		erwähnen sagen 
taak 		Arbeit Aufgabe Pensum 
taal 		Sprache 
taamlik 		ein bischen ein wenig etwas ziemlich 
tafel 		Tisch 
tafeldoek 		Tischtuch 
tafelskuimer 		Parasit Schmarotzer 
tagtig 		achtzig 
tak 		Ast Zweig 
takbok 		Hirsch 
taksisboom 		Eibe Taxus 
tamatie 		Tomate 
tandarts 		Zahnarzt 
tandpyn 		Zahnschmerz Zahnschmerzen Zahnweh 
tans 		jetzt gegenwärtig nun 
tarief 		Tarif 
taxi 		Taxe Taxi 
te 		zu zu sehr zu viel 
teater 		Theater 
tee 		Tee 
teel 		tierzüchten 
teen 		um 
teenoorgesteld 		invers umgekehrt 
teenstelling 		Antithese Gegensatz Gegenstellung 
teer 		delikat fein gelinde zart 
tegelyk 		einstweilen indes inzwischen unterdessen 
tegnies 		technisch 
tegnologie 		Technologie 
teken 		Signal 
teks 		Text 
tel 		zählen aufzählen 
telefoon 		Telephon 
telegrafeer 		telegraphieren 
telegram 		Telegramm 
televisiestel 		Fernsehapparat Fernsehgerät 
telraam 		Abakus Kugelmaschine Rechenmaschine 
tempel 		Tempel 
temperatuur 		Temperatur Witterung 
tenk 		Behälter Zisterne 
tent 		Baracke Zelt 
ten behoewe van 		zu ... Gunsten 
ten opsigte van 		betreffs bezüglich 
ten spyte van 		trotz ungeachtet 
term 		Ausdruck Terminus Wort 
tert 		Torte 
terug 		zurück 
terugbesorg 		vergelten wiedergeben zurückgeben 
terwyl 		während 
tevrede 		zufrieden 
te voet 		zu Fuß 
tien 		zehn 
tier 		Leopard 
tipe 		Typus 
tipies 		typisch 
tjek 		Bankanweisung Scheck 
toe 		an in nach zu 
toegang 		Eingang 
toeganklik 		zugänglich 
toekoms 		Futur Futurum Zukunft 
toemaak 		schließen verschließen zumachen 
toepas 		anwenden verwenden 
toernooi 		Turnier 
toeskouer 		Zuschauer 
toespraak 		Ansprache 
toespreek 		ansprechen 
toestand 		Fassung Lage Situation Zustand 
toestel 		Apparat Vorrichtung 
toeter 		Hupe 
toevlugsoord 		Asyl Zufluchtsstätte 
toevoeg 		addieren beifügen zufügen 
tog 		allerdings freilich immerhin ja ja doch wohl zwar 
toilet 		Abort Abtritt 
toneel 		Bühne Scene Szene 
tongvis 		Seezunge 
toon 		angeben weisen anweisen hinweisen zeigen 
toring 		Turm Zwinger 
tot 		bis 
totdat 		bis 
tot by 		bis 
tou 		Kette Reihe Reihenfolge Tour 
towenaar 		Magiker Zauberer 
tower‐ 		Zauber‐ zauberisch 
traan 		Träne 
tradisie 		Tradition Überlieferung 
tragedie 		Tragödie Trauerspiel 
trap 		Stiege Treppe 
trawant 		Trabant 
tref 		treffen 
trein 		Zug 
trek 		ziehen verziehen 
trommel 		Trommel 
troos 		trösten Trost spenden 
trop 		Ar 
tropies 		tropisch 
trots 		hochfahrend hochmütig stolz 
trottoir 		Bürgersteig Gehweg Trottoir 
trou 		sich verehelichen sich verheiraten 
tuin 		Anlage Garten 
tuis 		heim daheim zu Hause 
tulp 		Tulpe 
tussen 		unter mitten unter zwischen 
twaalf 		zwölf 
twee 		zwei 
twintig 		zwanzig 
twyfel 		zweifeln bezweifeln 
tyd 		Zeit 
tydelik 		Interim‐ provisorisch 
tydens 		während 
tydperk 		Epoche Zeitabschnitt 
tydskrift 		Zeitschrift 
u 		dein deinig euer eurige Ihr ihrige 
ui 		Zwiebel 
uit 		aus aus ... heraus 
uitbeeld 		abbilden 
uitdeel 		austeilen verteilen zuteilen 
uitdruk 		ausdrücken 
uitdrukking 		Ausdruck Äußerung 
uiteindelik 		endlich 
uitgaan 		ausgehen ausrücken 
uitgawe 		Auflage Ausgabe Herausgabe Verlag 
uitgee 		herausgeben 
uitgestrek 		ausgedehnt geräumig weit 
uitgewer 		Verleger 
uithaal 		ausschließen aussondern 
uithou 		aushalten austragen 
uitkyktoring 		Aussichtsplatz Luftschloß 
uitleen 		borgen 
uitnooi 		einladen 
uitpak 		auspacken 
uitroei 		austilgen ausrotten tilgen vertilgen 
uitsig 		Aussicht 
uitslag 		Erfolg Ergebnis Resultat 
uitspraak 		Aussprache 
uitstalling 		Ausstellung 
uitstappie 		Ausflug Exkursion 
uitsteek 		vorstehen 
uitsuig 		aussaugen 
uitvind 		entdecken erfinden 
uitvoer 		ausführen exportieren 
uniek 		einzig 
uniform 		Uniform 
universiteit 		Hochschule Universität 
uur 		Stunde Uhr 
u s'n 		der deine der euere der Ihre 
vader 		Vater 
vak 		Abteilung Fach 
vakansieoord 		Ferienort 
val 		fallen 
valk 		Falke 
vals 		falsch 
vampier 		Vampir Vampyr 
van 		Familienname 
vanaand 		heute abend 
vanadium 		Vanad Vanadium 
vandag 		heute 
vang 		erbeuten ergreifen ertappen erwischen fangen fassen 
vanmiddag 		heute Nachmittag 
van ... af 		aus aus ... heraus 
van nature 		natürlich 
variasie 		Variation 
vark 		Schwein 
varkie 		Ferkel 
vars 		frisch neu unberührt 
vars water 		Süßwasser 
vas 		fest 
vashou 		halten aufhalten 
vasmaak 		befestigen festsetzen fixieren 
vasstel 		befestigen festsetzen fixieren 
vasteland 		Erdteil Festland Kontinent 
vat 		erbeuten ergreifen ertappen erwischen fangen fassen 
vee 		Herde Senne Trift Vieh 
veertien 		vierzehn 
veertig 		vierzig 
veg 		kämpfen 
veilig 		gefahrlos geheuer harmlos 
veiligheid 		Sicherheit 
vel 		Haut 
veld 		Acker 
veldsprinkaan 		Grashüpfer Heuschrecke 
venster 		Fenster 
ver 		ab dahin fort heraus weg hinweg 
veral 		besonders zunächst zuvörderst 
verander 		ändern tauschen umändern umtauschen wechseln umwechseln 
verantwoordelik 		verantwortlich 
verbaas 		in Verwunderung setzen verwundern 
verbaas hom 		sich wundern staunen erstaunen 
verband 		Bandage Verband 
verbeeld hom 		erdichten sich einbilden sich vorstellen 
verbind 		kombinieren 
verbleik 		erblassen verblassen 
verblyf 		Aufenthalt 
verborge 		heimlich 
verbrand 		verbrennen 
verby 		über ... hinaus vorbei vorüber 
verbygaan 		passieren vergehen vorübergehen vorüberkommen 
verbysterd 		bestürtzt 
verdedig 		behaupten beschützen verteidigen 
verdien 		erringen gewinnen 
verdieping 		Etage Geschoß Stock Stockwerk 
verduidelik 		darlegen einleuchten erklären erläutern 
verduideliking 		Aufklärung Aufschluß Erläuterung 
verdwyn 		entschwinden verschwinden 
vereis 		erheischen fordern erfordern verlangen zumuten 
vereniging 		Assoziation Verbindung Vereinigung 
vergadering 		Versammlung Zusammenkunft 
vergeef 		entschuldigen verzeihen 
vergeet 		vergessen 
vergelding 		Belohnung Lohn 
vergelyk 		vergleichen 
vergelyking 		Gleichnis Vergleich 
vergifnis 		Begnadigung Vergebung Verzeihung 
vergoeding 		Entgelt Ersatz Vergütung 
verhaal 		Geschichte Historie 
verhole 		heimlich 
verhouding 		Gleichmaß Proportion Verhältnis 
verhuis 		übersiedeln 
verjaarsdag 		Geburtstag 
verkeer 		sich aufhalten sich befinden 
verkeerd 		falsch irrig 
verkeersreëls 		Verkehrsvorschriften 
verkies 		auslesen wählen auswählen erwählen 
verklaar 		deklarieren 
verkoop 		veräußern verkaufen 
verkoopsman 		Ladengehilfe Verkäufer 
verlaat 		entäußern fortlassen überlassen unterlassen 
verlang 		wünschen 
verlede 		Vergangenheit 
verlies 		Verlust 
verlof 		Urlaub 
verloofde 		Braut 
verloor 		verlieren 
verlos 		befreien entledigen erledigen freilassen frei machen 
verlossing 		Entsatz 
vermeld 		nennen 
vermoë 		Befähigung Kapazität Vermögen 
vermy 		ausweichen entgegen entweichen meiden vermeiden 
verneder 		demütigen erniedrigen 
veronderstel 		vermuten voraussetzen 
veroorsaak 		antun bewirken veranlassen verursachen zufügen 
verorber 		aufessen aufzehren 
verpleeg 		pflegen warten 
verpleegster 		Krankenschwester 
verplig 		zwingen 
verpligting 		Gebühr 
verraad 		Treubruch Verrat 
verrassing 		Überraschung 
verruklik 		entzückend 
vers 		Strophe 
versamel 		sammeln einsammeln 
verseker 		versichern 
versekering 		Assekuranz Versicherung 
verskeidenheid 		Abwechslung Varietät 
verskeie 		verschiedene 
verskil 		abweichen differieren sich unterscheiden 
verskillend 		verschieden verschiedenartig 
verskole 		heimlich 
verskriklik 		furchtbar 
verskyn 		erscheinen 
verslaan 		bewältigen meistern bemeistern siegen besiegen überwinden 
verslag 		Bericht Meldung Rapport Referat Vortrag 
versoek 		Ansuchen Bitte Ersuchen Gesuch 
versoeking 		Versuchung 
verspreid 		uneins 
verstaan 		begreifen erfassen verstehen 
vertaal 		übersetzen übertragen 
vertaling 		Übersetzung Übertragung 
verteenwoordiger 		Vertreter Stellvertreter 
vertel 		erzählen 
vertolk 		auslegen deuten dolmetschen interpretieren verdolmetschen 
vertoning 		Darbietung Darreichung Darstellung Vorlegung Vorstellung 
vertoon 		angeben weisen anweisen hinweisen zeigen 
vertrek 		abreisen fortgehen 
vertroue 		Zuversicht 
vertrouwe stel in 		rechnen sich verlassen auf vertrauen 
vervaardig 		anfertigen fabrizieren herstellen verfertigen 
vervang 		ablösen ersetzen 
vervelig 		überdrüssig verdrießlich 
vervoer 		Transport 
verwag 		gewärtigen harren warten erwarten 
verwant 		verwandt anverwandt 
verwantskap 		Verwandtschaft 
verwantskapsbetrekking 		Verwandtschaft 
verwar 		einwickeln hineinziehen verwickeln 
verward 		bestürtzt 
verwerf 		erbeuten erlangen erringen habhaft werden sich erwerben 
verwysing 		Referenz 
vet 		feist fett fettig geil 
vetterig 		feist fett fettig geil 
vier 		vier 
vinger 		Finger 
vinnig 		geschwind hurtig rasch schnell 
viool 		Fiedel Geige Violine 
viooltjie 		Veilchen 
vir 		an in nach zu 
vis 		Fisch 
visie 		Äußerung Gesinnung Gutdünken Meinung 
vlag 		Banner Fahne Flagge 
vlam 		Flamme 
vlei 		schmeicheln 
vleis 		Fleisch 
vleuel 		Fittich Flügel 
vlieg 		fliegen huschen 
vliegtuig 		Äroplan Flugmaschine Flugzeug 
vlierboom 		Holunder 
vloei 		fließen rinnen strömen 
voedsel 		Ätzung Ernährung Futter Nahrung Nahrungsmittel 
voegwoord 		Bindewort Konjunktion 
voel 		empfinden fühlen 
voertuig 		Fuhrwerk Gefährt Wagen 
vol 		voll 
volg 		folgen 
volgende 		folgend nächst umgehend 
volgens 		gemäß nach 
volledig 		ganz total 
volstruis 		Strauß 
volume 		Volumen 
volwasse 		ausgewachsen erwachsen 
vol maak 		ausfüllen erfüllen 
vonkel 		funkeln glitzern 
voor 		jüngst vor 
voorbeeld 		Beispiel Exempel 
voorbehoud 		Reservierung Vorbehalt 
voorberei 		bereiten vorbereiten 
voordeel 		Interesse Nutzen Vorteil 
voorheen 		früher zuvor 
voorkom 		sich aufhalten sich befinden 
voorkop 		Stirn 
voorletter 		Initial 
voormalige 		vorig 
voornaam 		Vorname 
voorraad 		Versorgung Vorrat 
voorreg 		Privileg Privilegium Vergünstigung Vorzug Vorzugsrecht 
voorsit 		auftragen 
voorspelling 		Wahrsagung 
voorstad 		Vorstadt 
voort 		hervor vorwärts 
voorval 		Ereignis 
voorwoord 		Vorrede Vorwort 
voor dat 		bevor ehe 
vorentoe 		hervor vorwärts 
vorm 		Formular 
voël 		Vogel 
vra 		fragen anfragen 
vraag 		Frage 
vragmotor 		Lastauto Lastkraftwagen LKW 
vrede 		Friede 
vreedsaam 		Friedens‐ friedlich gemütlich 
vreemd 		ausländisch fremd 
vrees 		Angst Furcht 
vreeslik 		furchtbar 
vreugde 		Freude 
vriend 		Freund 
vriendelik 		freundlich 
vriendelikheid 		Freundlichkeit Wohlwollen 
vriendin 		Freundin 
vries 		frieren 
vroeg 		früh zeitig 
vroegtydig 		früh zeitig 
vroeër 		früher zuvor 
vroeëre 		vorig 
vrolik 		fröhlich heiter lustig vergnügt 
vrou 		Frau Gemahlin 
vrug 		Frucht 
vrugbaar 		fruchtbar 
vrugteloos 		nutzlos 
vryf 		frottieren reiben abreiben 
vryheer 		Baron Freiherr 
vryheid 		Freiheit 
vrymaak 		befreien entledigen erledigen freilassen frei machen 
vuil 		unlauter 
vuis 		Faust 
vul 		Fohlen Füllen 
vulkaan 		Vulkan 
vurk 		Gabel 
vuur 		Feuer 
vuurhoutjie 		Streichholz Zündholz 
vyf 		fünf 
vyftien 		fünfzehn 
vyftig 		fünfzig 
waai 		blasen wehen 
waar 		wo 
waaraan 		wozu 
waarborg 		Garantie Gewähr 
waarde 		Bedeutung Geltung Wert 
waardeer 		achten mögen schätzen wertschätzen würdigen 
waardevol 		gültig wertvoll 
waarheen 		wohin 
waarheid 		Wahrheit 
waarin 		worin 
waarmee 		womit 
waarnatoe 		wohin 
waarom 		weshalb weswegen 
waaroor 		worüber 
waarsku 		warnen 
waarskuwing 		Warnung 
waarskynlik 		wahrscheinlich wohl 
waarvan 		woraus wovon 
waarvandaan 		woher 
waarvoor 		wofür wozu 
waar ... heen 		wohin 
waatlemoen 		Wassermelone 
wag 		gewärtigen harren warten erwarten 
wagkamer 		Warteraum Wartesaal 
wag vir 		gewärtigen harren warten erwarten 
walvis 		Walfisch 
wandel 		promenieren spazieren 
wandelpad 		Fußweg Pfad Steg Steig 
wang 		Backe Wange 
want 		da denn weil 
warm 		warm 
was 		Wachs 
wat 		was 
water 		Wasser 
watter 		wer 
wedstryd 		Konkurrenz‐Prüfung Preisausschreiben Wettbewerb 
weduwee 		Witwe 
week 		erweichen verweichlichen 
weens 		anläßlich wegen 
weer 		abermalig abermals von neuem wieder 
weeskind 		Waise Waisenknabe 
weet 		wissen 
weggesteek 		heimlich 
weghardloop 		ausreißen entfliehen entlaufen fortlaufen sich verlaufen 
wegsteek 		einschließen 
wegstuur 		abschicken entsenden fortschicken wegschicken 
weier 		ablehnen abschlagen ausschlagen versagen weigern verweigern 
weiering 		Verweigerung Weigerung 
wekker 		Wecker 
welke 		wer 
welvaart 		Wohlfahrt Wohlstand 
wen 		erringen gewinnen 
wenkbrou 		Augenbraue 
werk 		arbeiten 
werker 		Arbeiter 
werklik 		authentisch echt recht urkundlich wahr wahrhaft 
werklikheid 		Realität Wirklichkeit 
werkloosheid 		Arbeitlosigkeit 
werksdag 		Werktag Wochentag 
werktuigkundige 		Mechaniker 
werkwoord 		Verb Verbum Zeitwort 
wesel 		Wiesel 
westelik 		westlich 
wet 		Gesetz 
wetenskap 		Wissenschaft 
wewenaar 		Witwer 
whisky 		Whisky 
wie 		wer 
wiel 		Rad 
wie se 		deren dessen wessen 
wil 		wollen 
wilde vark 		Eber Wildschwein 
wilgerboom 		Weide 
wind 		Wind 
winkel 		Butike Geschäft Kramladen Laden 
wins 		Ertrag Gewinn Interesse Nutzen Überschuß Verdienst Vorteil 
wiskunde 		Mathematik 
wiskundig 		mathematisch 
wissel 		austauschen auswechseln umtauschen vertauschen verwechseln 
wit 		weiß 
witmens 		Europäer 
woede 		Grimm Wut 
woekerplant 		Parasit Schmarotzer 
woestynbewoner 		Beduine 
wol 		Wolle 
wolf 		Wolf 
wolvin 		Wölfin 
wond 		Verwundung Verletzung Wunde 
wonder 		Mirakel Wunder Wundertat 
wonderbaarlik 		mirakulös 
woning 		Wohnhaus Wohnung 
woon 		hausen wohnen 
woonstel 		Appartement Etagenwohnung Gemach 
woord 		Vokabel Wort 
woordeboek 		Wörterbuch 
word 		geschehen vorkommen werden zu stande kommen 
wors 		Wurst 
wortel 		Karotte Möhre Mohrrübe 
wreedaardig 		grausam 
wreedheid 		Grausamkeit 
wurm 		Wurm 
wyf 		Weib 
wyn 		Wein 
wys 		Art Manier Weise 
wyse 		Art Manier Weise 
wyser 		Zeiger 
wysheid 		Weisheit 
wysie 		Melodie Weise 
wêreld 		Welt 
xilofoon 		Xylophon 
ys 		Eis Gefrorenes Speiseeis 
yster 		Eisen 
ystervark 		Igel 
zirkonium 		Zirkonium 
bak, boks, pot 		Behälter Besteck Krug 
'n 		ein eine 
'n paar 		ein paar einige einiger einiges etliche manche 
