Imperial Aramaic almost like Hebrew ++
https://en.wikipedia.org/wiki/Aramaic_alphabet

Aramaic
Arāmāyā
‎
L2R rendering of semitic in Sublime

Hebrew:
ארמיא
Armia

Syriac: 
ܐܪܡܝܐ‎ 
Armia

Arabic:
آرامية
Aramyo

L2R rendering of semitic in Sublime

בר 1. pure 2. puer (son)


AKKADIAN words in asSyriac:

akhu	achim : bruder
akhatu	achim.t : sister
ammtu	Amme
anutee	these

arba'u	four
hamsu (hamshu)	khamsha	hamsho	five  𓂧𓇋𓏏 ḫamiš@Akkad khamsa@Arab djw~dqujen~5 ?
sebu (shebu) 	shavva 	shau’o seven ++ I18N
shamanu 	tmanya 	tmanyo eight !
tishu 	tishaa 	tisho nine
esru	esra	asro	ten
shinesar 	teryesar 	tra’sar twelve


BAa-VILle		babylon
GIKH-KAA		Kiecher
DO-RRAA			duration++ century / a period of 100 years / 100
DAA-TEED		future date
HAA-SAA-NAAY		h.easy
ZAAH-MUT		Zank
CHAA-TOON = hard
WURR-DAA		rwda rose
BIB-LAA			vlovaa flower
WAAH-KHSHEE	savage :)
WAA-RRAA-QAA	paper?
ZOO-Z=E			Zaster money
ZRRAA-QAA D SHIM-SHAA		raise de shamash
GNE-TAA			(sun) set
SUH-RRAA		moon
ZMAARR-TAA	song
ZAA-MAA-RRAA	singer
ZAA-MAARR-TAA singer
KAR-KHA			KUR : city
KAHK-RA			coin
GAM-LA			camel / robe
MAL-AH-KAH - a messenger
AH-DAM - name, man
SEB-E-LA		Corn, Grain, or Wheat 
MAT-A				dead (mort)
METTA /MATTA	Town 
TAL-ME-DA 	student/tutor ↔ talmud
TUL-MEE-D=E Desciples.
SHLEE-KHAA	 Apostle 'Schüler'
Elijah	My God is Yah ↔↔
AB-BAH - Father
ISH-THA – fever !?!
MAR-A - Lord or Master  ↔ Meyer!
MAR-YAH - LORD God !?!
MAL-COO-TAH - God’s reign
MAL-KA - king, counsel
LOOP OO MAA-LIP learn (verb) and teach (verb).
LOO-KHAA tablet
KTAA-VAA	book ?
MAN-NA - a type of food(?) that fell from heaven, means “What is it?” – Jn. 6:31
MISH-E-KHA – Messiah (Anointed One), Christ 
HIGH-YEA - life <<
SNA 	hate?
SHEM-AY-AH – heaven : shamash/air

GEM-EER-A - all inclusive, mature	↔ GEN?
RAB-OO-LEE – Master Rabbi
SA-TAHN-A - adversary, accuser, Satan! Lucifer?
YAL-AL means to “wail” or “howl” ↔ Jammer, Jallahs:)
Simon Peter-Kepa	 rock^2 !?
"Bar D’Alaha”		Son of God
"Bar Nasha”		Son of Man
UR-HA – the way or path (Jesus’ followers)
MIL-THA		mind->word
TD=OO-RRAA	~ Dora↔ Dacha: Mountain
KUL-DAA-YAA	Chaldean
KUL-DE-TAA	Chaldean
LEE-SHAA-NAA	language(tounge)


MU-DN-KHAA East
GURR-BYAA) = North.
MU-AARR-WAA) = West.
TUY-MNAA) = South.

SOO-RRIT) = Syriac.

SAAH-DOO-TAA martyrdom ↔
SAAH-DAA		martyr
YOM D' SAAH-D=E 	martyrs day
SUH-RRAA moon.
SHIM-SHAA) = sun.
KUKH-WAA) = star.

EE-DAA GOO-RRAA) = Easter.
EE-DAA ZOO-RRAA) = Christmas
SHAAH-RRAA ~ EE-DAA
AA-ZEEZ		associate / loved one

AA-SHIQ		passion or love.

MI-LAA) = word. 
KOO-NAA MI-L=E) = lexicon. ↔ Kennen
KOO-NAA-SHAA) = collection.
POO-SHAAQ MI-L=E	lexicon
POO-SHAAQ-TAA) = explanation / interpretation / translation
LIK-SEE-QON) = lexicon. :)
KHAASH-KHAA-T=E = the ancient word for dictionary 
QURR-=TD=E-SAA diploma / degree
PAA-RRIQ	protect/save
PRAAS	: send
QAA-LAA	sound
PRAAS QAA-LAA) = radio
PRAAS KHIZ-WAA) = TV
KHIZ-WAA		'vison' 

SLEE-WAA cross  W↔P:
ZQEE-PAA crucifix / cross.
SOOP-RRAA Food placed on a spread cloth ↔ supper, soup?
eberu ebara ’boro to cross 	𒁇 𒈦 !

RRAA-ZEE	rational / reasonable
RRDAAY-TAA) = approval / satisfaction / being pleased with. <<
SHAA-PEE-RRAA	super schön
SHLAA-MAA 	Shalom Peace.
SAA-YAA-DAA hunter.
B-SYAA-DAA) = hunting (verb)  ↔ be- being- Ba.an @ Sumer
SE-DAA) = hunting	~ hunt?

KHE-LAA) = strength / power		↔ GAL!
QOO-WUT strength ↔ Wut?

TO-RRAA GOOL-PI-NAA winged bull (Taura)
TAA-WIRR-TAA) = cow.	Taur.ta ♀

TUSH-EE-TAA 	history (taa-rriq is arabic).

The Peshitta (Syriac: ܦܫܝܛܬܐ‎ pšîṭtâ) is the standard version of the Bible for churches in the Syriac tradition


ardikhalu	architect  (tect↔khalu)
yarho		mond-jahr=Month  'arkhu @ Akkad!?! <<
asu asya osio		Arzt
assuritu	assyrian female
atta att hat you:ante-tu
attunu ahtune hatu you plural
banu bnaya or bnna bone 	'bauen' to build
battibatti batvatti neighbourhood, households	↔ bethi-bethi !
braqa barqo 	flash ↔ bright?
birgu birqa lightning
bararu barra glimer, to shine
beldababi baldvavi b’eldbobo adverseries, enemies	↔ Belzabub --
bibbu bibva drainage
birinni billan between us
birku birka barko knee

bishu bisha bisho evil

biitu baita baito house	beth Bett
buru beera biro water well	BORN,brunnen
buhur buhra (h =kh) first born

daianu daiana judge	↔ DOM@Goth! <<
daianutu daianuta daiono judgeship
dinu dyana to judge 
dannu dannana strong, mighty	↔ DON
dammu demma admo blood
daqqu daqiqa tiny

dimtu dimeta tear ↔ EG!

ikkaru	akkara	akoro	farmer, gardner ↔ Acker, Agro!
eglu khagla haqlo	Acker, field
ekallu hakla hajklo palace	hai'gal ↔ heikel 		↔ Serbo-Croatian: hajklik, hajklih

elippu	elpa	elfo	ship
elle	al	aal	on, upon	'al'@ARAB ↔ R!
elu	elul	'eloyo	high
elulu	ellul		to be high
ilutu	elayoota		highness, divinity ↔ elevate
emeru	khmara	hmoro	ass, donkey	↔ *Mare!
énu	aina	aino	eyen!
enzu	ezza	ezo	goat !?

etteru	atera	atiro	wealthy, rich ?<<
*ettiru	netara	notar	to protect  ↔ Mother Nature Vulture!! <<
gammalu	goomla	gamlo	camel
gappu	gulpa		wing <<
garnu	qarna	qarno	horn	kernas! <<
garru	garra		graben : to dig out
gashtu	qishta	qeshto	bow

gushu	qisha		cold ?
hashalu	khshala		to crush		*khrsh.ala
hassinu	hassina		ax	ss↔x
hatu	khitta	htoyo	to sin ↔ hate?
hittitu	khteeta	htitho	sin, crime	↔ Hittites? Ketzer!
iddu	idda	ido			side, hand: yod!
*idu	yeda	yod'o	to know	*vidda
*illidu	yalidda	yaludo	child *chilid !

immati	eeman	ema	when

imnu	yamina	yamino	right hand  ↔ 𓊿 𓅆 𓋀 #IMNT 𓋀𓏏 Amun Ammnon @Amman(sWesten) 𓆄𓏏𓅂Veastan
inbu	anbee	enbe	grapes

insabtu	esaqta		ring	<
isku	eshka	shako	testicle	<
isu	qesa	qaiso	wood	<
ittimalu	timmal	athmel	yesterday	<
kabadu	kabda		liver /
kakkabu	kikhwa	kokbo	star <
kakkishu	kaksha		rat	/
kakku	chekka		weapon (literally tooth) ! <
kalbannatu	kalbanita		axe
kalbu	kalba	kalbo	dog	'Kläff'
kalbatu	kalibta	kalbtho	bitch 
kalmatu (feminine)	qalma (male)		louse
kalu	kla		to stand, to hold back <
kapapu	kyapa		to bend, to bow
karabu	qraba (communion)		to bless
karmu	karma	karmo	garden, vineyard, orchard
khallu	khalla		vinegar
karru	kirya	karyo		short !<< klein
karsu	kersa	karso	belly, abdomen <<
kasaru	asarra		zerren to bind, tie	
kashtu	qeshta		bow <
kaspu	kispa		'kaspian' silver, treasure *kasiba ↔ kass...!
khabu	khabbib		to love al'hoebe liebe
khammatu	khamta		female	femme.ta <
khasinu	khasina		~ax
khatu	khtama	hthomo	to end
khuturu	khutra		scepter	~ sku'tur


kima	kimad		COMME according to, as much as
kinnu	kinna	kino	just
kinnu	qinna		nest	↔ KückHühn
kinnutu	kinnuta	kinotho	justice ?? <
kudurru	khaderban		boundry <
kullu	kulleh	kole	all	 *qwhole ++ !! ↔ gal
kurru	kurra		furnace	↔ char, Herd
kussi	kursi	kursio	chair ~-
kussitu	kusitta		hat, garment hood
kutallu	qdalla	qdolo	back of the neck
la	la	lo	no	! +
labashu	lbasha	lbosho	to cloth? /
lagattu	lqatta		to pick, pluck /
libbi	libbi	lebi	my heart	lieb-I	lieb-my ++
libbu	libba	lebo	heart
lishannu	lishanna	leshono	toungue, ~langauge ++
lumu	loma		bad luck, ill faith		loom↔doom

makharu	makhara		*Macher, architect, surveyor
ma-alku	malka	malko	prince
maalkatu	malikta	malektho	queen
magaru	myaquri	myaqar	to favour, obey, respect
mashmashu	shamasha	shamosho	deacon  	Diakon
migru	myuqra	myaqro	mister
milku	milka		counsel
minna	minna or binna	menyo	what
minu	minyana	menyono	number
mishikhtu	mshukhta		measurement

mannu	maney		who		*mwhon EG ++
maanu	maaney	manyo	who		*mwhon EG ++

makhasu	mkhaya	mahyo	to hit or stirke

malu	maleh	mole	to fill

mamitu	momita		oath ↔ meme=word

manu	bnaya, mnaya	bnoyo	to count, count
manzaltu	mozalta	mazlo	orbit, position of star

markabtu	markabta	markabtho	chariot		mar'hippote ++ EG

marsu	mirya		sick	↔ Mars, Masern
marsutu	mrayta		sickness

mashtitu	shtaita	shtoyo	a drink

mutu	mota	mawto	death	*muert ++
mittu	mitta	mitho	dead	*mort ++
matu	myata	maoto	to die	*mort ++

matu	mata	motho	land, country
mattati	matwati		lands, villages

mashu	machikh		to find
mashu	manshuyee		to forget
meshu	masheh		to clean to wipe
messu	maseh		to wash cloths

mu	miyya	maye	water mwuar mar EG++

mudutu	dayta	ida'tho	knowledge <!>
murru	mora		myrah ++
muskenu	meskeena	meskeno	destitute mittellos ? /
naasharu	nishra	nishra	eagle <<<
nabu	nabee		to speak (in prophecy) to utter ↔ Nabu=Mercury
naggaru	najar	nagoro	carpenter, *Nigger:) <<

nakharu	nukhra	nekhroyo	foreign	*Next<<+
nash-nakhar	nasha-nakhraya	nosho nekhroyo	foreigner

nakhu	nakha	niho	Nicker(chen)++ to rest
namaru	nowra		mirror <

nashagu	nshaqa	nshoqo	to kiss	↔ Nase  𓌢  N35 𓈖  D19 𓂉  
napahu	npakha	nfoho	to blow /
napishtu	napsha		life, breath of life << ++
↔  𓋴  T22 𓌢  N35 𓈖  D19 𓂉   scent, saint, sank  Ω𓋩𓋹☥𓃙𓃶

naptu	nupta		naptha ++

nihtu (f)	nikhta		peaceful, at rest ↔ Nixtu ;)
nihu (m)	nikha		restful, peaceful			
*hnihptu 𓊵𓏏𓊪𓅱𓏛𓏥 


nassaru	nattar	notar	to guard
nirru	nirra		yoke /

nishi	nashi	noshe	people
nishu	nasha	nosho	person !!

nuarmu	armunta		pomegranate

narru	nahra	nahro	river		++ nar,naur™
narrati	nahre	nahre	rivers ++ nar,naur™

nunu	nuna	nuno	fish	Nauna 𒈾
nuru	nura	nuro	light, fire	: al Nar النار !  vs noir
pagru	paghra	faghro	corpse, body < ↔ grab?
pakadu	paqid		to appoint, to command ↔ pasha:boss/head
parasu	prasha	frosho	to separate, parate, part +++
paraku	prakha		to fly ^^ ?
parzillu	prizla		iron ↔ ParthIran! vs Porzellan
pashahu	pshakha		to be at rest, *PEACE!
pasharu	pasher	fosher	dissolve, melt ↔ bash
patu	patekh	fotah	to open	↔ *portür!	p↔f!
pillakku	pilgha		spindle </> Pilger?
pirru/pillu	pila	filo	elephant *Al'pharron *Al'filan El'phant <<

pu	pumma	femo	mouth
putu	patta	fotho	face !!<<

qa ↔ corn

qabaru	qbara	qboro	to bury  ↔ 𓈎𓂋𓋴𓌟𓀜 ↔ tell / temuru
qalalu	qaloola	qalilo	light-weight	~klein+leicht
qalati	qaliatee		~alkali -
qannu or qinnu	qinna	qeno	nest	↔ Henne !
qarabu	qrabtana		soldier	Karabiner? ↔ Recke
qarnu	qarna		horn khorn keras carne++
qatu	qatta		handle	↔ HaNd
qemku	qemkha		flour ?
qeribu	qarbin	qaribo	to draw near

raatu	rehta		water course, river, iteru << +-+
rakabu	rekaba		to ride ↔ Recke++
raqadu	reqada	rqodo	to dance
remu	rakhma	rahme	mercy, remorse? <

rikku	rekha	reho	smell, Riech ++		<?>
reshu	resha	resho	head, beginning, ratio™ ++
re'u	raya	re'yo	shepherd
re'utu	ra'uta		shephership
rimmu	rimma		wild bull, buffalo, RAM™

rabu	raba	rabo	great, large ↔
rubbo	rub		chief, leader, Rabbi™ ↔
rabshag	rubshaqa		cup-bearer or chief butler

rukhtu	rwikta		extensive ↔
ruku	rikhqa	rahuqo	distant, far ↔ roady << EG +-
ruaqu	raqa		escape	𓍯𓄿𓏴𓈐   vs Rache
↔ b'rücke @ road?

rupsu	rupsha, rupshta		shoulder, shovel ↔ rash:head

sabiru	shibirta		bracelet / 
sadaru	sedra		list, to order /

sagu	syaqa	sloqo	climb, to go high	↔ saxxa ↔ ♐ sagittarius 'archer' ≠ capricorn

saharu, zakhiru	sura	z'uro	small ↔ zero!
zakhiru (male) 	zkhura small	↔ obskure !
zakhirtu (female) 	zkhurata small
seheru 	sura small, to be young  *semarl small -


salmu	salma	salmo	image <<
salu	salee	slutho	to pray	↔ salut!

shamu™ 	shmaya 	shmayo heaven
samamu	shmayya	shmayo	heaven ++ ↔ Sun! ↔ crimson samt sammu :
sammu	smooqa	semoqo	red	!!<<
shamshi 	shimsha 	shemsho the sun
shamanu 	tmanya 	tmanyo eight !
shebu 	shavva seven sieben++
shedu 	shedda 	shido demon, evil spirit *shadow++
shatu 	sheeta 	shtoyo year ↔ story?

tamitu 	mamita oath
tamu 	mami to swear

sananu	sanyana		rival, hater	↔ satan!?


sarahu 	srakha *SCHREIHEN ++ to utter cries of mourning, uncontroled anger
sarapu 	srapa to burn, refined silver

shakhanu 	shkhana 	shahino to be warm	<ƒ> chemo, cham, thermo

shalamu 	shlama peace, greeting	Shalom™ + calm
shalamu 	shlama 	shlomo to be well
shalmish 	b' shlama peacefully

shalatu 	shultana 	sheltono to rule ↔ Sultan! +  𓇓𓏏 

saptu 	sipta 	saptho lip, edge		𓎙𓆓𓈇𓏤 ↔ serpent
shaluhu 	shalukee to strip off	↔ Schlachten!?


shatu 	shta to drink ?

shamatu 	shameta birth mark, brand
shanati (female) 	sheeni (male) 	shne years  𓆴 tIUte 𓆶

shapahu 	shpaha ~ spill, spread, scatter +~+
shebabbi 	shbabbi 	shbobe neighbors ?
shuptu 	shopa place, dwelling, seat+ <<  ↔ shop
shulmu 	shlama peace	shalom+	calm
shutapu 	shotappa partner, partaker
siaqu 	eeqa 	iqo narrow, tight	↔ quetsch?
sibutu 	saibuta 	sobutho old age <<
simmiltu 	simmalta ladder	/

siru 	bisra 	basro meat   ψ:BS!
sippu 	sippa edge, treshold

sissu 	suissa 	sessyo horse *chossa

sittu 	shinta 	shantho  sleep   Aa28 𓐪  D46  𓂧  D46  𓂧  W24 𓏌  D7 𓁼   ↔ quit nuitte !?
 
sulamu 	shulama completion
sumelu 	simmala 	semolo left <<

shemu 	shma 	shma’ to hear		𓋴𓅓𓄔 !!!
sumu 	shimma name ∑ Schimmer:)	llamo 𓋴𓅓𓄔
shumu 	shema 	eshmo name	↔ Al Asm الاسم jméno@CES имя renomé 'Reim' ↔ schema σχέμᾰ ↔ das Sein (Form haben)
sanu 	tanee to repeat, tell << samu 𓋴𓅓𓄔

siamu 	syamma insegnia, writing, *scri.mos
sipru 	sipra writing	↔ sprache

surru 	sharee to begin

turu 	tora 	taoro bull	Taur I18N ++ الثّور  al phthaur ++

taaru 	dyarra 	d’oro to return
tabaku 	tpakha to pour out, shed

tabu 	tava 	tobo good, pleasant vs Taboo!
tabtu 	tobta 	tubtho goodness, kindness

tahumu 	tekhuma 	thumo boundry

talmidu 	talmidda 	talmidho student, apprentice ↔ Talmud ++

tamati 	yamti seas
tamtu 	yamta 	yamo sea	↔ talassea

++
targmon 	targmanna  dragman dragoman [Wort-über]trag-Mann!   δραγομάν truchman trouchman trudgeman
targmanu 	targemana 	targmono translator talk-MAN!	  ترجمان (tarjumān), in Turkish tercüman turchemannus 
מתרגם  (metargem) translator of written, drogman
מתורגמן (meturgeman) interpreter of spoken 

taniku 	tannukee to sigh
tapahu 	tpakha to pour out

taradu 	trrada to send, expel
taru 	dyara return ?
tayartu 	dyarta to return

tegal 	tgalla to weigh ↔  << liegt auf der Zunge.  Tiegel? --
shaggalu 	tgalla to weigh	↔ shekel

tillu 	tilla hill, tell™ Delle
<?>			𓈎𓂋𓋴𓌟𓂝𓊭 
temuru 	tamuree to bury ↔ tomb + murt 🕇
tamaru 	tamer bury	↔ tomb!

tesliti 	sluti my prayer ?
teslitu 	sluta prayer ?
tibnu 	tuyna straw ?
tinuru 	tanura 	tanoro oven ↔ timber ?
u = oo and und y!
ummu 	yema mother	mAmma
ummanu 	ummana artist	human
umu 	uma day	time *tuma
umushu 	umait daily
urhu 	urkha 	urho road, way ↔ Uroad Ort
uru 	ura stall	Ort+
wabalu 	labuli to take, to carry away

zamaru 	zmara to sing		EG zimmern kletzmer ++
zammeru 	zammara singer (male) EG! Summerer
zammertu 	zammarta singer (female)

zeru 	zerra seed <<
zeru 	zarra descendant ↔ seed

zekhru 	dekhra male <<
zingnu 	digna beard	↔ dignity!?
zuprinu 	zapraana safran +
zuzu zuza 	zuze money	Zaster +



𑀅	11005	BRAHMI LETTER A
𑀆	11006	BRAHMI LETTER AA
𑀇	11007	BRAHMI LETTER I
𑀈	11008	BRAHMI LETTER II
𑀉	11009	BRAHMI LETTER U
𑀊	1100A	BRAHMI LETTER UU
𑀑	11011	BRAHMI LETTER O
𑀒	11012	BRAHMI LETTER AU
𑀋	1100B	BRAHMI LETTER VOCALIC R
𑀌	1100C	BRAHMI LETTER VOCALIC RR
𑀍	1100D	BRAHMI LETTER VOCALIC L
𑀎	1100E	BRAHMI LETTER VOCALIC LL
𑀏	1100F	BRAHMI LETTER E
𑀐	11010	BRAHMI LETTER AI
𑀓	11013	BRAHMI LETTER KA	?
𑀕	11015	BRAHMI LETTER GA	C
𑀔	11014	BRAHMI LETTER KHA	G
𑀖	11016	BRAHMI LETTER GHA
𑀘	11018	BRAHMI LETTER CA
𑀙	11019	BRAHMI LETTER CHA
𑀚	1101A	BRAHMI LETTER JA	E
𑀛	1101B	BRAHMI LETTER JHA	Y
𑀝	1101D	BRAHMI LETTER TTA
𑀢	11022	BRAHMI LETTER TA
𑀣	11023	BRAHMI LETTER THA ↔ SUN/Thor 𐤈 ṭēt Θ
𑀞	1101E	BRAHMI LETTER TTHA ↔ theta!
𑀥	11025	BRAHMI LETTER DHA	D!
𑀟	1101F	BRAHMI LETTER DDA	T?
𑀠	11020	BRAHMI LETTER DDHA	??
𑀤	11024	BRAHMI LETTER DA	TH
𑀦	11026	BRAHMI LETTER NA	¬??
𑀡	11021	BRAHMI LETTER NNA	¬¬?
𑀗	11017	BRAHMI LETTER NGA	↔ 𑀔 Gamma
𑀜	1101C	BRAHMI LETTER NYA
𑀧	11027	BRAHMI LETTER PA	P
𑀨	11028	BRAHMI LETTER PHA	b
𑀩	11029	BRAHMI LETTER BA	Po
𑀪	1102A	BRAHMI LETTER BHA	Pi π
𑀫	1102B	BRAHMI LETTER MA	!
𑀬	1102C	BRAHMI LETTER YA	Y?
𑀭	1102D	BRAHMI LETTER RA	r
𑀮	1102E	BRAHMI LETTER LA	L
𑀴	11034	BRAHMI LETTER LLA
𑀯	1102F	BRAHMI LETTER VA	Vaw
𑀰	11030	BRAHMI LETTER SHA	山
𑀱	11031	BRAHMI LETTER SSA
𑀲	11032	BRAHMI LETTER SA *PSA ↔ P 𑀧
𑀳	11033	BRAHMI LETTER HA
𑁇	11047	BRAHMI DANDA
𑁈	11048	BRAHMI DOUBLE DANDA
𑁉	11049	BRAHMI PUNCTUATION DOT
𑁊	1104A	BRAHMI PUNCTUATION DOUBLE DOT
𑁋	1104B	BRAHMI PUNCTUATION LINE
𑁌	1104C	BRAHMI PUNCTUATION CRESCENT BAR
𑁍	1104D	BRAHMI PUNCTUATION LOTUS
𑁒	11052	BRAHMI NUMBER ONE
𑁓	11053	BRAHMI NUMBER TWO
𑁔	11054	BRAHMI NUMBER THREE
𑁕	11055	BRAHMI NUMBER FOUR
𑁖	11056	BRAHMI NUMBER FIVE
𑁗	11057	BRAHMI NUMBER SIX
𑁘	11058	BRAHMI NUMBER SEVEN
𑁙	11059	BRAHMI NUMBER EIGHT
𑁚	1105A	BRAHMI NUMBER NINE
𑁛	1105B	BRAHMI NUMBER TEN
𑁜	1105C	BRAHMI NUMBER TWENTY
𑁝	1105D	BRAHMI NUMBER THIRTY
𑁞	1105E	BRAHMI NUMBER FORTY
𑁟	1105F	BRAHMI NUMBER FIFTY
𑁠	11060	BRAHMI NUMBER SIXTY
𑁡	11061	BRAHMI NUMBER SEVENTY
𑁢	11062	BRAHMI NUMBER EIGHTY
𑁣	11063	BRAHMI NUMBER NINETY
𑁤	11064	BRAHMI NUMBER ONE HUNDRED
𑁥	11065	BRAHMI NUMBER ONE THOUSAND
𑁦	11066	BRAHMI DIGIT ZERO
𑁧	11067	BRAHMI DIGIT ONE		1𑁧+
𑁨	11068	BRAHMI DIGIT TWO		2𑁨+
𑁩	11069	BRAHMI DIGIT THREE	𑁩3+	
𑁪	1106A	BRAHMI DIGIT FOUR		𑁪4? vs 𑁮8	?
𑁫	1106B	BRAHMI DIGIT FIVE		𑁫5~
𑁬	1106C	BRAHMI DIGIT SIX		6𑁬+
𑁭	1106D	BRAHMI DIGIT SEVEN	𑁭7+	
𑁮	1106E	BRAHMI DIGIT EIGHT	𑁮8	?  vs 𑁪4
𑁯	1106F	BRAHMI DIGIT NINE		𑁯9+
𑁿	1107F	BRAHMI NUMBER JOINER
