Allah (figurative speech)	bu itran
alligator	ttimsaH
almond	l'luz
almost	.‫ع‬laHal; .‫ع‬laiyn; druġ
alone	i iġf^; i ixf^
alphabet	l'hja; l'Huruf**
alphabet, Tamazight	tifinaġ
already	yad : yet ++
also	awd
although	mkarr
always	abda 	ever
always	dima	immer <> time
ambassador*	ssafir
amulet	l'Harz
and (time)	u'
and	'd
angel 	ssfa ~ saviour
angel(s)	l'malayka
angel(s)	arHbi n lbhim
animal pen	ahidur; tahidurt
animal skin	l'bHim

animals (domestic)	l'uHš; l'uHuš
animals (wild)	tawlzit
ankle	azvi; tazvit; dblij**
anklet	wayd/tayd; wyat/tyat;

another	yadnin; yadnn

ant	awtuf w->n : ant +++
ants	iwtfan; tyudfin; yudfan

anus	axna ~~ Arsch ++

appearance	l'mndr ?
appendix*	l'mşrana zzayda
apple, Adams	tatffaHat n Adam
apples	talaHalut; tfaH**

appointment	rendezvous ++
appropriate	ilaq
approximately	ġor
apricot	l'barquq; mšmaš
April	abril; šar rb‫ع‬a ++

arm	afus; iġil <<
arms	ifasn

armpit	daw tayt
arrow	la'fliš <> flieg!
art	l'fnn ~ fine phoni

bangs (hair)	tawnza
bank	l'banka ++
banyo, metal	ššfna
barbary macaque	z‫ع‬tut
barber	ahjjam; ahssan
barbers	ihadjmn
barefoot (adj.)	s lHfa
bark (tree)	ifršin; l'frši; tifršt
barley	timzin
barn	aHanu n lbHim
bars, iron	talHdidin
basil	l'Hbaq
basin, for washing	l'mġssl

blond	ašhabun  Aschbraun ++
blond	azrwal	 Asch__ 

blood	idamn	<<

blood vessel	azġur
blood vessels	izġuran

blue (adj)	ajnjari; azarqi <> lapis la'zarqi
blue sky	asmawi

board (wood)	talblanšt <> table ++

boat	talflukt ;)

body	şşaHt 'scrot' <<< EG!

boil (n)	taHbubt; taqayt
bolt (lock)	şşaqta
bolt, metal, sliding (for locking doors)	zzkrum

bomb	l'minet ++
bomb	l'qanbula**
bomb powder*	l'barud

bone	akajmuj; akjij; akzui;
bones	aqjbab; iġşş  <> osso??

boogieman	iġşan; iukzay; ixsan;
boogiewoman	xuš

book	tarir to'readr -

boots	l'štab; l'ktab

borders	butyu ~~
both	imaran; l'Hudud
bottle	ssin/ssnat
bottom	taqr‫ع‬iyt; l'qra

bottom (of)	abud ~~ ++
boundary	abud (n) ~~
boulder	izdar (n); tabut (n); ~~

bowl	aġulid
bowl (low, flat, for couscous)	tigit
bowls	taHwart; tamtliyt; tazlft

box		l'bakit; l'bakiya  bucket,box ++++
box, wooden	l'karţtun  Karton +++
box	tazlaft
box, big	tiHwarin

boy	tarrbi‫ع‬t  <> burs bi‫ع‬ ? +?
boys	şşnduq

bra	arba; arva ~++
brace (for mud form)	ifrgasn <> gießen?? <<
brace	 lqum; iširan

bracelet	sutyanat

bubbles	tibiwlin ;)

bucket	ataš; aţaz; attas; l'kob;
bucket, measuring (metal)	sstl
bucket, well	l'‫ع‬brt <> birth:brunn!
buckets	aga

bugs	attasn

building	ibxušn <> b*au
bulb	buta	l'bni ~+?
bulb, meshy, for buta	l'bni
lamp	taftilt

bull	a‫ع‬jliy; igiz; iyiz  ~ ox
bulls	izyarn

bullets	rşaş <> schieß 

bundle (n)	taymust
bureau	l'mktab

burn (n)	uġus ~ ustulo fuge -
burns, as a medical	cure (n)	 tiqad
agorryH; agrri‫ع‬
burp (n)	
l'maHţţa n lkiran
bus station
	l'kiran
buses	
la'karţ vizit business card
walayni; walini but
agzzar butcher
zbda butter
udi butter, from the cow
ibrbilu butterfly
aġu buttermilk
aşud; axna buttocks
abra button
ibratn buttons
su udar : by foot	
by means of :	as  ++
as irġnan : by necessity	as urgent ++
iġf nsn; iwadu nsn by themselves  ? one-selfn-
MAS by what : im'was? ma? ma'os
xs km/ky by yourself : as cylf-

cactus	aqanaray; tazart n
cactus	irummin
cakes	l'gatu
calandar	l'yawmiya
calf (cow)	Ta‫ع‬jliyt

ceiling* sqf 
cement	sima++
cemetary	l'qbur; tamdint	 << kbury++ EG
census	l'iHşa[n.sus]
centipede		dad nuašal <<<
ceremony, baby naming	sib‫ع‬ ??


comedian baqšiš <> Pers
common hare	tawtult

FFF
	Commune	
	community group	l'jama‫ع‬a
	company	taqbilt
	competition	šarika
	computer	l'munafasa
	conditioner (hair)	l'urdinatur
	conditions	ssišwar
	condolences	ďďuruf
	condom	t‫ع‬ziyt
	cone	kaput; mika; prisirvatif
	confrontation	l'qilb
	congratulations	amqibal
	consensus	mbruk
	constitution	tifaq
	construction	d-dustur
	contains	l'bani
	continent	diks
	conversation	l'qarra
	convince	l'munakaša
	cook (person)	qn‫ع‬
	cooked	takuzinit
	cooked (adj)	inwan
	cookie cutter	inwa
	cookies	l'kalb n lHlwa
	cooking (n)	l'biskwi; l'gatu
	cooking pot	tinwi
	cooperation	ţawa
	co-operative*	tamunt
	copper	tt‫ع‬awuniya
	cord (electricity)	nnHas
	corn	l'xiţ n ďďo
	corn stalks	asngar; dra; qillu;
	corn, ear	qrilloh
	corner	aġddu
	corpse	tiqillut
	corruption*	tiġmrt
	cost	amttin; l'jutta
	cost of transportation	l'fasad
	cotton	atig
	cough (n)	l'markub

curse, magical	taymust <> magit
curtains	l'xamya; rridu
curve	l'virage <<
curves	l'virajat
cut (n)	ubui
dance (traditional)	aHaydus; aHwaš
dandruff	l'qšra
danger (n)	l'-xatar
dark (n)	tillas <> stille,kelle <<<
darkness	tabxni
date (of month)	ttarix
dates (fruit)	tiyni; tib‫ع‬ušin
daughter	tarbat   bat@Arab!  tar<>person toch.tar ... !!
daughter, mine	illi
daughter-in-law	tislit
dawn	l'fjr

day	: AS ⵙ SoLaRa !!! dAS <> dAG

day after tomorrow	nafuska; nif uska; nik waska

December	dujanbir; šar tnaš +++

defense (soccer)	ddif‫ع‬ defen' +++

delicious	yaţfut; taţfut ~ tastefu' ++++ --

democracy ddimuqratia ++

desert	sHra +++ de'Saharat (fem.)

design, colorful	
developing nations		dduwal nnamiya ;) ++++
development	tanmia <> tun

devil	š-šitan; ljjn  Satan, al'Jin ++
devils	ljjnun  Jinnen (n plural DE ok)

devilish	  devil numia/manner (Geist) ++++

diarrhea	abrruţ ;)

dictionary	dictionaire; l-munjid mondial ++

dinner i'mnsi <> mensa ++
direction	mani (hand) ++
director	l'mudir : master <> Mutter +++

dream (n) 
dress (n)	
tawargit
dress shirt	l'qsua; aqaydur;
dresser	tawjdanit
drink (n)	l'qamija
drinking (n)	l'maryu
drinks	tmswit
driver	tissi
drop (of liquid)	l'-mašrubat; tissi
drops (of liquid)	šifur
drought	timqqit
drugs	timqqa
drugs, intravenous	l'jafaf; taġart
drum (large one) (n)	l'muxddirat
drum (n)	tsmiyawin n
dung (cow)	l'muxddirat
dung (donkey, mule, horse)	ddndum
dust	agnza; allun; tallunt;
dust devil	ijdm
dynamite	tarfa
eagle	imzran
ear	amruġd
early	tamzawit
early (dawn)	l'minat
early, to do	l'baz
something	amzuġ
earring	anzay; zik
earrings	tifawt
ears	Huru
earth	taxurst
Earth, planet	tiwinas; tixursin
earthquake	imzgan; imzġan;
East (n)	imzian
easy	akal
education	ddunit; l'‫ع‬alam
egg	zlzal
egg yolk	l'qblt; ššrq
eggplant	iuhan; tuhan
eggs	tiġri

eye	ţiţ
eye, white of	timli n ţiţ
eyebrows	timiwa; timuwa
eyeglasses	l'mdadr; l'mdrat; nďaďr
eyelashes	argaln; arjaln; aryaln;
eyes	ašbabn
fabric scraps	aln
fabric*	iHarqan
face (n)	ttub
factory	aqmu; udm
faith	l'uzin
faithfully	l'nit
faithfulness (sexual)	snit
fake	l'ixlaş
falcon	izwwr
fall (season)	l'baz
family	l'xrif
family of…	l'‫ع‬aila; taxamt; ait
famine	uxam
fan (n)	ayt
fan (of something) (n)	taglft; jju‫**ع‬
farm	l'frfara; tarrwaHt
farmer	mušjji‫ع‬
fart (n)	l'firma
fart (silent) (n)	afllaH
fart (with noise) (n)	urth
farts (silent) (n)	akuffi; urd
fast (adj)	akuzzi
fat (animal) (n)	urdan
fat (n)	fimara; fisa‫ع‬
father	tadunt
fatigue (n)	l'idam
faucet	baba; bba
faucet (public)	tabxlit
favorite (adj)	l'bzbuz; robini
fear (n)	bumba
feather	dayt‫ع‬jib
February	tawda; l'xuf**
feelings	rriš
feet	fbrayr; šhr juj
fence	l'xadr; ššu‫ع‬ur**

flatterer	asHHar
flatterers	isHHarn
flea	agurdu; awurdu
fleas	igurdan; iwurdan
flesh	tifiyi
flies	izan
flip flops (plastic, for bathroom)	mššaya
flirting	aqşr
flood (n)	anji
floor	akal; ašal
floor (cement)	ďďşş
flour	aggurn; awurn;
flour, course	awwrn; farina; imndi
flour, white	ibrin
flower	l'furs
flowers	ajddig; ajdig; aljig
flute	ijdign; iljign
fly	taš‫ع‬but; tibinzit
foal	izi
fog	asnus
folder	amdlu; ďbaba**
food	l'milf
food (lunch)	l'makla
food (meal)	imkli
foot	tirmt
foot, ball of	adar; afdahil; atar
footprints	awurz
for	a‫ع‬şr
for example	i
forbidden	matalan; tamatrt;
forcefully	l'mital**
forearm	mamnu‫ع‬
forearms	s ddr‫ع‬
forehead	iġil
foreigner	iġaln
foreigners	ayrni; ayri
forest	abrrani; arummi; imzzi
fork	imzzan; irummin
fork (for wool)	l'ġabt
form (for mud construction)	furšita

girls glacoma	goodness
glass	goodnight
glass (drinking)	goodnight (to more
glasses, eye	than 1 person)
glove	gopher (persons job)
gloves	gossip (n)
glue	gound (adj)
goal (soccer)	government
goal keeper	grain
goals	grammar*
goat	grandfather
goat (M)	grandmother
goat (male, baby)	grandparent
goats	grapes
God knows	graph
goiter	grass
gold	grasshopper
good	grasshopper (small)
good (tasty)	grave (n)

hands handspan	ifasn
harassment*	tardast
hardship	nggan
hardware store	tamara
harelip	ddrugri
harvest	afriat
harvest (grass)	anbdu
hat	l'Hšiš
hay	kaskita; tarbbat;
haze (weather)	tarbuš
he	alim
head	ďbaba
headache, migraine	ntta
headdress (metal)	aqllal; ixf; uxsas
heads	ššqiqa
health	tryamut n tislit
health clinic	iġfawn; uxssn
healthy	şşaHt
heart	sbiţar
heat	ijji; işHa
heater	awl; ul; l'qlb**
Heaven	l'Hma
hedgehog	šufaj
heel	l'jnt
heels	bu mHmd; insi
height	awrz; taylzimt; urz
hell	iwrzan
help (n)	tuvda
hemorrage	afa; jahnnama
hen	l'ma‫ع‬awnt
her	bzzaf n idamn
her (direct obj. pronoun)	tafullust
her (indirect obj. pronoun)	nttat
her (possessive pronoun)	-tt
herb, grown in fields	-as
herd	-ns
herding	tanuġa
here	aštal
here it is	tayssa

houses how (interrogative)	tadarwin; tidartwin
how much	manimš; manimšidda
human being	mšta; sHal**
human rights*	bnadm
hummingbird	Huquq linsan
hunger	Hyayyu
husks, corn	la'zz
hyena	aHlfuš
I	nk; nkin
I love you	nk
I think so	da km/k tiriġ
ice	.‫ع‬niġ; imkn**
idea	agris; asmid; iwri
if	rray; l'fikra**
if only	ig; mk; mš
immigrants	mrday
immigration	l'muhajrin
importance	l'hijra
important	g (conj) muhim
in	ihmma; muhim**
in (location)	j
in front of (location)	g
in order (counting)*	dat; l'gdam
in order (not messy)	rttb
in order to…	jm‫ع‬
in the middle (of)	afad; baš; marad
in the name of God	ammas (n)
incense	bismillah
independent	.‫ع‬ud loqmari; l'jawi;
industry	nndd
infection	l'istiqlal
information	şşni‫ع‬t
injection	abďay; a‫ع‬ţţib
injury	inarmaysn;
innocent*	l'ma‫ع‬lumat**
insect	jjlba; tismi
insects	.‫ع‬rrm
inside (of)	bari
inspector	abxu; abxxuš

job jocularity	l'xdmt
joint (i.e. knee)	rršqt
joke	l'msfl
joker	nnukta
joker (in cards)	baqšiš
joking around	jjokir
jokingly (adv)	l'hďrt
journal (personal)	s ‫ع‬nwa
journalist	l'yawmiyyat
jug	saHafi
juice	aqlil; l'xibit
July	l'‫ع‬aşir
June	yulyuz; šhr sb‫ع‬
juniper	yunyu; šhr sţa
just	tawalt
just now	ġas; ġir
kettle	dġik; mHra
key	l'ġllay; l'mqraš
keys	tasarut
kid (small goat)	tisura
kidney	iġjd; iġšt; tiġšt
killing	mnġiwt
kilogram	tanuġi
kindling	kilo
king	l'qšš
kingdom*	aglid; ayllid; l'malik
kitchen	l'mamlaka
knife	izġi
knot	tajnwit; l'mus**
ladder	tamurkist
ladle	sslum; taskkalya
lake	aġnja
lamp	l'buHayra
languages	tajjajt
lantern	l'luġat
last	tajjajt
latch	amgaru/tamgarut
later	şşaqta
law	mnb‫ع‬d; asani
lawyer	l'qanun
leaf	l'muHami

locust logs	map
lollipops	March
loneliness	mare
longing (for) (n)	marketing*
loom	marriage
loss (n) (vs. profit)	marrow, bone
lotion	mask of pregnancy
lotto-like game	masturbation
love (n)	mat
luck	matches
lunch	material
lung illness (caused from work in mines)	mathamatics

piece metal, flat, to put on	aqzdir
roof	l'kuntur
meter (in taxi)	iġrdayn
mice	l'mijhar
microscope*	a‫ع‬skri; l'‫ع‬skr
military	amxzni
military guys	l'Hlib
milk (n)	asif n igna
Milky Way	azarig; azrg; tisiad;
mill	azrgn n waman
mill, water	brikat
millions (money)	taşşum‫ع‬t
minaret	l'‫ع‬ql
mind (n)	l'ġar; l'mnjm**
mine (minerals)	win-u; tin-u
mine (possessive)	l'm‫ع‬dn
mineral	l'm‫ع‬adn
minerals	l'uzir

nature	nobody
naughtiness	noise (n)
naughty person	nomads
nausea	noodles
near (location)	nor
necessary	normal
neck (n)	north
necklace	North America
necklace (shell)	nose
nectarine	nose, runny
needle	noses
needles, knitting	nostalgia (for)

opening in front of shirt (women)	awsi
opinion	ray
opinions	id rray; la'rriyat
opportunity	l'furşa
opposite	ďď'd; l'‫ع‬ks
optomistic*	mutafail
or	nġd
or (question)	mad; mid
orange (color)	alimuni
orange (fruit)	l'limun
orchard (usually w/in a wall)	urti
oregano	azuknni; iziknnu;
organization	zza‫ع‬tar**
others	munďďama
otter	wiyď; tiyď
our	igdi n waman; ijdi n
ours	waman
outfit (clothes)	-nġ
outside (of)	win-nġ; tin-nġ
oven	ssunbl
over	brra (n)
over here	afrran
over there	nig
package	iwrd
page	azyin; iwrin
pages	kulia; l'bkit
pain (n)	sfHa
paint (n)	sfHat
paint brush	angaz; azbar
pair	l'bantura; şbaġt; şbaqt
pair (cards)	şşita n şbaġt; ššiţa n
palm (of hand)	şbaġt
palm tree	tayuga
pan (1 handle)	rrunda
pan (2 handles)	tidiklt
pancake	tafruxt; tiyni; tifrxin
pancake-like bread	l'kasruna
panther*	l'gamila

people people (of 1 nation)	mddn
people, high birth	š‫ع‬b
people, low birth	šrfa
people, poor	i‫ع‬amin
peoples (of nation)	drawš
pepper (spice)	ššu‫ع‬ub
pepper (vegetable)	l'bzar
pepper, bell	tiflflt
pepper, hot	tflflt iHran
peppermint	tifulfil tamharuţ
perfume	fliu
perhaps	l'bxur; rriHa
person	.‫ع‬niġ
person missing teeth	bnadm
person who cannot	agrmaš
talk	aznzul

plus (math)	zaid
pocket	jjib; jjnb
poem*	šši‫ع‬r
poems	timnaţin
poet	amdiaz; šša‫ع‬ir**
poison	ssm
poisoning	ištša
police	l'bulis
police car	l'fargunit
police inspector	l'inspiktur
police station	l'kumisariya
pollution	alwwt; ttalwwut
pomade	l'pumad
pomegranate	rrmman
ponge	l'ponj; l'Haf
pool	la'pisin
pool (in river)	amda
poop (human)	ixan
poop (sheep)	iwrrayn
poor	l'mskin
poor people	l'masakin
poor thing	igllin/tigllint;
poor things	mskin/mskina
popcorn*	msakn
pope, the	l'glya
poplar	l'baba
population	ssfsaf
porridge	šš‫ع‬b
portion (n)	tagula; tarwayt
possible	tiqimit
post man	imkn
post office	l'faktur
pot	l'buşţa
pot, coffee	kasruna
potato	l'briq
potato bug	bţaţa
prayer	l'‫ع‬ffar
prayer beads	tazallit
prayer rug	tsbiHat
president	şşllaya; tazarbit n
press (n)	tzallit

quality quarter	kaliti
queen	rab‫ع‬a; rb‫ع‬
question	tayllidt
quickly	asqsa; sual**
quill (in plant)	fimrra
quills	asnan; axlal
quince	isnan; ixlaln
rabbit	šfarjil; sfrjil
racism	alqnin; awunin;
racks, brochette	l'qninat; tawtult; tqnint
radio	l'‫ع‬nsuria
rain	radio
rainbow	anzar
raisins	tagut
rake (n)	tislit n iyjnna; tislit n
ram	unzar
ranger, forest	zbib
rarely	raţu
raven	anuguţ
ravine	buġaba
razor	mrra mrra
ready	ahaqar
reason	taġya
reasonable	razwar; zizwar
receipt	mujud
recipe	max; max alig
rectangle	l'm‫ع‬qul
red	l'faktura; rrusi
red fox	l'maqadir
reduce	l'mustaţil
refrigerator	azgwaġ
region	.‫ع‬lbun
registration, for work	naqs
regret (n)	frigu; tlaja
regulator (between gas tank and hose)	l'mnţaqa
reign	la'mbuš
relationship	tgrazi
relative	l'magana
relatives	l'mulk

rotten (n) round	axmmuj
rug, wool	amduwr
running	ahadun; iHnbl
rust	tazla
sack	şda; taniyt
sacrificial animal	l'xnšt
saddle	tafaska
saddle blanket	tariyt
saddle, camels	taġrart
saddle, mules	tariyt n ulġum
safety pin	tabarda n usardun
saffron	aġnas; l'filil
salad	zz‫ع‬fran
salary	šlata
salt	šhriya
sand (n)	tisnt
sand dunes	iyidu; rmla
sandals	tiwririn n rmla
sandals, woven	idukan; idušan
sandman visit (stuff in eye in morning)	arqsn
sandwich	tarta
sanitation	kaskrot
satellite*	aţunsu; nadafa
Saturday	l'qamar lisţina‫ع‬i
sauce	sbit
saucepan	duaz; imarġan
saw	l'gamila
sawdust	l'mnšar
scab	alabba n lmnšar
scale	a‫ع‬ttib
scale, pull	l'mizan; l'‫ع‬bar
scar	tušt
scarf	azmud; azmul; uqlib
scarf clip	arkuš; l'furar; tasbniyt;
scarves	zzif
schedule (program)	tasġunst
school	la'zyaf
school vacation	l'brnamj
school, koranic	l'ikul; mdrassa
science	l'‫ع‬uţla

sheet sheet metal	l'izar
shelf	aqazdir
shelves	rrf
shephard	isyaln; rrfuf
shepherds	amksa
shin	imksawn
ship	babur
shirt, dress	baţu
shoes	l'qamija
shop	idukan; şşbbaţ;
shop keeper	tikurbyin
shopping*	taHanut
short	butaHanut/m_mtHanut
shot (of medicine)	l'mqďiyt
shots (of medicine)	igzul
should	agzay; awzay; ; tismi
shoulder	tismawin
shoulders	xssa
shovel	iġir
shroud, funeral	iġariwn; tiġurdin
shrub	l'bala; l'bara
siblings	l'kfn
sickle	ifssi
sickness	imjr n uzaġar
side	iġ n šra
side, other (of river, road)	tamaďunt; l'mrď**
sieve	tasga
sifter	agummat
sigh	bu syyar; tallunt; ;
silk	tšţţuţ
silver	bu syyar
similar (to)	tixt
similar to	l'Hrir
sin	nqurd; nqurt
since	zun (d)
sincerely	am
singer	ddnb
singer*	l'ig; sg

snow	adfl; atfl
so (therefore)	uxla
so that (purpose)	mrad
soap	şşabun
soccer	l'kura; takurt
sock	tarġiwin
socket, electrical	priz
socks	tqašr
soda	l'munada
sofa	l'panj
solar panel	taqa šmsia
soldier	amxzni; a‫ع‬skri
solution	l'Hl
some	kan
someone	kan yan
someone (unspecified)	flan
something	ša n lHajt
something good	l'mşlaHa
something is wrong	yaġi kra
something that hurts (on body)	abray; avray
sometimes	kantikal; mrra mrra
somewhere	kan udġar
son (my)	arba inu; mimmi; yiwi
song	izli; l'msaq; taHidust;
songs	l'uġniya
son-in-law	izlan
soot	adgwal
sore throat	akffus; ašffus
sorry	tizlmaz
souk tent	samHi
soul	agitun
sound	rruH
sound (in general)	awal
sound (related to vehicles)	l'Hss
soup	l'Haz
sour (n)	askif; taHrirt
south	tasmmi
South America	l'janub
souvenir	amerika janubia

steel wool stench (n)	jiks
steps, on stairs	rriHt
stick	ddrjat
stick (esp. for beating)	taġruyt
stick (for beating)	taġruyt
stick, for coals	am‫ع‬rad
stick, wooden	ašnqs n wafa
sticky (adj)	taġrušt; taġruyt
stock market	sslġ (conj in present)
stomach	l'burşa
stomach (organ)	abuď; adis
stomach, roll of	axdil; l'm‫ع‬da
animal organs	tikurdasin
stomach, swollen	ibzg udis
stone	azru
stone mill	azrg
stones (in river, used as path)	işnţiw
store	taHanut
stories	l'qişşat
stork	.‫ع‬liuswu
storm*	l'‫ع‬sifa; tignut
story	l'qişt
stove	l'furnu
stove, traditional,	tanurt
made from mud	nišan; tanumi
straight	tastit; şffaya**
strainer	azrz
strap (for purse, knife)	alim
straw	l'friz; ttut**
strawberry	abrid; šanti
street	ifilu
string	asţa
string (for loom)	ifilan
strings	l'xţţ
stripe*	izriran
stripes	l'xţuţ
stripes*	ţalib(a)
student	tiġri
studies (n)	l'muďu‫ع‬

teaching (n)	tt‫ع‬lim
teapot	l'brrad
tears	imttawn
technical assistance	tta‫ع‬awun ttiqni
teeth	tuġmas; tuxmas;
television	tuxsin; uxsan
temperature	tlfaza
temples (side of head)	l'Harara
ten minutes	ifşlan; nwadr
tennis shoes	qşmayn
tent	sbrdilat
terrorism	agitun; taxamt; axam
terrorist	irhab
testimony	irhabi
than (comparative)	ššahada
thank God	zi ġif
thank you	l'Hamdullah
that	saHa
that (demonstrative)	allig; -in; -nna; alliy
that (indirect speech)	-naġ; -in
that (relative)	nwis
that (relative, not recent)	na
that (relative, recent)	l'iġ
that (thing)	daġ
that's all	ayin; aynnaġ
thats the way!	aynaġ
thats why…	imšinaġ
the same as	aynaġ as
theater	anšt*
theft	l'msraH
theif	tukrďa
their (F)	imikr
their (M)	-nsnt
theirs (F)	-nsn
theirs (M)	win-nsnt/tin-nsnt
them (F)	win-nsn/tin-nsn
them (F) (direct obj.	nitnti
pronoun)	nitni
them (F) (indirect obj.	-asnt

tibea	aġanim n udar
ticket	tawriqt
tickle (n)	tiglgat; tiklkad
tiger	aġilas
tilling (n)	l'qliv
time	l'Hal
time (hour)	l'uqt; tassa‫ع‬t
time (instance)	ddur; tiklt
time when	l'ig
times (instances)	la'dwar; tikal
times (multiplied by) (math)	fi; madruba

to be brave	.‫ع‬zzu; z‫ع‬m
to be bright	ssidd
to be broken	rz
to be burned	ġus; kumt
to be burnt	kmď
to be busy	ur sala (conj)
to be calm	hddn
to be careful	Hďu (ixf*); rar lbal
to be cheap	rxs
to be clean	nqu
to be clear (water)	zdig
to be clear*	bayn
to be close	nmili; qrrb
to be cloudy (water)	rkiz
to be cold	krm; qrf
to be comfortable (emotionally)	z‫ع‬m ġif

to be immature	fsis; imzi* l‫ع‬ql
to be in a hurry	Harš; zrb
to be in charge	qabl
to be in peace	hnna
to be intelligent	šwu
to be interested	ihmma
to be interesting	hmma
to be involved	umu
to be itchy	tš (conj. as reflexive v)
to be jocular	ršq
to be large	us‫ع‬
to be late	.‫ع‬ţţr
to be leaning	myyl
to be left over	šayď
to be light (not heavy)	fsis
to be lonely	qnţ
to be long	ġzif; xitr
to be long (time, distance)	wahli
to be loose	narzm
to be lost	ašk; tl'f; zl
to be lost in thought	xmm
to be loud	suqr
to be lucky	ġur (conj) zzhr
to be mad	qllq; z‫ع‬f**
to be married	awl; tahl
to be melted (adj)	fsi
to be messy	xwwď
to be mixed	xllţ
to be muddy	rkiz
to be narrow	qmr
to be naughty	qjar
to be nauseous	aġ (conj) tmlilay
to be near	nmili; qrrb
to be next to	wala
to be nice	Hlu
to be obvious*	bayn
to be old	xitr
to be older than	agur
to be outgoing	z‫ع‬m
to be overripe	bbrţuţţy; l'bibţ
to be pale	wriġ; zrf
to be part of	umu

to be strong to be surprised	şHu
to be swollen	r‫ع‬b
to be tall	bzi
to be tangled	ġzif
to be tense (muscles)	mmarks
to be thick	qqrş
to be thin (objects)	zur
to be thin (people)	sdid
to be thirsty	ď‫ع‬f
to be tight	dig* fad; inġa* fad
to be tired	nyumu
to be ugly	rmi; uHl
to be unable	xxu
to be unhappy	rmi
to be upset	qnď
to be used to	qllq
to be useful	nf‫ع‬
to be vacant (adj)	slaH
to be vast	ar
to be warm	us‫ع‬
to be weak	ruġ
to be wet	d‫ع‬f
to be white	mmġ
to be wide	mlil
to be worried	us‫ع‬
to be worth	qllq
to be/make	su
conditional upon	šrţ
to bear	tHmml
to beat	dz; kkum; ut
to beat (win)	rnu
to beat up	nnaġ
to become	myassan
acquainted	walf
to become used to	myassan
to befriend	ttr
to beg	bdu
to begin	gr‫ع‬
to belch	amn
to believe	knu
to bend (oneself)	sknu

to catch up to to cause	ssikl
to cause something	sbb'b
not to work	sxsr
to cauterize	qqd
to celebrate	g lfrH; Htafl
to change	bddl
to change (clothes)	xllf
to change (money)	şrrf
to charge	šarji
to cheat	ġušu
to chew	fz;
to choke	Hnq
to choose	sti; xtar
to churn (milk)	sndu
to clean	ssird
to clean (with soap, water, squeegee)	siaq
to climb	ali
to climb down	ggz
to close	qqn
to collapse (people)	sxf
to collect	jjm‫ع‬
to collect water	agm
to collect wood	zdm
to collide	mlqay
to color	l'wwn
to comb (hair)	krď
to comb (wool)	mšt
to come back	uġuld
to come in	kšm
to command	amr
to compete	nafs; mjahad
to complain	smumi; štka; štša
to complete	kmml
to confuse	xrbq
to consume	sthlk
to convert	kujm
to convince	qn‫ع‬
to convulse	rjij; ryij
to cook	snu; ssmr
to copy	nql
to cough	skuHu; usu

to disappear (behind something)	ġġli

to fear to feed	ggd
to feed animals	stš
to feel	.‫ع‬lf
to fence in	Hssa
to fight	suty
to fight (verbally)	nnaġ
to fill	.‫ع‬ayr
to filter	.‫ع‬mmr; tkur
to finance	şffa
to find	mwwl
to finish	af
to fish	fuku; kmml
to fit	amz islman; şyyď
to fix	ga; yusa(d)
to flatter	.‫ع‬dl; hiya
to flee	sHHr
to flip	rul
to flip over	nnqlb
to flirt	snqlb
to fly	qşşr
to fold	ayll
to follow	smun; snţfs; uďu
to follow bad	ţfur; tb‫**ع‬
instructions (leads to bad results)	g ixf^ dig*

to hang to hang to dry	agl
to happen	fsr
to harvest (grains)	aġ; jru
to harvest (grass)	mgr
to hate	Hšš
to have	krh; mqt
to have an	ġur*
expectation but be let	narz
down	fďr
to have breakfast	inji udis/uxdil
to have diarrhea	mmnsu
to have dinner	burš
to have goosebumps	dduxmu
to have indigestion	munzr
to have nosebleed	Hnna
to have pity	ddrġl
to have poor vision	nkH
to have sex	gn d; jam‫ع‬
to have sex (euphemism)	myuqu
to have sex (homosexual)	qqu
to have sex (slang)	ftH
to have surgery	sfld; sll;
to hear	srġ; sHmu
to heat	.‫ع‬awn
to help	uďu
to hem	ks
to herd	ffr
to hide	wt swawal
to hint at	sxdm
to hire	ut
to hit	ġrf; nnţ
to hit against	amz; asiy
to hold	ţţf s
to hold on	tmnna
to hope	ks taġufi
to hug	şyyd
to hunt	Harš; Hurru
to hurry	brš
to hurt	bri

to leave behind to lend	zdu

to make something happen, by force	g ddr‫ع‬
to make something	siksil
the same	sbdd
to make stop	.‫ع‬mmr atay
to make tea	swHl
to make tired	sfhm
to make understood	ssrġ
to make warm	.‫ع‬llm
to mark	awl; tahl
to marry	dllk
to massage	ut (conj) tizzt; kfft**
to masturbate	ut (conj) tummizt
to masturbate (men)	.‫ع‬br
to measure	şalH
to mediate	jm‫ ع‬d
to meet	mjma‫ ع‬d
to meet (by coincidence)	mjma‫ع‬
to meet (with people)	fsi
to melt	Hfď
to memorize	ggal g
to menace	krfs
to mess up	zzg; zziy
to milk	zri (reflexive)
to miss (a bus)	tnġa* taġufi n
to miss (someone/something)	ssur; xllţ
to mix	smumi
to moan	ġml
to mold	Hďu
to monitor	matti
to move	mštg
to move (in place)	rHl
to move (residence)	dirz
to move away from	smatti
to move something	xlf
to multiply (be fruitful) (agriculture)	ut …g…
to multiply* (numbers)	nġ
to murder	g ism
to name	Htadja; xssa

to pound	ddz
to pour	ffi; xwu
to practice	l'md
to praise	škr
to pray	zzal
to pray for something	d‫ع‬u
to precede	zwur
to prefer	fďďl
to prepare	sujd
to press	zyr
to prevent	mn‫ع‬
to prevent someone	sHrm
from doing something	rbH; snf‫ع‬
to profit	zayd s dat
to progress	mn‫ ;ع‬sHrm
to prohibit	qawl
to promise	Hďu
to protect	jbd
to pull	ut (conj) s lbuniya
to punch	.‫ع‬aqb; wt
to punish	df‫ ;ع‬dHi
to push	srs
to put down	gr s
to put in	kllf
to put in charge	l's
to put on	Hzzm
to put on a belt	sxsi
to put out	zdiy
to put together (from parts)	nnaġ
to quarel	fst
to quiet	iwt unzar
to rain	sbd
to raise	sxitr
to raise (children, livestock)	asi afus
to raise (hand)	ġtaşb
to rape	awď; l'km
to reach	ġr
to read	amz
to receive	.‫ع‬rď
to recite	akz
to recognise	sjjl

to rust	sdda
to save	Hďu
to say	ini
to scare	siwd
to scatter	zll‫ع‬
to score	sjjl
to scratch	kmz; xbš; xmz
to scream	sġuy
to scrub	mri
to see	annay; ra‫ع‬a; sksw; zr
to see one another	myinniy
to seek	inig; ttr
to seem	dhar (relexive)
to sell	znz
to send	azn
to sentence (court)	Hkam
to separate	bďu; frrq; sti
to serve	srba
to set a bone (close)	qqn
to settle	zdġ
to sew	gnu; jnu
to shake	ryij; sus
to shake hands	msllam
with/greet each other	ssur; ššur
to share	ššwu
to sharpen	ġrn; Hssn
to shave	snj"m
to shell grains	ks
to shepherd	xllf
to shift (car gears)	sfliliy
to shine (sun)	rgigi
to shiver	ut
to shoot	tqaďa
to shop	smziy
to shorten	sġuy
to shout	sn‫ع‬t
to show	dwš
to shower	mziy
to shrink	xsi
to shrink (something swollen)	qqn
to shut	fst

to spread to spread out	fsr
to sprout	ġrď
to squat	mġi
to squeeze	qqim xf tiġiġiyin; ut
to stain	.‫ع‬şr; ziyr; zm
to stamp	slġ
to stand	ţb‫ع‬
to stand (i.e. I can't stand you)	bdd; nkr
to start	Hml (always negative)
to start awake	bdu
to startle	fafa
to starve	sduy
to stay	mt s laz
to stay up late	qqim
to steal	muyd
to step on	akr
to step over	akl xf
to stick	sġl
to still be	sslġ
to sting	sul
to stink	qqs
to stir	jj"u; xmj
to stop	Hrrk; smštg
to stop doing	bdd; Hasr; Hbs
something	rsa
to stop someone from	mn‫ع‬
doing something	xzn
to store	smun
to straighten up	Hnq; zlg
to strangle	mġrď
to stretch	kssl
to stretch someone (in a hammam)	.‫ع‬rra
to strip	ġr
to study	njH
to succeed	ssum
to suck	ţd
to suck (babies on mother's breast)	krfş
to suffer	rġ tafuyt

to throw out (liquid) to throw something	nġl
into a hard surface	ġrf

to worship to wound	.‫ع‬bd
to wrap	jrH
to write	duar
to write (a note)	ara; ktb; uru
to write (official documents)	m'rka
to write down (legal)	zm'm
to yawn	qiyd
to yell	fa
toad	sġuy
tobacco	alfsa
today	tabaġġa
toe	assa; assad; assddġ;
toenail	asttx
toenails	tifdnt
toes	iskr
toilet paper	askarn
tomato	tifdnin
tomb	papiyi jinik
tomorrow	matiša
tongue	aguram
tooth	aska
toothbrush	ils
toothpaste	uxs
toothpick	šita n tuġmas; šita n
Torah	tuxsin
tourist	dontifriz; dwa n imi;
towel	dwa n tuġmas
traditional birth	akšut n tuġmas;
attendant*	l'mswak
traditions	torat
trail	turist
train	l'fuţa
train station	l'qabla
training	l'‫ع‬wayd
translation	tamadla
transportation	l'lmašina; ttran
transportation money	la'gar n ttran
trap	l'furmasyun

uncle (on fathers side)	.‫ع‬mmi
uncle (on mothers side)	xali
under	ddaw
underwear	l'grşun; slip
universe	ddunit
university	l'jami‫ع‬a
unless	mgur; xs mš
unmet expectation (n)	anaruz
until	allig; ar; arij
up	afla
upon	ġif
urine	abzid; ibzdan
us	nkni
us (direct obj. pronoun)	-aġ
usually	ġaliban
utensils, kitchen	irukutn
uterus	l'walda
vaccination	awzay
vagina	abšiš; abšši; aHtšun;
vagina (figurative)	tabšit
vegetables	bu mnqar
vehicles	l'xuďrt
veil, bridal	l'Hadid
veins	a‫ع‬bruq
verb	izuġran
verdict	l'fi‫ع‬l
vermicelli	l'Hukm
vertigo	š‫ع‬ria
very	dux
vice president	bzzaf; gudin; kigan
view	nayb n rryss
village	l'mnďr
vine	aduar; iġrm
vinegar	ddilit
virgin	l'xll
voice	tamwudt
vomit	awal
voyage	iriran; ishukurn
vulture	safar
vulva	tamdda

welcome back	.‫ع‬lslama
welder	aHddad; amzil; sudur
well, water	anu; una
well, water (small)	tanut
west	l'ġrb
what	mayd
what (in affirmative sentences)	ayna

worthless wound	ur su (conj in past)
wrestling (n)	walu
wrist	l'jrH
writing (n)	tiġilt
wrong (not true)	tmšt n ufus
yard	tirra
year	.‫ع‬anwa
years	jjrda
yeast	asggas
yell (to someone)	isggasn
yellow	taxmirt
yes	sġwi
yes? (not as an answer)	awraġ
yesterday	iyyah
yield the way	n‫ع‬am?
yogurt	asant; asnat; itlli
yolks (for animals when plowing)	atm; bala
you (F)	ďanon
you (F) (direct obj.	tiltatin
you (F) (indirect obj.	-km
you (F, pl) (direct obj.	-knt

Tamazight-English	to infect
.‫ع‬ada	normal
.‫ع‬adi	wrong (not true)
.‫ع‬anwa	to punish
.‫ع‬aqb	to repeat
.‫ع‬awd	to aid; to help
.‫ع‬awn	to expect
.‫ع‬awwl	to be ready for
.‫ع‬awwl ġif	something
.‫ع‬ayd	to return
.‫ع‬ayr	to fight (verbally)
.‫ع‬bd	to worship
.‫ع‬br	to measure; to weigh
.‫ع‬ddan	many
.‫ع‬ddb	to torture
.‫ع‬dl	to fix
.‫ع‬id lmilad	birthday
.‫ع‬in	to go
.‫ع‬iš	to be alive
.‫ع‬jb	to like; to be pleasing
.‫ع‬jb* i (reflexive)	to
.‫ع‬jn	to please someone
.‫ع‬laHal	to knead
.‫ع‬laiyn	almost
.‫ع‬lbun	almost
.‫ع‬lf	red fox
.‫ع‬liuswu	to feed animals
.‫ع‬llm	stork
.‫ع‬lm	to learn; to mark; to
.‫ع‬lslama	teach
.‫ع‬mmi	to inform; to warn
.‫ع‬mmr	welcome back
.‫ع‬mmr adġar	uncle (on fathers
.‫ع‬mmr atay	side)
.‫ع‬mr	to fill; to be crowded
.‫ع‬ndak/‫ع‬ndaki	to occupy
.‫ع‬niġ	to make tea

abra	button
abray	something that hurts
abrdil	figs, black
abrdud	tail
abrid	road; path; street
abril	April
abrrad	goat (M)
abrrani	foreigner
abrruţ	diarrhea
abši	vulva
abšiš	vagina
abšši	vagina
abttan	skin
abud	bottom
abuď	stomach
abukad	person, blind
abxu	insect
abxuš	black (adj.)
abxxuš	beetle; insect
abzid	urine
abzzug	swelling
ad i‫ع‬fu rbbi	get well
ad uri tggrt	don't touch me
aďaď	finger
adar	foot
aday	when (relative)
adbib	doctor
addil	tail
addud	come here!
adfl	snow
adġar	place
adġs	coelostrum, cow
adgwal	son-in-law
adif	bone marrow
aďil	grapes
adis	stomach
adj	to allow; to leave; to
adjar	l'et
adjarn	neighbor
admr	neighbors
adr	chest
adr i	to bury

agg aggj	to look out (window)
aggu	thunder
aggurn	smoke (n)
aġilas	flour
agitun	tiger; cheetah
agl	tent
aġlan	to hang
aġlay n tafuyt	ditch, irrigation,
aglid	division
aglim	sunset
aglu	flat portable surface
aġlzim	used for flattening
agm	bread

aHtšun aHuli	vagina
aHwaš	sheep
aHyut	dance (traditional)
ait uxam	crazy
ajar	family
ajardini	reward
ajbir	gardener
ajddig	purse
ajdid	flower
ajdig	bird
ajdir	flower
ajjrgun	cliff
ajjrug	molars
ajmmu‫ع‬	molar
ajnjari	meeting
ajrray	blue (adj)
ajrtil	mayor
-ak	carpet
akajmuj	you (M) (indirect obj.
akal	pronoun)
akffus	bone
akjij	dirt; earth; floor;
akl xf	ground
aklzim	soot
aknaray	bone
akr	to step on
akšmir	axe
akšud	prickly pear
aksum	to rob; to steal
aksum n tuġmas	cliff
akšut	wood
akšut n tuġmas	meat
akuffi	gums
akuki	wood
akušam	toothpick
akutf	fart (silent) (n)
akuzzi	hair (messy, on an
akz	adult)
akzui	disabled (adj)
al	nest

amazdar	person, degraded
amaziġ	berber man
amd abariq	to slap
amda	pool (in river)
amdadi	purple
amdakl	friend
amdiaz	poet; singer
amdlu	fog
amduwr	round
amduz	manure heap
amerika janubia	South America
amerika šamalia	North America
amġar	old person; chief
amgard	neck
amgaru	la'st
amgrd	neck
amgrt	throat
amgur	scythe
amidadi	purple
amin lmal	treasurer
amirad	pigeon
amjjuţ	bald
amjut	tinea (loss of hair due
amksa	to dirtiness)
ammas (n)	shephard
amn	in the middle (of)
amnasf	to believe; to trust
amqibal	half
amr	confrontation
amruġd	to command
ams	dust
amšat	to smear
amskan	comb (n)
amsmar	small
amštj	nail
amţay	movement
amţliy	taste (n)
amttin	plate
amud	corpse
amur	seeds
amuţin	share (n)
amwur	person, sick

anuguţ anurz	ar
anxar	ar asra
anzar	ara
anzay	arad
anzlum	arag
aqadus	araġ
aqahwi	arba
aqanaray	arba inu
aqaroi	argaln
aqaydur	argaz
aqayn	argaz n utma
aqazdir	arHabi
aqjbab	arHbi n lbhim
aqlil	arHbya
aqllal	ariaz

asgun ašhabun	typhoid fever
asHHar	blond
asi	flatterer
asi afus	to carry; to lift; to pick
ašiban	up
ašibi	to raise (hand)
asid	person with gray hair
asidd	sky blue; turquoise
asif n igna	electricity
asignu	l'ight (n)
asir	Milky Way
ašišaw	cloud
asiy	rosemary
ašk	chick
aska	to hold
aškam	to disappear; to be
askar	l'ost
aškar	tomorrow
askarn	troublemaker
askayri	fingernail
askif	purse
asklu	fingernails; toenails
ašku	alcoholic (person)
askyun	soup
aşlaH	tree
aslid	because
aslid asnat	horns (animal)
aslid idgam	trash
asmawi	day before yesterday
ašmaz	day before yesterday
asmdl	night before last
asmid	blue sky
asmun	itch (n)
-asn	grave (n)
asnan	cold (n); ice
asnat	friend
asngar	them (M) (indirect obj.
ašnqs n wafa	pronoun)
asnsar	thorn

avrruy n uġrum	bread, piece
avurġs	grasshopper (small)
awal	sound; speech; voice;
awardi	word
awd	to reach; to arrive
awď	also
awd imiq	even (adv)
awd ma‫ع‬lm	nothing
awd yan	nothing
awdHaH	no one
awdyan	nothing
awġ	nobody
awi	to eat; to graze
awis	to bring; to take away
awjjim	"I wonder..."
awl	heart
-awn	to be married; to get
-awnt	married; to marry
awraf	you (M, pl) (indirect
awraġ	obj. pronoun)
awrz	you (F, pl) (indirect
awsi	obj. pronoun)
awsir	mug
awtuf	yellow
awulu	heel
awunin	opening in front of
awurdu	shirt (women)
awurn	old man
awurz	ant
awwrn	plow (n)
awzay	rabbit
axam	flea
axansir	flour
axbarn	foot, ball of
axbašn	flour
axbbuš	vaccination
axdil	tent

azarig azarqi	mill
azbar	blue (adj)
azbi	cramps; colic; pain
azduz	bracelet
azġur	pestle (for mortar)
azgwaġ	blood vessel; root
azilal	red
aziwal	place, higher
azizaw	person, cross-eyed
azl	green
azlm	to run; to run away
azlmat	person, cross-eyed
azmud	l'eft
azmul	scar
azn	scar
aznnar	to send
aznzul	cape
azqur	person, mute or deaf
azrg	bridge
azrgn n waman	mill
azrm	water mill
azru	worm, in mud
azrwal	rock; stone
azrz	blond
azufri	strap (for purse, knife)
azuknni	bachelor
azumar	oregano
azvi	pricklies (in raw wool)
azwu	anklet; bracelet
azyin	wind
azzar	over there
a‫ع‬ami	hair
a‫ع‬brqu	person, low birth
a‫ع‬bruq	grasshopper
a‫ع‬daw	veil, bridal
a‫ع‬jli	enemy
a‫ع‬jliy	beef
a‫ع‬lam n trgwa	bull
a‫ع‬lbun	manager, water
a‫ع‬ryan	fox
a‫ع‬sas	hospitable (adj)
a‫ع‬skri	guard

bnadm bntr	person; human being
bnu	to paint
bou‫ع‬wid	to build
bri	pear
brikat	to hurt (be painful)
brkuks	millions (money)
brra (n)	pasta
brrm	outside (of)
brr‫ع‬	to turn
brš	to enjoy
brzd	to hurt
bškirid	to bother; to disturb;
bslama	to annoy; to irritate
bţaţa	bicycle
bubu ikrkisn	goodbye*
bu itran	potato
bu ixudadn	proprietor
bu mHmd	l'iar
bu mnqar	Allah (figurative
bu şfir	speech)
bu syyar	l'iar
bu tagant	hedgehog
bu tayut	vagina (figurative)
bu trabandu	jaundice
buġaba	sieve; sifter
buHmrun	turtle
bumba	person, hunchbacked
burš	smuggler
bus	ranger, forest
bušfr	measles
butaHanut	faucet (public)
butamart	to have goosebumps
butl	to kiss*
butyu	musket
buzgwaġ	shop keeper (M)
buzgwiġ	bearded man
buzruru	couscous, corn
bxxr	boots

ddilit	vine
ddimuqratia	democracy
ddin	religion
ddisir	fruit (after meal)
ddkr	male*
ddllak	rolling pin
ddnb	sin
ddndum	drum (large one) (n)
ďďo	electricity
ďďoh	l'ight (n)
ddr	to be alive
ddra	corn
ďďrb	multiplication (math)
ddrġl	to have poor vision
ddriwš	beggar
ddrjat	steps, on stairs
ddrs	l'esson
ddrugri	hardware store
ddruj	stairs
ďďşş	floor (cement)
ddu	to go; to walk (go)
ddub	bear (n)*
dduhr	call to prayer, 2nd
dduj	walnuts
ddula	country*; nation;
ddunit	government
ddur	world; Earth; planet;
ddura	universe
ddurdr	time (instance)
ďďuruf	trip (n) (travel)
ddurus	to be deaf
d-dustur	conditions
dduwal nnamiya	l'essons
dduwaya	constitution
dduxmu	developing nations
ddwa	skylight*
ddz	to have indigestion
dfar	medicine
df‫ع‬	to pound; to smash
dġi	to owe
dġik (noon)*	to push

dujanbir dum	d‫ع‬u
dur	f
ďur	fa
duwr	fabur
dux	fad
dwa n imi	fafa
dwa n tuġmas	faHrtu
dwr	farina
dwš	farţu
dwx	fasma
-dx	fbrayr
dz	fďďl
d‫ع‬f	fďr

g ism	to celebrate
g ixf^ dig*	to tempt
to name	to line up
to follow bad	to tickle
instructions (leads to bad results)	at the end
g lfrH	to fit
g lġrr	to think (an opion); to
g lHd	think something
g şşf	mistakenly

guz ġuz	Hďu iġf*
ġyyb	Hďu ixf*
ġz	Hfd
ġzif	Hiďr
ġzin	hiya
ġzz'z	Hiyya
habmluk	Hkam

Hzzm	-i
to be generous; to put	i ixf^
on a belt; to tie; to	i wadu*
fasten	ibilbilu
i	ibrbilu
-i	ibrin
at; for; to	ibuxa
me (direct obj. pronoun)	ibuzikn
me (indirect obj. pronoun)	ibxaš
alone	ibzdan
oneself, by	ibzg udis
moth	idid bibi
buttons	id luzir
butterfly; moth	id rray
course flour; finely	id rray
ground wheat	id sfud
hail	idamn
parasite	idarn
figs	idd'd
water bugs	idġarn
insects	idi
urine	idmarn
stomach, swollen	idrimn
do/is (question word before noun)	idrus
turkies	iďuďan
ministers (govt)	idukan
opinions	idušan
suggestions	if
skewers	ifan
blood	ifasn

igm igma	drawing of water
ignna	brother
igr	sky
iġrafn	field
igrawn	cups
iġrdayn	frogs
iġrisn	mice
iġrm	warp threads
iġşan	village
iġşş	bones
iġšt	bone
iġuda	kid (small goat)
igura	good
igurdan	frogs
iġyal	bedbugs; fleas
igzul	donkeys
iHadjamn	short
ihadjmn	tattoos
ihalaln	barbers
iHarqan	l'ies
iHbubn	fabric scraps
iHi	seeds
ihirwin	no
iHla	heroin
iHla wawal	pretty (adj)
ihmma	things are good
iHnbl	important; interesting;
ihnna lHal	to be interested
iHruyn	rug, wool
ijdad	no problem
ijdi	clothes
ijdi n waman	birds
ijdign	dog
ijdm	otter
ijji	flowers
ijlx	drum (n)
ijnna	healthy
ijr	dirty
ijran	sky
ikmz (colloquial)	field

imšinaġ	l'ike that; thats the
imsmarn n tadoht	way!
imšţn	needles, knitting
imttawn	brushes (for wool)
imula	tears
imzgan	shadows
imzġan	ears
imzi* l‫ع‬ql	ears
imzian	to be immature
imzran	ears
imzzan	dung (donkey, mule,
imzzi	horse)
-in	foreigners
inarmaysn	foreigner
inbiawn	that; those
indar	information
inġa* fad	guests
inġa* kra	penalty card
ini	to be thirsty
inifif	to be sick
inig	to say; to tell
iniġi	funnel
iniji	to look for; to seek
iniyn n wafa	fight (n)
injayn	witness (n)
inji udis/uxdil	iron fire stand
inmmtri	cheeks
inox	to have diarrhea
insi	beggar
inslmn	stainless steel
-inu	hedgehog
inwa	Muslims
inwan	my
inzad	cooked (adj)
inzadn	cooked
inzd	hair, strand of
iqaritn	hair, goats; hairs,
iqbi	small (esp. knuckles)
iqojjan	hair, small (esp.
iqrruyn	knuckles)

iskrlkasn iskula	l'ie (n)
islan	trees
isli	grooms
isliman	groom (n)
islli	fish (pl)
islman	rock
ism	fish
ismawn	name; noun
ismx	names
išmz	slave
isnan	finger, thumb
išnti	quills
işnţiw	child, illegitimate
isrdan	stones (in river, used
isrman	as path)
issans	mules
iššď	intestines
istkan	gasoline (for motor
istma	bikes)
istmatn	to be slippery
ištša	fork (for wool)
isufir	sisters (my)
iswi	sisters
isyaln	poisoning
iš‫ع‬ab	spices
ithri	basket, bread
ithrn	shelves
iţlan	fox
itlli	star
itran	stars
itran n ţit	make-up (n)
itri	yesterday
iţs	stars
ittzďa	cataract
itušiar	star
iuhan	sleep
iukzay	ground (.i.e. spices)
iwadu nsn	devilish
iwaliwn	easy
iwatu*	bones

izlan	wedding songs
izli	tree branch; song
izllaiyn	beads
izm	l'ion
izran	rocks
izri	pupil (in eye)
izriran	stripes
izrman	worms
izuġran	veins
izuran	roots
izwwr	fake
izyarn	bulls; cows
i‫ع‬amin	people, low birth
i‫ع‬dawan	enemies
i‫ع‬lban	foxes
j	in
jahnnama	hell
jamHuria	republic
jam‫ع‬	to have sex
javil	bleach
jawb	to answer; to reply
jbd	to pull
jbl	mountain*
jdd'd	to renew
jgwa	house
jhd i	to make loud
jiks	steel wool
jj"u	to smell bad; to stink
jjaj	glass
jjam‫ع‬	school, koranic
jjbbad	slingshot
jji	to be cured; to be
jjib	healed; to recover
jjlba	pocket
jjld	injection
jjm‫ع‬	l'eather
jjnb	to collect ; to roll (rug,
jjokir	etc.)
jjrda	pocket
jju	joker (in cards)
jju‫ع‬ (euphemism)	garden; yard

kfft	kmz
kfrun	-kn
kigan	knf
kilima	knimti
kilo	knni
kjm	-knt
kk xf	knu
kks	krad
kks (azar)	kradt
kkul	krď
kkum	krf
kkušm	krfs

lajudan	gendarme, head
lakart du sejour	carte de sejour
lakarţ vizit	business card
laksida	accident
lal	to be born
lalla	miss
laman	trust
lambuš	full time workers;
lamušajlla	registration for work
lapisin	tape recorder
larb‫ع‬	pool
larqum	Wednesday
larriyat	numbers
larz	opinions
lasfiwad	cedar
lasurang	skewers
lavabu	syringe
layhni*	sink
lazyaf	goodbye
lazz	scarves
lbab	hunger
lbaba	door*; gate*
lbaġia	pope, the
lbaġiat	prostitute (least
lbakit	shocking)
lbakiya	prostitutes (least
lbala	shocking)
lbaliza	box
lbani	box*
lbanka	shovel
lbantura	suitcase
lbara	construction
lbarba	bank
lbarquq	paint (n)
lbarud	shovel
lbatri	beets
lbayas	apricot
lbaz	bomb powder*
lbHar	battery, car
lbHar l-abyad lmutawassit	bed; mattress

lfanid	pill; birth control pills;
lfanid n tarwa	candy
lfargunit	birth control pills
lfasad	police car
lfašit	corruption*
lfasma	fruit
lfaxr	gauze
lfdur	coals; charcoal
lfikra	breakfast
lfikrat	idea*; thought
lfil	thought
lfilaHa	elephant
lfilil	agriculture*
lfililan n wazzar	safety pin
lfirma	ribbon
lfista	farm; firm
lfišta	jacket
lfi‫ع‬l	party
lfjr	verb
l-fjr	dawn
lflus	call to prayer, 1st
lfnn	money
lfnnan	art
lforj	artist
lfqra	winch
lfraš	paragraph*
lfrdi	bed
lfrfar	gun
lfrfara	pinwheel
lfrit	fan (n)
lfriz	french fries
lfrmasiyan	strawberry
lfrq	pharmacy
lfrraka	difference*
lfrši	washboard
lfşşa	bark (tree)
lfşşat	alfalfa*
lftiH	alfalfa
lftur	surgery
lfurar	breakfast (n)
lfurmasyun (sunrise)	scarf

lHayat	l'ife*
lHaz	sound (related to
lHazm	vehicles)
lHbaq	belt
lhbra	basil
lHbs	meat, without bones
lHd	prison
lHdd	Sunday
lHdid	fence
lhďrt	metal
lhijra	joking around
lHimz	immigration
lHisabat	chick peas
lhiwaya	accounting
lhiwayat	hobby*
lhja	hobbies*
lHjrat	alphabet
lHk	battery
lHl	right (priviledge)
lHlib	solution
lHlwa	milk (n)
lHm	candy*; sweets
lHma	to sodder
lHndia	heat
lhnna	prickly pear
lHnqa	peace
lhnt	necklace
lHob	steel
lHq	l'ove
lHrir	right
lHsab	silk
lHšiš	accounting; bill
lHss	grass; harvest (grass)
lHub	sound (in general)
lHudud	l'ove (n)
lHuk	borders*
lHukm	can (metal)
lHuquq	sentence (legal)*;
lHurriya	verdict
lHuruf	rights
lHwayj	freedom*

ljjn ljjnun	devil
ljma‫ع‬t	devils
ljmHuryyin	meeting of leaders
ljnt	Heaven
ljrH	paradise
ljrrart	wound
lju	pulley system
ljumla	weather
ljumu‫ع‬a	sentence (grammar)*
ljutta	Friday
lkabut	corpse
lkadu	coat
lkalamrasas	gift (n)
lkalb n lHlwa	pencil
lkalimat	cookie cutter
lkamun	l'yrics
lkanisa	cumin*
lkanun	church
lkari	brazier
lkarta	slingshot
lkarţtun	cards, playing
lkaši	box, big
lkasruna	stamp (n) (official)
lkass	pan (1 handle)
lkatib	glass (drinking)
lkawkab	author; secretary
lkbbuţ	planet*
lkdub	coat
lkfn	l'ies*
lkfta	shroud, funeral
lkiran	meat, ground*
lkks	buses
lkm	to sneak
lknia	to reach
lknina	name, family
lkninat	pill
lkob	pills
lkorba	bucket
lkra	crate
lkri	rent (n)
lkrik	rent (n)

lmalayka	l'markub
lmalik	l'maryu
lmamlaka	l'masakin
lman	l'mašari‫ع‬
lmanďa	l'-masiHi
lmani	l'-masiHiya
lmanu	l'-masiHyin
lmaqadir	l'-mašrubat
lmariu	l'massa
angel(s)	l'ma‫ع‬awnt
king	l'ma‫ع‬lumat
kingdom*	l'md
peace	l'mdadr
money order	l'mdf‫ع‬
semen	l'mdint
menu	l'mďl
recipe	l'mdrat
charcoal heater (rectangular);	l'mġssl

lm'sxut(a) lmţrqa	naughty person
lmudir	hammer
lmuďu‫ع‬	director; manager
lmuftiš	subject
lmuġnni	inspector
lmuġrb	singer*
lmuhajrin	call to prayer, 4th
lmuHakama	immigrants
lmuHami	trial (court)
l-muHit	la'wyer
l-muHit l-atlasi	ocean
lmulk	Atlantic Ocean
lmunada	reign
lmunafasa	soda
lmunakaša	competition
lmunax	conversation
l-munjid	climate*
lmuqawala	dictionary
lmurad	enterprise
lmurşu	objectives
lmus	piece
lmusiqa	knife*
lmustaš	music
lmustaţil	mustache
lmustqbal	rectangle
lmutafrrijin	future*
lmutur	spectators*
lmuwaţin	scooter
lmuxddirat	citizen
lmu‫ع‬aq	drugs
lmu‫ع‬dal	disabled (adj)*
lmu‫ع‬lim	average*
lmxazn	teacher
lmxdda	authorities;
lm‫ع‬d	government
lm‫ع‬da	pillow
lm‫ع‬dn	minerals
lm‫ع‬dnus	stomach (organ)
lm‫ع‬išt	mineral
lm‫ع‬llm (sunset)	parsley

l-qrqara	drain (in shower or
lqrrasat	floor) (n)
lqrunfl	clothespins*
lqr‫ع‬a	cloves
lqšra	jar (n)
lqšš	dandruff
lqsua	kindling
lqum	dress (n)
lquwa	boys; children
lqwilbat	energy*
lqzbur	suppository
ls	cilantro
lşaq	to dress; to put on; to
lşşq	wear
lštab	glue
ltnin	to glue; to tape
luft	book
luġniya	Monday
luHš	turnip
luHuš	song*
luliyt	animal (wild)
lum	animals; wildlife
luqid	wife; woman
luqt	to blame*
luqt na	matches
lurd	time (hour)
lurdinatur	when (relative)
lusada	rose (flower)
lusx	computer
lutil	pillow
luwašun	dirt (on person)
luzin	hotel
luzir	children
luzi‫ع‬t	factory
lvaliza	minister (govt)
lvirage	divided slaughtered
lvirajat	animal
lwalda	suitcase
lwalidin	curve
lward (scotch)	curves

l‫ع‬aşir	juice
l‫ع‬aşr	call to prayer, 3rd
l‫ع‬b	to play
l‫ع‬bar	scale
l‫ع‬brt	bucket, measuring
l‫ع‬ďala	muscle*
l‫ع‬dalat	muscles*
l‫ع‬ds	l'entils
l‫ع‬ffar	potato bug
l‫ع‬fit	fire (n)
l‫ع‬ib	weakness
l‫ع‬il	baby; man
l‫ع‬in	spring
l‫ع‬in n ţit	iris
l‫ع‬ks	opposite
l‫ع‬lam	flag
l‫ع‬laqa	relationship
l‫ع‬lu	entryway, hallway
l‫ع‬nsuria	racism
l‫ع‬nzi	meat, goat
l‫ع‬ql	brain*; mind (n)
l‫ع‬rg	sweat
l‫ع‬ša	call to prayer, 5th
l‫ع‬sifa	storm*
l‫ع‬skr	military
l‫ع‬tbt	doorstep
l‫ع‬ţriya	spices
l‫ع‬uari	mountains
l‫ع‬ulum	science
l‫ع‬unwan	title
l‫ع‬uţla	holiday*; school
l‫ع‬wayd	vacation
l‫ع‬win	traditions
l‫ع‬wwaya	provisions
m_mtHanut	whooping cough*
mad	shop keeper (F)
madruba	or (question)
maHţa	multiplied by (math)
maHya	television station
mami	fig liquor
mamnu‫ع‬ (afternoon) (metal)	whom, to (relative)

mgr	to harvest (grains)
mġrď	to stretch
mgur	unless
mHbawš	chameleon
mHra	just now
mid	or (question)
mika	plastic bag; condom
miliun	1,000,000
milyun	10,000 Dhs
mimmi	son (my)
minyul	10,000 Dhs
miya	100
miya f lmiya	definitely*
miyaman	to trust each other
mjahad	to compete
mjġyul	hyena
mjma‫ع‬	to meet (with people)
mjma‫ ع‬d	to meet (by
mk	coincidence)
mkarr	if
ml	although
mlil	to be possible
mlili	to be white
mlk	to be dizzy
ml'lly	to own
mlqay	to spin; to turn around
mlul n (dir)	to collide
mma	across from (facing)
mma Hlu	mother
mmarks	grandmother
mmas	to be tangled
mmatr	to poop
mmġ	to guard; to watch
mmi‫ع‬dr	to be wet; to get
mmt	damp
mnb‫ع‬d	to be crazy
mnġiwt	to be dead; to die
mnsu	after*; la'ter
mnu	killing

muš mušjji‫ع‬	myinniy
muškil	myuqu
muslimin	myyl
mutafail	mzaray d
mutašaim	mziy
mutatarif	n
mutllat	na
muyd	nadafa
muzun	nafs
mwwl	nafuska
myaġ	nag
myassan	naġ

-nknt	your (F, pl)
nkr	to rise (get up); to
nm	stand; to wake up
-nm	to be straight
nmili	your (F)
nmra	to be close; to be
nmra n tilifun	near
nmska	size
-nna	phone number
nnaġ	chewing gum
nnaHw	that; those
nnaqus	to beat up; to fight; to
nnašat	quarrel
nndd	grammar*
nnf‫ع‬	bell
nnggasa	fun
nnHas	incense
nnird	benefit
nniyt	l'ight switch
nnqlb	copper
nnţ	dice*
nnukta	truth
nqb	to fall; to flip
nqis	to hit against
nql	joke
nqlb	to pierce
nqr	minus
nqš	to copy
nqş	to turn over
nqu	to trip
nqurd	to embroider
nqurt	to decrease
ns	to be clean
-ns	silver
nş	silver
nsas g lman	to spend the night
nsatas g lman	his; her(s)
nşH	half*
nšl	goodnight
-nsn	goodnight (to more

qiyd qjar	to write down
qjj	to be naughty
ql	to bite; to crunch
qlb	before (time)
qli	to faint
qllb	to fry
qlld	to examine
qllq	to imitate
qllv	to be angry; to be
qmmr	upset; to be worried
qmr	to examine
qnď	to gamble
qnţ	to be narrow
qn‫ع‬	to be lonely
qqar	convince
qqd	to convince
qqim	to be hard; to be
qqim xf tiġiġiyin	stale; to dry
qql	to cauterize
qqn	to remain; to sit; to
qqn (conj) tiţ	stay
qqrş	to squat
qqs	to wait
qqu	to close; to lock; to
qrf	set a bone; to shut
qrilloh	to wink
qrra	to be tense (muscles)
qrra n iġrdayn	to bite (insects); to
qrrb	sting
qrr'r	to have sex (slang)
qrš	to be cold
qşm	corn
qşmayn	trap
qššr	mousetrap
qşşr (something legal)	to be close; to be

rkiz	to be cloudy (water);
rkkb	to be muddy
rkkizn	to dial; to install
rkm	water, dirty
rku	to be boiled
rmi	to get dirty
rmla	to be tired; to be
rnu	unable
robini	sand (n)
rqqd	to defeat
rrafay	faucet
rraHt	to soak*
rrapur	alarm (clock)
rray	rest (n)
rraya	report
rrbH	idea
rrbi‫ع‬	flag
rrf	profit (n)
rrfuf	spring (season);
rridu	grass
rriH	shelf
rriHa	shelves*
rriHla	curtains
rriHt	air
rriš	perfume
rrmman	excursion; picnic
rrqm	stench (n)
rršm	feather
rršqt	pomegranate
r-ršwa	number
rruH	design, colorful
rrunda	jocularity
rrusi	bribe (n)
rruz	soul
rrwaH	pair (cards)
rrwiďa	receipt
rryaďa	rice
rryadiat	breeze
rryss	tire
rsa	sports

şak	purse
şalH	to mediate
šambrir	tire tube
samH*	to pardon; to excuse
samHi	excuse me; sorry
sanida	gound (adj)
šanpwan	shampoo
šanţi	path; street
šar Hdaš	November
šar rb‫ع‬a	April
šar sb‫ع‬	July
šar sţa	June
šar tlata	March
šar tmniya	August
šar tnaš	December
šar ts‫ع‬a	September
šar waHd	January
šar ‫ع‬šra	October
šarij	cistern; reservoir
šarika	company
šarji	to charge
sawl	to call (on phone); to

sfnj	doughnut
sfrjil	quince
sfru	to explain
sfsi	to dissolve; to make
sfsis	melt
sfst	to lighten
sftu	to calm; to make
şfu	quiet; to silence
sfud	to spell
sg	to be shiny
sġ	skewer (n)
šġal	from; since
sġl	to buy
sġlu	to do
sġr	to step over
sġr aln g	to make expensive
šġul	to teach
sġus	to gaze
sġuy	tasks
sġwi	to burn
sġzif	to scream; to shout;
sHal	to yell
šHal aya	yell (to someone)
sHam	to lengthen
šhd	how much*
shddn	a while ago
šhdya	brag (n)
šHf	to witness
sHHr	to pacify
sHirri	nectarine
sHišir	to be dehydrated
sHissi	to flatter
sHizun	to wheeze
sHllil	hallucination
sHmu	to whisper
šhr juj	to limp
šhr sb‫ع‬	to lie
šhr xmsa	to heat; to warm
sHra	something
šhriya	February

siwd şiwď	to scare
siwl	to give a ride; to lead
siwriġ	to
siyujd	to speak
sizi	jaundice
sjjl	to make ready
šjrt	to go bankrupt
skdub	to enroll; to record; to
skirks	score
skjm	tree
šklat	to lie
skmď	to lie
skn	to make enter
sknd	chocolate
sknjbir	to burn
sknu	to live (in a place)
skotš	to exploit
skr	ginger
škr	to bend (something)
skr-t i ka	tape
sksu (n)	to be drunk; to make;
sksu s ďart	to repair
sksw (conj) g lmri	to praise
sksw (v)	to trick
sktiy	couscous
skuffi	to look behind
skuHu	to look in mirror
skutr	to look; to see
skuzzi	to remind
sku‫ع‬u	to fart
šlaġm	to cough
slaH	to pack
šlalat	to fart
šlata	to crow
slġ	mustache
slH	to be useful
slHil	waterfall
slil	salad
slip	to be contagious; to

snqlb	to flip; to turn
snslt	something over
snţfs	chain (n); zipper
snu	to fold
šnu	to cook
snya	to be bent
snyumu	to sign
sn‫ع‬t	to be squished
sqaya	to show
šqayt	water fountain, public
sqf	difficulty
sqllq	ceiling*
sqqf	to upset (somone)
sqsa	to roof*
šqu	to ask
šrab	to be difficult; to be
srba	hard
srbi	wine
srdl	to serve
šrfa	to be fast
srġ	to make drop; to
šrjm	make fall
srraq zzit	people, high birth
srrf	to heat
srs	window
srsar	cockroaches*
šršq	to cash; to change
šrţ	to place; to put down
srurd	bell
srut	to make pleasant
sry	conversation
şşabra	to be/make
şşabun	conditional upon
ssafir	to lull (a baby)
ššahada	to thresh
ššahd	to loosen
şşaHt	twine
s-sail (money)	soap

ssirw	conditioner (hair)
to assist somone	paint brush
giving birth; to make a	paint brush
woman pregnant (man)	devil
ssišwar	trees
ššita	doubt
ššiţa n şbaġt	sugar
şşita n şbaġt	to do
š-šitan	to infect; to stick
šši‫ع‬r	sticky (adj)
ššjari	merchandise
ššk	wire (n)
sskkar	prayer rug
sskr	stairs
sslġ	wire (n)
sslġ (conj in present)	la'dder
ssli‫ع‬t	poison
sslk	to cook
şşllaya	belt*
ssllum	candle
sslš	both
sslum	wooden box; crate
ssm	industry
ssmr	to skin (i.e. knee, on
ssmţa	person )
ššm‫ع‬	zipper
ssnat	to bake
ssnduq	headache, migraine
şşni‫ع‬t	to make difficult
ššnšf	coins

stin	60
şţiqs	to bomb
stitmar	investment
štka	to complain
stš	to feed
sţs	to amuse; to make
štša	fun; to make laugh
šţţb	to complain
šţţr	to sweep
šţu	to bargain
stul	to smell
st‫ع‬ml	to be heavy
su	to use
sua	to absorb; to be
sual	worth; to drink
şud	to be worth
suddum	question*
sudur	to blow on a fire
suf	to leak
šufaj	welder
sufġ	to blow up (air)
sufs	heater
sufu	to make leave; to take
şug	out
suhn	to spit
sujd	to light a path/a place
sul	to drive
sula	to simplify
šumini	to prepare
sumu	to still be
sunfs	to be free (time)
suqr	chimney
şurţ	to include
surug (conj in present)	to breathe
sus	to be loud
şuţ	star (five pointed)
sutf	woman in last days of
suty	pregnancy
sutyanat	to shake
šuwaya	to spray (insecticide)

š‫ع‬ria s‫ع‬ţţr	vermicelli
-t	him (direct obj.
ta	pronoun)
tabaġġa	it (M object) (direct
tabarda n usardun	obj. pronoun)
tabašir	this
tabaxa	tobacco
tabHirt	saddle, mules
tabla	chalk
tablHuHt	spider
tabrat	garden
tabrdamušt	table
tabrgagt	Adams apple
tabrrrayt	l'etter
tabšit	l'izard
tabujjut	gossip (n)
taburzigt	circle
tabuţ	vagina
tabut (n)	muscle
tabuwlt	plant, hallucinogenic
tabxlit	belly button; umbilical
tabxni	cord
tadarwin	bottom (of)
tadawt	bubble (noun)
tadbibt	fatigue (n)
taddart	darkness
taddilt	houses
tadgwat	back (animal/person)
tadist	doctor (F)
tadllalt	house
ţadohţ	tail
tadrant	afternoon
taduli	diarrhea
tadunt	auction (n)
tadwart	wool
tafant	baby
tafarmlit	roof
tafaska	fat (animal) (n)
tafllaHt	entrails

taguni n ušn taguni n ‫ع‬nwa	taHidust
taġuri	tahl
tagust	taHnut
tagut	taHramt
taġya	taHrirt
tagzayt	taHruyt

tamimt	honey
tamlalt	gazelle
tammt	honey
tamndilt	blanket, bread
tamnt	honey
tamşriyt	room, living
tamssalt	roofing (n)
tamssi	naughtiness
tamswwqt	purchase (n)
tamtliyt	bowl
tamtut	wife; woman
tamţut n igma^	sister-in-law
tamunt	cooperation
tamurġi	grasshopper; l'ocust
tamurkist	knot
tamwudt	virgin
tamxmxt	dignity
tamzawit	dust devil
tamzi	youth
tamzmart	nail
tam‫ع‬durt	crazy person
tana‫ع‬ut	pulley (well)
tanbult	bladder
tangult	l'oaf of bread
taniyt	rust
tanmia	development
tanmiya n lmuqawalat	small business
timzzanin	development
tanmnirt	gravestone
tansrit	room (salon)
tanuġa	herb, grown in fields
tanuġi	killing
tanumi	straight (n)
tanurt	stove, traditional,
tanut	made from mud
tanutfi	well, water (small)
tanzġa	cistern
taqa šmsia	walk (n)
taqayt	solar panel
taqbilt	boil (n)
taqbut	community group;
taqfift	tribe

taslt tasmart	basket
tasmmi	hammer
tasmunt	sour (n)
tašm‫ع‬t	friend
tasrdunt	candle
tassa	mule
tassaywlt	l'iver
tassa‫ع‬t	shadows
tasskolt	hour; time (hour);
tassmrt	watch
tassnduqt	mousetrap
taşşum‫ع‬t	belt
tass‫ع‬t i	tea crate
tastit	minaret
tašţţabt	now
tašwitin	strainer
taš‫ع‬but	broom
tatajint	brochettes; diced
tatayth	meat
taţbibt	flute
tatffaHat n Adam	tajine dish
taţfut	pillow
tavut	doctor (F)
ţawa	Adams apple
tawalt	delicious
tawargit	umbilical cord
tawda	cooking pot
tawirqt	juniper
tawjdanit	dream (n)
tawjimt	fear (n)
tawkka	form (paper)
tawla	dress (n)
tawlzit	tail (on an animal);
tawmatin	childs penis
tawnza	worm
tawriqt	fever
tawriqt n lintixab	ankle
tawrirt	sisters
tawsirt	bangs (hair)
tawtult	paper; ticket

ta‫ع‬riya tbşil	erosion*
tb‫ع‬	plate
ţb‫ع‬	to follow*
ţd	to stamp
tfaH	to suck (babies on
tffaya	mother's breast)
tfiras	apples*
tflflt iHran	ashtray
tflla	pear
tflut	pepper, hot
ţfur	to tease
tgrazi	door
tHara	to follow
tHawis	regret (n)
ţHHana	circumcision
thlla	travels (n)
tHmira	blender
tHmml	to take care
tHmms	paprika
tiam‫ع‬rt	to bear
tiara	to be enthusiastic
tiayrsi	belly button
tibinzit	airplane*
tibiwlin	l'otto-like game
tibiwlt	flute
tibiwwal	bubbles
tibiwwlt	bubble (noun)
tibrmit	balloons
tibujja	balloon
tib‫ع‬ušin	bidon, 50 liter
tidartwin	muscles
tidi	dates (fruit)
tidiklt	houses
tifaq	sweat
tifatliwin	palm (of hand)
tifawt	consensus
tifdnin	warts
tifdnt	early (dawn); morning
tifiġra	toes
tifinaġ (early)	toe

tijni	sewing (n)
tijnut	thunder
tijwit	churn, made from
tikal	animal skin(n)
tikdift	times (instances)
tiklkad	carpet
tiklt	tickle (n)
tikurbyin	time (instance)
tikurdasin	shoes
tilfax	stomach, roll of
tilfxt	animal organs
tilguit	callouses (n);
tili	splinters; blisters
tilima	callous (n); blister;
tilkmin	splinter
tillas	bridge
tilmi	ewe
tiltatin	file, metal
timatdin	turnip
timdlt	dark (n)
timganin	thread, wool
timġarin	yolks (for animals
timġt	when plowing)
timit	placenta
timiwa	grave (n); l'id
timli n ţiţ	prostitutes (slang)
timlilay	women
timnaţin	chin
timqqa	umbilical cord
timqqit	eyebrows
timuwa	eye, white of
timzin	nausea
timzzilit	poems
tin wutši	drops (of liquid)
tin yits	drop (of liquid)
tinknt	eyebrows
tinnġ	barley

tislit n unzar	rainbow
tismawin	shots (of medicine)
tismdlt	l'id
tismi	injection; needle; shot
tismi n lqwwa	IV
tisnda	stand for churn
tisnt	salt
tisruns	fibula
tissi	drinking (n); drinks
tistuin	branch, tree
tisura	keys
tiswit	basket, bread
ţiţ	eye
titliwin	brochettes; skewers
tiwinas	earrings
tiwkkiw	worms
tiwrġi n tiglay	egg yolk
tiwririn n rmla	sand dunes
tiwtmin	women
ţixsi	ewe
tixt	sigh
tixursin	earrings
tiyď	others
tiyira	end (of events)
tiyjda	beams, ceiling
tiyni	dates (fruit); palm tree
tiyu	hose
tiyzlt	kidney
tizarzay	meat skewers
tizdit	weaving (n)
tizi	mountain pass
tizizwa	bees
tizlmaz	sore throat
tizrt	pitchfork
tizwa	bees
tizwarnin	call to prayer, 2nd
tizwiri	a long time ago
tizwit	bee
tizwuri	a long time ago;
tizzt	beginning
ti‫ع‬zzit (of medicine) (noon)	masturbation

trjm	to translate
trkxt	handle, axe
ţrrf	to be beautiful
tryamut n tislit	headdress (metal)
tš	to eat
tş	to laugh; to smile
tš (conj. as reflexive v)	to be itchy
ţs xf	to make fun of
tsawr	photographs; pictures
tsbiHat	prayer beads
tsHa	definitely
tsigniu	clouds
tskawwin	horns (animal)
tsmiyawin n	drugs, intravenous
lmuxddirat	sieve
tšţţuţ	photograph
tswira	9
ts‫ع‬a	90
ts‫ع‬in	19
ts‫ع‬taš	9
ts‫ع‬ud	it (F object); her
-tt	chalk
ttabaşir	nature
ţţabi‫ع‬a	form (for mud
ttabut	construction)
ttaHrruš ljinsi	sexual harrassment*
ttalwwut	pollution
ttaman	price
t-taqafa	culture
ţţaqs	weather forecast
ttarix	date (of month)
ţţas	to touch
tta‫ع‬awun ttiqni	technical assistance
ţţd	to breastfeed
ttf	to grab; to arrest
ţţf s	to hold on
ţţib‫ع‬	stamp (n) (official)
ttimsaH	aligator
ttiqa	trust (n)
ttiran	field, playing
ţţm‫ع‬ (direct obj. pronoun)	greed

tuxsin tuzlin	teeth
twssir	scissors
-tx	person, old
txsi	these; this
tyat	ewe
tyudfin	another
tzlaft n tadawt	ants
tzwari	back, lower
tzyyin	beginning
t‫ع‬adilt	circumcision
t‫ع‬dda xf	bag, canvas
t‫ع‬rrď	to attack
t‫ع‬ziyt	to get in someone's
u	way
ubui	condolences
udadn	and (time)
uday	cut (n)
udayn	sheep, barbary
udi	Jew
udm	Jews
uďu	butter, from the cow
uggar	face (n)
uġuld	to fold; to hem
uġus	more
uHl	to come back
uHu	burn (n)
uima	to be tired
ujd	no
ujju	brother
ukan	to be ready
ukus	to descend
ul	then (sequential)
ulli	removal
ulwu	heart
uma	sheep
umi	weak
umu	why not?
una	where…from
unfus (animal/person)	to be involved; to be

ut (conj) tiġuzvav ut (conj) tinzi	to squat
ut (conj) tizzt	to sneeze
ut (conj) tummizt	to masturbate
ut (reflexive) ljnun	to masturbate (men)
ut (reflexive) uquryan	to be epileptic
ut …g…	to be epileptic
ut aġujdim	to multiply* (numbers)
ut rršš	to sit
utma	to applaud
utmas	sister (my)
utmi	placenta
utši	where…from
uţţub	meals
uxla	brick, mud
uxs	so (therefore)
uxsan	tooth
uxsas	teeth
uxssn	head
uzu	heads
uzum	to skin
uzz‫ع‬	to fast
vititi	to divide a
wa	slaughtered animal
wahali aya	bicycle
wahi	this
wahli	a long time ago
wahli n	no
wajb	to be long (time,
wala	many
walayni	to answer
walf	nor
walini	to be next to
walu	but
war	to be accustomed; to
warwarg	adapt; to be used to
warixs	but
watx (euphemism)	nothing

xllş	to be scared
xllţ	to rot; to stink
xlu	to be lost in thought
to pay	to grab
to be mixed; to mix	5
to destroy; to knock	50
down/collapse (a building)	15
xl‫ع‬	to confuse
xmj	only
xmm	by yourself
xmr	unless
xmš	to shrink (something
xmsa	swollen)
xmsin	to break down
xmstaš	to fail; to lose (a
xmz	game); to spoil

zdu zhu	znqt
zi	zqlil
zi ġif	zr
zik	zrb
ziyl	zrď
ziyr	zrda
zizwar	zrf
zl	zri

Verbs	ssa

to applaud	t'ttr

to be able	txyyar

to be careful	trara lbal

to be dangerous	tilis

to be fast	tqwu

to be hot	---

to be loud	ġur (conj in simple

to be poor	tHtadja

to be silent 	ššď

to be used to	tnfa‫ع‬

to benefit from*	tġďar

to bribe 	iwiġ

to charge 	ġušiġ

sthlak 	rjajġ

to cut (hair)	tkks(azar)

to disappear	tġyyab

to drink	smiqqi

to enroll	kjjm

to fall	tnqlab

to fit	.‫ع‬ddl

to gamble	jjma‫ع‬

to gleam	sfliliy

to guard	akka

to have sex (homosexual)	tqqu

to ignore 	xaylġ

to kiss	tbus

to let go of 	l'lġ'ġ

to look 	sksuġ

to make a woman pregnant (man)	sxitir

to make noise (like fingernails on a chalkboard)	šršaq

to meet	tmjma‫ ع‬d

to obey	tbzzaz

to peel	zlam

to prevent someone from	trbaH

to reach	tlkam

to resemble	zddġ

to scare	tzlla‫ع‬

to share	tššur

to skin (i.e. knee, on person )	tamd abariq

to spin wool	sufus

to step over 	sslġ'ġ

to swallow 	gguliġ

to teach	šš‫ع‬af

to tie closed	tzyyar

to understand	qqrd

to walk	tddu

to wink	sffď

Countries	Algeria

Hong Kong	hung kung
Hungary	hanġarya
Iceland	aislanda
India	l'hind
Indonesia	andunisia
Iran	iran
Iraq	l'‫ع‬iraq
Ireland	irlanda
Israel	isra'il
Italy	italia
Jamaica	jamayika
Japan	l'yaban
Jordan	alurdn
Kazakhstan	kazaxistan
Kenya	kinia
Kiribati	kiribati
Kosovo	kusuvu
Kuwait	l'kwit
Kyrgyzstan	kirgistan
Laos	la'wus
Latvia	la'tvia
Lebanon	l'ubnan
Lesotho	l'usuţu
Liberia	l'ibiria
Libya	l'ibia
Liechtenstein	l'išinšţayn
Lithuania	l'ituaynia
Luxembourg	l'uksmburg
Macedonia	maqdunia
Madagascar	madaġašqr
Malawi	malawi
Malaysia	malizia
Maldives	maldiv
Mali	mali
Malta	malţa
Marshal Islands	juzur lmaršal
Mauritania	muriţania
Mauritius	maribis
Mexico	l'miksik
Micronesia	mikrunizia
Moldova	mlduva
Monaco	munaku
Mongolia	manġuliya

Solomon Islands	juzur ssulumun
Somalia	şşumal
Somaliland	ard sumal
South Africa	janub afriqia
South Korea	kuria aljnubia
Spain	ispania
Sri Lanka	sirilanka
Sudan	ssudan
Suriname	surinam
Swaziland	swazilanda
Sweden	sswid
Switzerland	swisra
Syria	suria
Tajikstan	tadjakstan
Tanzania	tanzanya
Thailand	ttayland
Timor-Leste	timur-šarqia
Togo	ţţuġu
Tonga	ţunga
Trinidad and Tobago	tarindad wa tubagu
Tunisia	tuns

God Phrases	bşHa

nšallah 	ad i‫ع‬fu rrbi

