Norbert Wiener, a key figure in cybernetics, in which Weaver made this curious claim, today quite famous:
    When I look at an article in Russian, I say, “This is really written in English, but it has been coded in some strange symbols. I will now proceed to decode.”


г -> gh  buchгaltung гaaгa = Hague
ф => PTH!!! ph/th!! arithmetic арифметика Athens F france  amphibian  амфибия  ✓ Африка Эфиопия Ethiopia профессор 
у = u ≠ vy (historic) phui
й : ñy->y ng/nik/ing->y !  blank 		белый  belėiy[nk]  ✓
Ю : U (iUv) new Luxemburg Югославия  Yugoslaviia
professor
-nost -ness
бег- WEG-! => беs des-
от- o- aus- :(?): re- er- wieder-?
за- zu- für-

k c zu to !  K/T !  kata? tak?

zoo 		зоопарк  śoopark ✓
ABC 		азбука алфавит  acbuca alphabet : abc ✓ al'tablet
Abyssinia 		Эфиопия  aithiopiia ✓
Adam's apple 		адамово яблоко  adamovo iabloko ✓
Addis Ababa 		Аддис‐Абеба  addis‐abeba  ✓
Aden 		Аден  aden  ✓
Afghanistan 		Афганистан  afganistan  ✓
Africa 		Африка  afrika  ✓ ф!
African 		африканец  afthrikaness ✓
African woman 		африканка  afthrikanka ✓
Albania 		Албания  albaniia  ✓
Algeria 		Алжир  alζeir  ✓
Algiers 		Алжир  alζeir  ✓
Alps 		Альпы  alpėi  ✓
Altai 		Алтай  altay  ✓
America 		Америка  amerika  ✓
American 		американский  amerikanskiy 
American woman 		американка  amerikanka  ✓
Amsterdam 		Амстердам  amsterdam  ✓
Amudaryra 		Амударья  amudaria  ✓
Amur 		Амур  amur  ✓
Angola 		Ангола  angola  ✓
Angora 		Анкара  ankara  ✓
Ankara 		Анкара  ankara  ✓
Antarctic 		Антарктика  antarktika  ✓
Antwerp 		Антверпен  antverpen  ✓
April 		апрель  aprel  ✓
Arab 		араб  arab  ✓
Arabia 		Арабия  arabiia  ✓
Arabian 		арабский  arabskiy  ✓
Arabian woman 		арабка  arabka ✓
Arabic 		арабский  arabskiy  ✓
Aral Sea 		Аральское море  aralskoe more ✓
Archangel 		Архангельск  arxangelsk  ✓
Argentina 		Аргентина  argentina  ✓
Armenia 		Армения  armeniia  ✓
Arnhem 		Арнем  arnem  ✓
Asia 		Азия  aśiia ✓
Asian 		азиатский  aśiatskiy ✓
Asian woman 		азиатка  aśiatka ✓
Asiatic 		азиатский  aśiatskiy ✓
Athena 		Афины  athinėi  ✓
Athene 		Афины  afthinėi  ✓ ф Apth!
Athenian 		афинский  athinskiy ✓
Athens 		Афины  athinėi  ✓
Atlantic 		Атлантический океан  atlanticheskiy okean ✓
Atlantic Ocean 		Атлантический океан  atlanticheskiy okean ✓
August 		август  avgust  ✓
Australia 		Австралия  avstraliia  ✓
Australian 		австралийский  avstraliyskiy 
Australian woman 		австралийка  avstraliyka  ✓
Austrian 		австрийский  avstriyskiy ✓
Azerbaijan 		Азербайджан  aśerbaydζean ✓
Baghdad 		Багдад  bagdad  ✓
Baikal 		Байкал  baykal  ✓
Baku 		Баку  baku  ✓
Balkans 		Балканы  balkanėi  ✓
Bangladesh 		Бангладеш  bangladesh  ✓
Belgian 		бельгийский  belgiyskiy 
Belgian woman 		бельгийка  belgiyka  ✓
Belgrade 		Белград  belgrad  ✓
Bering Sea 		Берингово море  beringovo more ✓
Berlin 		Берлин  berlin  ✓
Beyrouth 		Бейрут  beyrut  ✓
Bois‐le‐Duc 		Хертогенбос  xertogenbos ?/
Bolivia 		Боливия  boliviia  ✓
Bombay 		Бомбей  bombey  ✓
Bonn 		Бонн  bonn  ✓
Brabant 		Брабант  brabant  ✓
Braille 		азбука для слепых  aśbuka dlia slepėix /?
Brazil 		Бразилия  braśiliia ✓
Brest 		Брест  brest  ✓
Britain 		Великобритания  veliko=great britaniia 
British 		британский  britanskiy ✓
Brussels 		Брюссель  brussel  ✓
Bucharest 		Бухарест  buxarest  ✓
Bulgar 		болгарин  bolgarin  ✓
Bulgaria 		Болгария  bolgariia  ✓
Bulgarian 		болгарский  bolgarskiy  ✓
Bulgarian woman 		болгарка  bolgarka ✓
Burma 		Бирма  birma  ✓
Cairo 		Каир  kair  ✓
Calcutta 		Калькутта  kalkutta  ✓
Cambodia 		Кампучия  kampuchiia ✓
Cameroon 		Камерун  kamerun  ✓
Canada 		Канада  kanada  ✓
Canberra 		Канберра  kanberra  ✓
Carpathians 		Карпатские горы Карпаты  karpatskie gorėi karpatėi 
Carpathian mountains 		Карпатские горы Карпаты  karpatskie gorėi karpatėi 
Caucasus 		Кавказ  kavkaś ✓
Channel 		Ла‐Манш  la‐mansh <<< 
Chile 		Чили  dhili  ✓
China 		Китай  kitay  ✓
Congo 		Конго  kongo  ✓
Copenhagen 		Копенгаген  kopengagen  ✓
Cuba 		Куба  kuba  ✓
Curaçao 		Кюрасао  kurasao  ✓
Cyprus 		Кипр  kipr  ✓
Dacca 		Дакка  dakka  ✓
Dakar 		Дакар  dakar  ✓
Damascus 		Дамаск  damask  ✓
Danube 		Дунай  dunay ✓ 
Delft 		Делфт  delftht  ✓
Denmark 		Дания  daniia 
Dnieper 		Днепр  dnepr  ✓
Dominican Republic 		Доминиканская Республика  dominikanskaia respublika ✓
Don Juan 		бабник  babnik ?/
Dublin 		Дублин  dublin  ✓

East 		восток  vostok Veast! <<

Egypt 		Египет  egipet  ✓
England 		Англия  angliia  ✓
English 		английский  angliyskiy  ✓
Englishman 		англичанин  anglichanin  ✓
Englishwoman 		англичанка  anglichanka  ✓
English Channel 		Ла‐Манш  la‐mansh << Isle of Man?
Esperanto 		эсперанто  aisperanto  ✓
Estonia 		Эстония  aistoniia  ✓
Ethiopia 		Эфиопия  aithiopiia  ✓
Europa 		Европа  evropa  ✓
Europe 		Европа  evropa  ✓

France 		Франция  Franssiia !!!
French 		французский  Fthranssuśskiy !!!

Friesland 		Фрисландия  Frislandiia  ✓
Gabon 		Габон  gabon  ✓
Gambia 		Гамбия  gambiia  ✓

Genesis 		книга Бытия  kniga bėitiia <<

Geneva 		Женева  ζeeneva  ✓
Genoa 		Генуя  genuia  ✓
Georgia 		Грузия  gruśiia ~✓

Germany 		Германия  germaniia  ✓
German 		немецкий  nemesskiy <<

Ghana 		Гана  gana  ✓
God 		Бог  bog  ✓
Great Britain 		Великобритания  veliko britaniia ✓ ! ver!
Greece 		Греция  gressiia ✓
Greenland 		Гренландия  grenlandiia  ✓
Guinea 		Гвинея  gvineia  ✓
Guinea Bissau 		Гвинея‐Бисау  gvineia‐bisau  ✓
Gulf of Finland 		Финский залив  Finskiy śaliv ?
Haiti 		Гаити  gaiti  ✓!
Hanoi 		Ханой  xanoy  ✓
Havana 		Гавана  gavana  ✓
Helsinki 		Хельсинки  xelsinki  ✓
Holland 		Голландия  gollandiia  ✓
Hook of Holland 		Хукван Холланд  xukvan xolland  ✓

Hungary 		Венгрия  vengriia ✓ !! VANgaria <<< !!!

Iceland 		Исландия  islandiia ✓
India 		Индия  indiia  ✓
Indian Ocean 		Индийский океан  indiyskiy okean ✓
Indonesia 		Индонезия  indoneśiia  ✓
Iran 		Иран  iran  ✓
Iraq 		Ирак  irak  ✓
Ireland 		Ирландия  irlandiia  ✓
Israel 		Израиль  iśrail  ✓
Italy 		Италия  italiia  ✓
Jamaica 		Ямайка  iamayka  ✓
Japan 		Япония  iaponiia ✓
Jordan 		Иордания  iordaniia  ✓
June 		июнь  iun  ✓ !
Kabul 		Кабул  kabul  ✓
Kazakhstan 		Казахстан  kaśaxstan  ✓
Kieff 		Киев  kiev  ✓
Kirghizia 		Киргизия  kirgiśiia  ✓
Korea 		Корея  koreia  ✓
Laos 		Лаос  laos  ✓
Latvia 		Латвия  latviia  ✓
Lebanon 		Ливан  livan  ✓
Leyden 		Лейден  leyden  ✓
Liberia 		Либерия  liberiia  ✓
Libya 		Ливия  liviia  ✓
Lisbon 		Лиссабон  lissabon  ✓
Lithuania 		Литва  litva  ✓
Liverpool 		Ливерпуль  liverpul  ✓
London 		Лондон  london  ✓
Luxemburg 		Люксембург  luksemburg  ✓
Madrid 		Мадрид  madrid  ✓
Maestricht 		Маастрихт  maastrixt  ✓
Malaysia 		Малайзия  malayśiia  ✓
Mali 		Мали  mali  ✓

Mediterranean 		Средиземное море  srediśemnoe more <<

Meuse 		Маас  maas  ✓
Mexico 		Мексика  meksika 
Mexico City 		Мехико  mexiko  ✓
Minsk 		Минск  minsk  ✓
Moldavia 		Молдавия  moldaviia  ✓
Monaco 		Монако  monako  ✓
Mongolia 		Монголия  mongoliia  ✓
Morse alphabet 		азбука морзе  aśbuka morśe ✓
Moscow 		Москва  moskva  ✓
Mozambique 		Мозамбик  mośambik  ✓
Nepal 		Непал  nepal  ✓
New York City 		Нью‐Йорк  nuv‐York 
New Amsterdam 		Нью‐Йорк  nuv‐hnork 
New York 		Нью‐Йорк  nuv‐hnork  ✓
Nicosia 		Никосия  nikosiia  ✓

North 		север  sever  Sibir! ✓ <<< +++

Oxus 		Амударья  amudaria ✓ !!
Persia 		Иран  iran ✓
Rhine barge 		баржа  barζea ?
Russia 		Россия  rossiia  ✓
Russian 		русский  russkiy  ✓
Sassenach 		англичанин  anglichanin ✓   (?)

Saturday 		суббота  subbota ✓

Sea of Laptev 		море Лаптевых  more laptevėix ✓
Soviet 		советский  sovetskiy ✓

Street of Dover 		Па‐де‐Кале  pa‐de‐kale <<

The Hague 		Гаага  gaaga ✓ :) LOL
US citizen 		американец  amerikaness ✓
Volga 		Волга  volga  ✓
White Russia 		Белоруссия  belorussiia ✓
Yalta 		Ялта  ialta  ✓
Yemen 		Йемен  hnemen  ✓
Yugoslavia 		Югославия  Yugoslaviia  ✓
Zaire 		Конго  kongo ✓

a 		в на  v na <<?

abattoir 		бойня  boynia banjo:bath

abdomen 		брюхо  bruxo  bronche? ~✓™
abdominal 		брюшной  brushnoy Brust++ ✓

aberration 		ошибка  oshibka 
able 		способный  sposobnėiy ~~ пособ : potent -
abide 		ждать подождать  ζedat ~ stay- podoζedat 
abortive 		бесполезный  bes.poleśnėiy unnüś,unnötig …

about 		о  o  ✓
above 		над  nad  nach,an+at,über    	ду́матьuv (над чем) nach-denken über etwas/jemand

abroad 		за границей  śa granissey  zu Grenze +++ <<

abscess 		абсцесс  absssess  ✓
absent 		отсутствующий  otsutstvuюschiy  otsut~absent +-
absolute 		безграничный беззаветный бескрайный беспредельный  беś-granichnėiy беś-śavetnėiy beskraynėiy bespredelnėiy 
absolutely 		абсолютно  absolutno  ✓

abstract 		забирать забрать  śabirat zu-führen … berühren ™ ... --

absurdity 		абсурд  absurd  ✓
abundance 		богатство  bogatstvo   bogota;) <<
abysmal 		безвыходный безнадёжный безысходный  беś-vėixodnėiy беś-nadёζenėiy беś-ėisxodnėiy 
abyss 		бездна  (a)беś-dna  ✓ - ?
academic 		академический  akademicheskiy ✓
academy 		академия  akademiia  ✓

ac- <> со- <> zu- !!
+++++++++++++++++
accede 		соглашаться  soglashatsia   (zustimmen) ?
accord 		согласие соответствие  soglasie sootvetstvie 
accordance 		согласие соответствие  soglasie sootvetstvie 
accompany 		сопровождать  soprovoζedat 

accent 		акцент  akssent  ✓
accept 		принимать  prinimat  << prendre? ✓ 
access 		атака  ataka ~✓ 
accident 		несчастный случай  neschastnėiy sluchay  
accommodation 		аккорд  akkord ~✓?
accomplishment 		акт  akt ✓ !! <<
accordion 		гармонь  garmon  ✓

account 		считать  schitat <> Giro? << 
accounting 		бухгалтерия  buxghalteriia ✓✓ ++ DE

accrue 		расти  rasti   (anfallen,auflaufen) ?/
accumulator 		аккумулятор  akkumuliator  ✓
accurate 		аккуратный  akkuratnėiy ✓

ache 		боль  bol << <> pain?

achieve 		делать сделать  delat sdelat ?
achievement 		акт  akt ✓

achromatic 		бесцветный  bes-svetnėiy des-schwarś+++ <<

ack‐ack 		зенитная артиллерия  śenitnaia artilleriia wtf?
acquire 		покупать купить  pokupat kupit << capture ✓ +
acquisitive 		алчный  alchnėiy  (habgierig) ?
acrobat 		акробат  akrobat  ✓
acrobatic 		акробатический  akrobaticheskiy  ✓

across 		поперёк  poperёk <> para!! << ✓
across from 		против  protiv  << ~✓

act 		акт  akt  ✓
action 		акт  akt  ✓
active 		активный  aktivnėiy ✓
activity 		активность  aktivnost  ✓   aktive-ness ++
actor 		актёр  aktёr  ✓
actress 		актриса  aktrisa  ✓
act of grace 		амнистия  amnistiia 
addled 		глумый  glumėiy  (verdorben)?
address 		адресовать  adresovat  ✓
adjutant 		адъютант  adhutant  ✓
administer 		администрировать  administrirovat  ✓
administration 		администрация  administrassiia  ✓
administrative 		административный  administrativnėiy  ✓
admiral 		адмирал  admiral  ✓
admiralship 		адмиральский  admiralskiy  ✓
admire 		восхищаться  vosxischatsia 
adore 		боготворить  bogotvorit 
advantageous 		полезный  poleśnėiy 
adventure 		авантюра  avantura  ✓
adventurous 		авантюрный  avanturnėiy  ✓

advertisement 		анонс  anons  ?
ad 		анонс  anons 

advice 		совет  sovet <<< Soviet = Rat!!

advocate 		адвокат  advokat  ✓
aerial 		антенна  antenna 	~✓!
aerodrome 		аэродром  aairodrom  ✓
aerolite 		аэролит  aairolit  ✓
aeronautical 		авиационный  aviassionnėiy  ✓ < aviation++
aeronautics 		авиация  aviassiia  ✓ < aviation++
aeroplane 		аэроплан самолёт  aairoplan✓  samolёt ?

affair 		дело  delo ?

affluent 		богатый  bogatėiy  << Bogota?
affluence 		богатство  bogatstvo 

afresh 		опять  opiat :) LOL!! <<< ~afresh
again 		опять  opiat <<< </>opposite

against 		против  protiv  ~ <<

after 		за  (a)śa  <<

afternoon 		пополудни  popoludni ??

age 		возраст  vośrast ??? <<<

agency 		агентство  agentstvo ✓
agent 		агент  agent  ✓
aggression 		агрессия  agressiia  ✓
aggressive 		агрессивный  agressivnėiy  ✓
aggressor 		агрессор  agressor  ✓
aggro 		агрессия  agressiia ✓
agrarian 		аграрный  agrarnėiy  ✓

agree 		соглашаться  soglashatsia  << zu-stimmen ~~✓
agreement 		согласие соответствие  soglasie sootvetstvie 

agricultural 		аграрный  agrarnėiy ✓
agriculture 		агрономия  agronomiia ✓
agriculturist 		агроном  agronom  ✓
agronomics 		агрономия  agronomiia  ✓

agricultural labourer 		батрак  batrak <<
agricultural worker 		батрак  batrak 


aide‐de‐camp 		адъютант  adhutant ƒ?

ailment 		болезнь  boleśn  << balsam
ailing 		болезненный  boleśnennėiy 

aim 		цель  ssel   <<> bomb shells! 
aimless 		бесцельный  bes-ssel-nėiy 

air‐balloon 		аэростат  aairostat ~✓

air 		воздух  vośdux  <<<<<<<<<  <> vends-duct bos:ox!!
airless 		безветренный  беś--vetrennėiy  des-ventre-ny  <> vetrenär??

aircraft 		аэроплан самолёт  aairoplan✓ samolёt ? <<
airplane 		аэроплан самолёт  aairoplan samolёt 
airdrome 		аэродром  aairodrom  ✓
airfield 		аэродром  aairodrom ✓
airline 		авиалиния  avialiniia  ✓
airmail 		авиапочта  aviapochta ✓ <3 ++
airport 		аэродром  aairodrom  ✓
airway 		авиалиния  avialiniia ✓
air force 		авиация  aviassiia ✓ aviation

alarm 		будильник  budilnik << ?
alarmclock 		будильник  budilnik   <> bell?

alas 		к сожалению  k soζealeniю ?
albino 		альбинос  albinos  ✓
album 		альбом  albom  ✓
alcohol 		алкоголь  alkogol  ✓
alcoholic 		алкоголический алкогольный  alkogolicheskiy alkogolnėiy ✓
alcoholism 		алкоголизм  alkogoliśm  ✓
algebra 		алгебра  algebra  ✓
algebraic 		алгебраический  algebraicheskiy ✓

alien 		иностранный  inostrannėiy   1) ¬nosta 2) in.austral ?? <<

altitude 		высота  vėisota << ™
<!>
all 		всё  vsё  <<<<<<<<
altogether 		всё  vsё 
always 		всегда  vsegda 
all the 		все каждый  vse kaζedėiy 
all of a sudden 		вдруг  vdrug 

all over again 		опять  opiat ~ over << ^^!

allow 		пускать пустить  puskat pustit <> potent ~~✓-
almost 		почти  pochti  fast++ <<<
alms 		милостыня  (a)milostėinia  << 

alone 		один  odin  << 1 ✓

along 		мимо  mimo << among mit simil EG!! <<< +++
among 		между  meζedu <<<> ~~mit (✓) 

also 		также тоже  takζee toζee  <<<
already 		уже  uζee  <<> yet ~~✓ -
although 		хотя  xotia <<

alphabet 		азбука алфавит  acbuca alphavit ✓
alphabetical 		азбучный  aśbuchnėiy ✓
altar 		алтарь  altar  ✓

aluminium 		алюминий  aluminiy  ✓
aluminum 		алюминий  aluminiy  ✓
ambition 		амбиция  ambissiia  ✓
ammonia 		аммиак  ammiak  ✓
amnesty 		объявить амнистию  obhiavit amnistiю ✓
amphibian 		амфибия  ampthibiia  ✓ <<  ф Ptheben MIX!
amphibious vehicle 		амфибия  amphibiia  ✓
amputate 		ампутировать  amputirovat  ✓
amputation 		ампутация  amputassiia  ✓
analogous 		аналогичный  analogichnėiy 
analogy 		аналогия  analogiia  ✓
analyse 		анализировать  analiśirovat  ✓
analysis 		анализ  analiś  ✓
analytic 		аналитический  analiticheskiy ✓
analytical 		аналитический  analiticheskiy ✓ 
anarchic 		анархический  anarxicheskiy ✓
anarchical 		анархический  anarxicheskiy ✓ 
anarchism 		анархизм  anarxiśm  ✓
anarchist 		анархический  anarxicheskiy  ✓
anarchy 		анархия безначалие  anarxiia✓ беś-nachalie <<
anatomical 		анатомический  anatomicheskiy ✓
anatomist 		анатом  anatom  ✓
anatomy 		анатомия  anatomiia  ✓
anchovy 		анчоус  anchous  ✓     -ус -vys! -ous -us

and 		а и  a i  ✓ <<

anecdote 		анекдот  anekdot  ✓

anew 		опять  opiat  ^^

any 		кто‐то  kto‐to <> EG !!! <<<< ++?????????????????
anybody 		кто‐то  kto‐to 
another 		другой  drugoy  <> EG?

anise 		анис  anis  ✓
annexation 		аннексия  anneksiia  ✓
anonymous 		безымянный  beś-ėimiannėiy  <<< +?
answer 		отвечать ответить  otvechat otvetit 
antelope 		антилопа  antilopa  ✓
antenna 		антенна  antenna  ✓
anthracite 		антрацит  antrassit  ✓
anti‐aircraft guns 		зенитная артиллерия  śenit!naia artilleriia  ✓   зенит Zenit!
apartment 		квартира  kvartira  ✓
apathetic 		апатичный  apatichnėiy  ✓
apathy 		апатия  apatiia  ✓
ape 		обезьяна  oбеś-iana @ Abbessinia!!! <<< ++ Obo vs Ono ! 
apostle 		апостол  apostol  ✓
apparatus 		аппарат  apparat  ✓
appeal 		апеллировать  apellirovat ✓ !!!
appeal to 		апеллировать к  apellirovat✓ k 
appellation 		имя  imia ?? <<
appetite 		аппетит  appetit  ✓

apple‐tree 		яблоня  iablonia ✓ !!! apple<>diabol!!! <<<
apple 		яблоко  iabloko   ✓ !!! apple<>diabol!!! <<<

apprehension 		арест  arest ✓
approximately 		приблизительно примерно  pribliśitelno??? primerno ~~✓?
apricot 		абрикос  abrikos  ✓
aquarium 		аквариум  akvarium  ✓
arbiter 		арбитр  arbitr  ✓
arbitration 		арбитраж  arbitraζe  ✓
arbitrator 		арбитр  arbitr  ✓
arc 		арка  arka  ✓
arch 		арка  arka  ✓
archaeological 		археологический  arxeologicheskiy ✓
archaeologist 		археолог  arxeolog  ✓
archaeology 		археология  arxeologiia  ✓
archbishop 		архиепископ  arxiepiskop  ✓
archipelago 		архипелаг  arxipelag  ✓
architect 		архитектор  arxitektor  ✓
architectonic 		архитектурный  arxitekturnėiy  ✓
architectural 		архитектурный  arxitekturnėiy  ✓
architecture 		архитектура  arxitektura  ✓
archive 		архив  arxiv  ✓
archives 		архив  arxiv  ✓
archivist 		архивариус  arxivarius  ✓
arena 		арена  arena  ✓
argument 		аргумент  argument  ✓
aristocracy 		аристократия  aristokratiia  ✓
aristocrat 		аристократ  aristokrat  ✓
aristocratic 		аристократический аристократичный  aristokraticheskiy aristokratichnėiy 
arithmetic 		арифметика  arithmetika  ✓   <> rift

arm 		рука  ruka  <<<<<<<<<<<<<<<< !?
army 		армия военные войско  armiia✓ voennėie voysko ?? __ <<

armature 		арматур  armatur  ✓
armchair 		кресло  kreslo ?
armoury 		арсенал  arsenal  ✓
aroma 		аромат  aromat  ✓
aromatic 		ароматический ароматичный  aromaticheskiy aromatichnėiy ✓
arouse 		разбудить  raśbudit  raise✓budit??
arrest 		арест  arest  ✓
arrested person 		арестант  arestant ✓

arrival 		приезд приход  prieśd prixod <<<<> proxim?
arrive 		прибыть прибывать  pribėit pribėivat 

arsenal 		арсенал  arsenal  ✓
arteriosclerosis 		артериоклероз  arteriokleroś  ✓
artery 		артерия  arteriia  ✓
article 		артикль  artikl  ✓
artillery 		артиллерия  artilleriia  ✓
artilleryman 		артиллерист  artillerist  ✓
artist 		артист  artist  ✓
artistic 		артистический  artisticheskiy ✓

<<<<<<<<<<<<<<<<<<<<<<<<<<<<<<<<<<<<<<<<<<<
as 		как  kak  ✓ <<
as if 		будто  budto 
as though 		будто  budto 
at 		в к на  v k na 


ascend 		подниматься подняться  podnimatsia podniatsia <<< pod + airpod !!! <<<
ask 		спрашивать спросить  sprashivat sprosit  <> sprechen!! <<< +++

asbestos 		асбест  asbest  ✓
ascetic 		аскетический  asketicheskiy ✓
asphalt 		асфальтировать  asphaltirovat ф ✓
assailant 		агрессор  agressor ✓
assault 		атаковать  atakovat ✓  attack!!
assembly 		ассамблея  assambleia  ✓
assimilation 		ассимиляция  assimiliassiia  ✓
assistant 		адъюнкт  adhunkt <<
association 		ассоциация  assossiassiia  ✓
aster 		астра  astra  ✓
asthma 		астма  astma  ✓
asthmatic 		астматический  astmaticheskiy ✓
astrology 		астрология  astrologiia  ✓

atheism 		атеизм  ateiśm  ✓
atheist 		атеист безбожник  ateist / беś-boζenik?
athlete 		атлет  atlet  ✓
athletic 		атлетический  atleticheskiy ✓
athletics 		атлетика  atletika  ✓
atlas 		атлас  atlas  ✓
atmosphere 		атмосфера  atmosphera atmosthera!!  ✓   out-most-terra atmo-sphere !! << ++-++
atmospheric 		атмосферический атмосферный  atmosthericheskiy atmosthernėiy ✓
atom 		атом  atom  ✓
atomic 		атомный  atomnėiy  ✓
atomic theory 		атомистика  atomistika  ✓
atom bomb 		атомная бомба  atomnaia bomba  ✓
attaché 		атташе  attashe  ✓
attack 		атаковать  atakovat ✓
attacker 		агрессор  agressor ✓

attend 		посещать посетить  poseschat posetit  <<  pro.sit?
at home 		дома  doma  ✓ +++++ EN!!! => Greek => *

at present 		теперь  teper  <<
at that place 		там  tam  da~ ✓ <<
auction 		аукцион  aukssion  ✓
audience 		аудитория  auditoriia 
auditory 		аудитория  auditoriia  ✓
aunt 		тётя  tёtia  Tante ++
author 		автор  avtor  ✓
authority 		авторитет  avtoritet  ✓
autobus 		автобус  avtobus  ✓
autogenous 		автогенный  avtogennėiy  ✓
automate 		автоматизировать  avtomatiśirovat 
automatic 		автоматический  avtomaticheskiy 
automoton 		автомат  avtomat  ✓
autonomic 		автономный  avtonomnėiy  ✓
autonomous 		автономный  avtonomnėiy  ✓
autonomy 		автономия  avtonomiia  ✓
autumn 		осень  osen  ~✓ - <<
avant‐garde 		авангард  avangard  ✓
avenue 		аллея  alleia ✓
aversion 		антипатия  antipatiia ✓
aviation 		авиация  aviassiia  ✓

await 		ждать подождать  ζedat podoζedat  <<<
awaken 		разбудить  raśbudit  ¬raśen :) <<

awkward 		аляповатый  aliapovatėiy   alien?<<

bad 		плохой  ploxoy <<
badly 		плохо  ploxo 

badger 		барсук  barsuk  ✓
baggage 		багаж  bagaζe  ✓

bairn 		ребёнок  rebёnok  (das Kind?)  bёn~bairn~bin=son! <<
barn 		будка  budka  Bude ~✓

baker 		булочник  bulochnik  ?
balance sheet 		баланс  balans  ✓
balcony 		балкон  balkon  ✓
ball 		бал  bal  ✓
ballet 		балет  balet  ✓
balloon 		аэростат  aairostat ~✓
bamboo 		бамбук  bambuk  ✓
banana 		банан  banan  ✓
bandage 		бандаж  bandaζe  ✓
bank 		банк  bank  ✓
bankruptcy 		банкротство  bankrotstvo  ✓
bank clerk 		банкир  bankir  ✓
bank official 		банкир  bankir  ✓
bar 		батон  baton  ~✓?-

barefoot 		босикомой  bosikomoy <<

barge 		баржа  barζea  ✓
barium 		барий  bariy  ✓
bark 		брехать  brexat ~✓-
barometer 		барометр  barometr  ✓
barren 		бесплодный  besplodnėiy 
barricade 		баррикадировать  barrikadirovat 
barrier 		барьер  barer  ✓
barrister 		адвокат  advokat  ✓
base 		базировать  baśi✓rovat?
basin 		бассейн  basseyn  ✓
bass 		бас  bas  ✓
bass voice 		бас  bas ✓
bathroom 		баня  bania ✓! <<
baths superintendant 		банщик  ban✓schik!? <<
battalion 		батальон  batalon  ✓
battery 		аккумулятор  akkumuliator ✓

battle‐ 		боевой  boevoy ~✓ <<
battle 		боевой  boevoy 

bay 		бухта  buxta  Bucht ✓
bazaar 		базар  baśar  ✓
be 		быть  bėit ✓!!! bist/seid
bead 		бусина  busina ~✓
beam 		балка бревно брус  balka[n]✓ brevno brus?
bean 		боб  bob  ✓? ;)
beard 		борода  boroda  ✓
beat 		бить  bit  ✓
beaver 		бобровый  bobrovėiy  ~✓

beautiful 		красивый  krasivėiy  <<< ! сивый ~ schönfair!! <<<<<


because of 		из‐за  iś‐śa  <<

become 		бытовать  bėitovat ~~✓ <<
bed 		постель  postel <<+?
bedroom 		спальня  spalnia ?

beech 		бук  buk  ✓
beefsteak 		бифштекс  bifshteks  ✓


behind 		за  śa <<
behold 		вот  vot  voiet! ✓ <<

beginning 		начало  nachalo <<<?
below 		внизу  vniśu <<?
beside 		около у  okolo u <<?
beyond 		поперёк  poperёk <<?
<<<<<<<<<<<<<<<<<

between 		между  meζedu  ✓  mitween mitten imbetween !! AMBI <<

better 		лучше  luchshe << lux?
best 		лучший  luchshiy 

belly 		брюхо  bruxo ~~ Brust ✓ << 

be able to 		мочь  moch   << macht +

be acquainted with 		знать  śnat ~~~ beCannt -- ?

be afraid of 		бояться побояться  boiatsia poboiatsia  phobie++ ✓
be alive 		жить прожить  ζeit proζeit  <<< seiet!
be called 		называться назваться  naśėivatsia naśvatsia  << (sch)natter!
be obstinate 		артачиться  artachitsia 
be stubborn 		артачиться  artachitsia 
be willing to 		хотеть захотеть  xotet śaxotet <<?

big 		большой  bolshoy ✓ !!! bolshevik? <<<
bible 		библия  bibliia  ✓
bill 		билет  bilet  ✓
billiards 		бильярд  biliard  ✓
binoculars 		бинокль  binokl  ✓
birch 		берёза  berёśa ~✓
bishop 		архиерей  arxierey  ArchHiery! ✓ <<

black 		чёрный  chёrnėiy  char coal chermn khem!! << <>
blue 		синий  siniy cyan! ++ ✓ <<
blueberry 		черника  chernika <- cyan

blank 		белый  belėiy  ✓    й : ink->ing->yny->y ! ++

blasphemy 		богохульство  bogoxulstvo ?
bless 		благословлять благословить  blagoslovliat blagoslovit ?
blessing 		благословение  blagoslovenie ?

blockade 		блокада  blokada  ✓
blond 		белокурый  belokurėiy   bello blank-hair! << 
blouse 		блуза  bluśa  ✓

blunt 		тупой  tupoy ?
blush 		алеть багроветь  alet bagrovet ?
blushing 		красный  krasnėiy ?
board 		забирать забрать  śabirat śabrat  the'board;) << ✓? ;)
boat 		лодка  lodka  lodge:wood?  <<

body 		тело туловище  telo tulovische << Teil?

bomb 		бомба  bomba  ✓
bone 		кость  kost  keras?
book‐keeper 		бухгалтер  buxgalter BuchHalter !! ✓ DE <3
book‐keeping 		бухгалтерия  buxgalteriia 

book 		книга  kniga  'Knigge' <3 ✓? ;)   Knick vs Buchs-Busch!! <<<

bookcase 		книжный шкаф  kniζenėiy shcathe / shcover <<!
bookshop 		книжный магазин  kniζenėiy magaśin 
bookstore 		книжный магазин  kniζenėiy magaśin 

boon 		благословение  blagoslovenie   ¬Plage! <<

borax 		бура  bura  ✓
bore 		буравить  buravit ✓
boron 		бор  bor  ✓
boss 		капитан  kapitan ✓
botany 		ботаника  botanika  ✓

both 		оба обе  oba obe ~~✓ <<+? o'beide

bottle 		бутылка  butėilka ✓
boulevard 		бульвар  bulvar  ✓
bourgeois 		буржуазный  burζeuaśnėiy ✓
bourgeoisie 		буржуазия  burζeuaśiia ✓
boutique 		магазин  magaśin ✓
bow 		арка  arka ✓ !
box 		боксировать  boks✓irovat?
boxer 		боксёр  boksёr  ✓
brace 		арматур  armatur ✓
bracelet 		браслет  braslet  ✓
braille 		азбука для слепых  aśbuka dlia slepėix ??

brain 		мозг  mośg <<< mośen;) ?? Moskau~capital !?! <<<<
bridge 		мост  most <<< ?  pons@brain

broad 		широкий  shirokiy <<?? <>
 spread?
brave 		бравый  bravėiy  ✓
breach 		брешь  bresh  ✓
bread and butter 		бутерброд  buterbrod ✓

brigade 		бригада  brigada  ✓
bring along 		забирать забрать  śabirat śabrat ~~ zu-bringt <<
bronze 		бронзовый  bronśo✓vėiy ✓
brother 		брат  brat  ✓
brow 		бровь  brov  ✓
buffalo 		буйбол  buybol  ~✓ !! <<

buffer 		буфер  bufher  ✓
bumper 		буфер  buffer  ✓ ++

building 		здание  śdanie <<?
burdensome 		тяжёлый  tiaζeёlėiy ?
busy 		заниматься  śanimatsia s'animated ~✓

buffoon 		арлекин  arlekin ✓
bull 		бык  bėik  ✓
buoy 		буй  buy  ✓
bus 		автобус  avtobus ✓

business 		дело  delo sell! tell? <<  ✓/2
business deal 		дело  delo 
case 		дело  delo  <<^^

but 		а  a  ✓ allo aber
by 		около у  okolo u  "à" <<
by now 		уже  uζee  : as(of now) ~~ ✓ <<

butterfly 		бабочка  babochka  ~~ <<
button 		бутон  buton  ✓
buy 		покупать купить  pokupat kupit kaufet ✓~! << 

cabinet 		шкаф  shkath shcabhe шcover !!  шcabi.net <<
closet 			шкаф  shkath  шcover 


call 		называть назвать  naśėivat naśvat (sch)natter <<<
caller 		посетитель  posetitel ?
call on 		посещать посетить  poseschat posetit ??

can 		банка  banka  '✓' <<< permute + ___ ???  ban=do ka[n]=work !<<

canal 		канал  kanal  ✓
candidate 		аспирант  aspirant  ✓
canoe 		байдарка  baydarka ?
canteen 		баклага  baklaga ?
capable 		способный  sposobnėiy ??
car 		автомашина автомобиль  avtomashina avtomobil ✓
card 		карта  karta  ✓
carpet 		ковёр  kovёr ✓ !
castle 		башня  bashnia  ~ bastion? ✓?

chasm 		бездна  беś-dna  <> <<
catastrophe 		беда бедствие  beda bedstvie   BAD✓__?
catastrophic 		бедственный  bedstvennėiy 
chaos 		беспорядок  besporiadok <<< ^^   hesperion?
chaotic 		беспорядочный  besporiadochnėiy 

catch 		бить ударить  bit udarit  featch ___? 
caviar 		икра  ikra -

century 		век  vek  ??   ≠ hundred 		сто  sto
centennial 		век  vek 

certificate 		акт  akt[e] ✓ 
chair 		стул  stul ✓
chamber 		комната  komnata ✓
channel 		канал  kanal  ✓
charity 		милостыня  milostėinia  <> mild? <<
cheap 		дешёвый  deshёvėiy ~ decheap <<

cheat 		бестия  bestiia bestechen baschik <<<

cheese 		сыр  sėir ~~ -
chemist 		аптекарь  aptekar  apotheker ✓
chemist's shop 		аптека  apteka apotheke ✓
chief 		капитан  kapitan ✓
child 		ребёнок  rebёnok ✓ bin:Bengel! rebe vs rabbi! vs REN! rein:  young, fresh   𓂋  𓈖  𓊪  𓅱 𓆶  𓏝 
childless 		бездетный  беś-detnėiy ^^?

choose 		выбирать выбрать  vėibirat vėibrat  <<
chord 		аккорд  akkord  ✓
chorus 		хор  xor  ✓
chunk 		булка  bulka  ✓
cigarette 		папироса сигарета  papirosa sigareta ✓
cinema 		кино  kino  ✓
circle 		ассоциация  assossiassiia ~✓ ƒ
city 		город  gorod KurOrt qvart ✓✓✓ !!! +++
class 		класс  klass  ✓
climate 		климат  klimat  ✓

clean 		чистый  chistėiy   chysm? <<
clear 		яркий  iarkiy <<
clergyman 		батюшка  batюshka /
client 		покупатель  pokupatel ?
climb 		подниматься подняться  podnimatsia podniatsia  pod+___ <<
clippings 		брак  brak  ?
clock 		часы  chasėi ~? -- 
clod 		булка  bulka ?
clothe 		одевать одеть  odevat odet ~-
cloud 		облако  oblako <> opaque? 
coarse 		аляповатый  aliapovatėiy 

coast‐ 		береговой  beregovoy 
coast 		береговой  beregovoy 
coastal 		береговой  beregovoy 

close 		закрывать закрыть  śakrėivat śakrėit zu-greifen ++ ✓ <<<!
club 		клуб  klub  ✓
coir 		хор  xor  ✓
collect 		собирать собрать  sobirat sobrat 
college 		лекция  lekssiia ✓ ++

colony 		аул  aul << alle?

come about 		бытовать  bėitovat << +?
come into 		входить войти  vxodit voyti for__<<

command 		приказ  prikaś 
commencement 		начало  nachalo 
concord 		аккорд согласие соответствие  akkord soglasie sootvetstvie /
concurrence 		согласие соответствие  soglasie sootvetstvie 
confront 		артачиться  artachitsia 

competition 		матч  match  Messen,Maś <3 ✓? <<
contest 		матч  match Maś ✓

concerning 		о  o  à ++ ✓    <> but

concert 		концерт  konssert  ✓
concrete 		бетон  beton ✓
condemn 		браковать  brakovat ?
confiscate 		наложить арест на  naloζeit? arest✓ na 
conifer forest 		бор  bor <> boreal wald
consent 		соглашаться  soglashatsia  ?
consider 		считать  schitat ? 
container 		бак  bak  box ✓

continuous 		безостановочный бесперебойный  беś-ostanovochnėiy bespereboynėiy 
contented 		довольный  dovolnėiy  <
contour 		абрис  abris  Abriss? <
copyright 		авторское право  avtorskoe pravo  author-privacy? << + ✓/2
corner 		угол  ugol Eche/angle! ✓✓ <<<
corps 		армеецкорпус  armeesskorpus ✓
correct 		правильный  pravilnėiy ?? <<
cost 		стоить  stoit  ~✓-
costly 		дорогой  dorogoy ?
counsel 		адвокат  advokat ✓
count 		считать сосчитать  schitat soschitat zusam sysy.tat? << 
countless 		бесчисленный  beschislennėiy des-^^ 

country 		деревня  derevnia 
countryside 		деревня  derevnia 

courageous 		бравый  bravėiy ✓
course 		блюдо  bluido plaś ✓
cramp‐iron 		арматур  armatur ✓~ ;) 

crazy 		безумный  беś-umnėiy 
craziness 		безумство  беś-umstvo 
crook 		бестия  bestiia ✓
crude 		аляповатый  aliapovatėiy ^^

cry 		плакать заплакать  plakat śaplakat ?

cupboard 		шкаф  shcaph-board   !!! <<<

current 		актуальность  aktualnost ✓
customer 		покупатель  pokupatel ?
cuttings 		брак  brak ?
daily paper 		газета  gaśeta ✓
dance 		бал  bal  ✓
dark 		тёмный  tёmnėiy <> khemni  khe*min(2) !!!!!!!!!!!!!!!!!! <<<<<<<<<<<<<<<
date 		число  chislo ?? <
dear 		дорогой  dorogoy ~ dear✓ogay~
decide 		решать решить  reshat reshit  ~ desheid ✓✓ <3

deem 		смотреть посмотреть  smotret posmotret  pense.ma-treat as ✓/2 ~~++--

defence 		арьергард  arer?gard✓  arier-guard?

descend 		спускаться спуститься  spuskatsia spustitsia 
description 		описание  opisanie epi-/be-sanie ??
design 		план  plan ✓
diagram 		план  plan ✓ 
desire 		желать пожелать  ζeelat poζeelat ?
desperate 		безвыходный беś-vėixodnėiy   bes-verxoid ~ desperate -
desperate безнадёжный безысходный   беś-nadёζenėiy беś-ėisxodnėiy 
detention 		арест  arest ✓
device 		аппарат  apparat ✓ 

devil 		бес  bes  ✓ "ANTI"  <> Bes God @ EG? <<
divine 		божеский божественный  boζeeskiy boζeestvennėiy tvennėiy~devine ??? <<<<

diamond 		алмаз  almaś <<
dictionary 		словарь  slovar <<
dim 		тёмный  tёmnėiy ~✓
dining‐room 		столовая  stolovaia 
diploma 		акт  akt ✓
director 		директор  direktor  ✓
disapprove 		браковать  brakovat ?
disapprove of 		браковать  brakovat 
disease 		болезнь  boleśn 
dish 		блюдо  bluido : plate✓
dislike 		антипатия  antipatiia ✓
dispose of 		продавать продать  prodavat prodat ✓? <<
dissect 		анатомировать  anatomirovat ✓
distinct 		яркий  iarkiy  dia_? << -
do 		делать 	delat  <<<
do		сделать  sdelat 
doctor 		врач доктор  vrach doktor ✓
document 		акт  akt ✓
dog 		собака  sobaka << 
door 		дверь  dver  ✓
doubt 		сомневаться усомниться  somnevatsia usomnitsia  ~✓? <<
down 		вниз  vniś <<
downstairs 		внизу  vniśu ^^
dress 		одевать одеть  odevat odet <> adret? <
drill 		буравить  buravit ✓ bohr
drivel 		брехать  brexat ( Blödsinn ) /
drink 		пить выпить  pit vėipit <<
drugstore 		аптека  apoteka ✓ 
drum 		барабан  baraban ! ONO

during 		за пока  śa poka <<
early 		рано  rano  << RA.an raise

dwell 		жить пожить  ζeit poζeit wohnZelt? Zeiten? <<

each 		все каждый  vse kaζedėiy  all <<
eager 		алчный  al.chnėiy djini? << 
east 		восток  vostok vosten vs vesten!! <<
easy 		лёгкий  lёgkiy <> leasyr 
eel 		угорь  ugor /
eight 		восемь  vosem ! 1?+7 ! past-7?
elder 		бузина  buśina <<
elect 		выбирать выбрать  vėibirat vėibrat 
elements 		азбука алфавит  aśbuka althavit  ≠ ABC WTF!
elephant 		слон  slon !! cylon schlange Nase <<

else 		другой  drugoy 

encourage 		бодрить  bodrit  be-druit…?

end 		конец  koness kend:kante+ness !!
ending 		конец  koness 

end up 		прибыть прибывать  pribėit pribėivat  <<
engineer 		инженер  inζeener  ✓
enter 		входить войти  vxodit voyti <<
enterprise 		завод  śavod 
equilibrium 		баланс  balans ✓
equipment 		аппаратура  apparatura ✓
error 		ошибка  oshibka <<

estate 		ферма  perma / therma  terr.ma !!<<

esteem 		считать  schitat ✓ schäśen 

even 		даже  daζee ?
evening meal 		ужин  uζein ?
ever 		всегда  vsegda ? [all]гда

everything 		всё  vsё  ??? <<< <> all vs bes=des-… wholes
everlasting 		бесконечный бескрайный  beskonechnėiy beskraynėiy ?
every 		все каждый  vse kaζedėiy 
everybody 		все каждый  vse kaζedėiy 
every one 		все каждый  vse kaζedėiy 

exact 		правильный  pravilnėiy ?

excise 		акциз  akssiś ✓ exzidieren (schliśen) ++?
excise‐duty 		акциз  akssiś besteuern <> Aktien?? ^^

exclusively 		только  tolko  ?
exercise‐book 		тетрадь  tetrad  4-square-📕	✓
exercise 		упражнение  upraζenenie  +++ <<< упражнение uprа.ghne* Übung Überung

expect 		ждать подождать  ζedat podoζedat  profezeiht!?! <<<

expensive 		дорогой  dorogoy <> way too reich? 

eye 		глаз  gloś  ✓✓✓ LOL! <<
eyebrow 		бровь  brov  ✓
facile 		лёгкий  lёgkiy  leicht✓ ! ++

fact 		факт  fakt  ✓
factory 		фабрика завод  Fabrika śavod 
farm 		ферма  Ferma Perma therma terr! <<<

fade(v.2) 		белеть бледнеть  belet blednet (über)blenden ✓
failure 		банкротство  bankrotstvo  ✓ ;)
fair 		базар  baśar 
family 		семья  semia  ✓
farm‐ 		аграрный  agrarnėiy ✓
farmer 		арендатор  arendator ^^?
farm out 		сдавать в аренду  sdavat v arendu 

fast 		быстрый  bėistrėiy  fėist fast +++<<

father 		отец  (v)oteц !! <<<<<<  EARLY CORRUPTION!?:(  ATAF@EG!!! 

fear 		бояться побояться  boiatsia phoboiatsia ✓
feather 		перо  pero   *фeро abero weather apropos!! <<<

female 		бабий  babiy ;) <3 !!! <<<

female student 		студентка  studentka ✓
field 		поле  pole  ✓
files 		архив  arxiv ✓
fight 		бороться  borotsia  war… Borussia:))) <<<

find 		находить найти  naxodit nayti  <<<?? EG?

fine 		красивый  krasivėiy krass ~✓?

first name 		имя  imiaя имя:nomer "Reim" <<<<!!!! EG

first 		первый  pervėiy   per.vyek first ~~~ << <> private 1.polit
firstly 		сначала  snachala 
first of all 		сначала  snachala <<<??
five 		пять  piat  ✓
flask 		баклага  baklaga  baglasche flask ~✓!<<
flat(n.) 		квартира  kvartira quartier ✓
flavour 		аромат  aromat ✓
flea 		блоха  bloxa  ✓
flee 		бежать  beζeat = run ^^ √pods feś,fetz
float 		плавать  plavat  ✓
folder 		тетрадь  tetrad  4?<<
fool 		болван  bolvan << <3 fool.van
foolish 		глумый  glumėiy 
foot 		нога  noga  ?
for 		за śa zu ✓
for			пока  poka ~~ for <<???
foreign 		иностранный  in.ostran.nėiy <> austral!? <<
forest 		лес  [fo]les  ✓? lín:林 Corrupt?
forgetful 		беспамятный  bes.pamiat.nėiy  des.formiert vs in.formiert <<<
fork 		вилка  vilka ~~✓/3
form 		анкета бланк  anketta(inquiry) / blank ✓
for sake of 		из‐за  iś‐śa  ~~ as-so ✓??
fountain‐pen 		авторучка  avto-ruchka ?
four 		четыре  chetėire  ✓
fragrant 		ароматический ароматичный  aromaticheskiy aromatichnėiy ✓
free 		безвозмездный бесплатный  беś-vośmeśdnėiy bes-platnėiy ¬platt

friend 		друг  drug;) drost,dost=2  <<! trag?

fright 		боязнь  boiaśn 
frindge 		бахрома  baxroma 
furious 		бешеный  beshenėiy <<
future 		будущий  buduschiy ✓ ;) <<!?
gain 		барыш  barėish bereich[ern]!! DE <3 <<<
gaol 		тюрьма  turma ✓
gap 		брешь  bresh[ung] ✓

garden 		сад  sad  ✓  садin: green gardin!! <<< vs >>> guard ROOT!?!

gasolene 		бензин  benśin  ✓
gasoline 		бензин  benśin  ✓
gather 		собирать собрать  sobirat sobrat собир~gather
gazette 		газета  gaśeta  ✓
get 		прибыть прибывать  pribėit pribėivat pro-bet √~ bėit:grow
get off 		спускаться спуститься  spuskatsia spustitsia 
girder 		балка бревно брус  balka brevno brus ?
girl 		девушка  devushka  de-bursche?  ‎-ушка -uška:minUscule! klein
girl 		девушка 𓏏𓏏 𐌳𐌰𐌳𐌳𐌾𐌰𐌽 daddjan “suckle” 𒋼𒂊𒋫𒀭 teetaan धयति dháyati  դիեմ diem
give 		давать дать  davat dat  ✓
gloss 		блеск  blesk  ✓
go 		идти пойти ехать поехать  poyti poexat exat idti™  podi,ex-audit  ✓
goal 		цель  ssel  ~~✓
god 		бог божество  bog boζeestvo BIG bigga ✓ @Persia
gold 		золотой  śolotoy gholode ✓
golden 		золотой  śolotoy gholode ✓
good 		хороший  xoroshiy <<
gossip 		бабьи сказки  babi skaśki 
government 		правительство  pravitelstvo 1. PROvto…  2. pRight! пра́вый • (právyj) right hand
go down 		спускаться спуститься  spuskatsia spustitsia --
go for a walk 		гулять погулять  guliat poguliat --
go in 		входить войти  vxodit voyti …audit <<
go up 		подниматься подняться  podnimatsia podniatsia √pod   ✓
gram 		грамм  gramm  ✓
grammar 		грамматика  grammatika  ✓
gramme 		грамм  gramm  ✓
grandmother 		бабушка  babushka/mamushka  ✓
gratitude 		благодарность  blagodarnost 
greedy 		алчный  alchnėiy Al.Knauser? al̂kans “greedy, hungry” sober
greyhound 		борзая  borśaia 
great 		большой  bolshoy !! bolshevik <<< poly
grow 		бытовать  bėitovat beith:baut <> высота <<
gulf 		бездна  беś-düna Bucht? abyss *dʰubno:deep +- ✓
gunner 		артиллерист  artillerist  ✓
half 		половина  polovina <<
hall 		зал  śal  ✓
ham 		ветчина  vetchina ~flesh:basar? 
hand 		рабочий  rabochiy  !!!!<<<<
handsome 		красивый  krasivėiy 
happen 		бытовать  bėitovat 
harp 		арфа  'arpha ✓
harsh 		аляповатый  aliapovatėiy 
hat 		шляпа  shliapa Schlapphut <3 ✓?
have 		получать получить  poluchat poluchit 
have to 		должен  dolζeen ~dois <<<
he 		он  on  ✓
health 		здоровые  śdorovėie << Esther/sante? ♀/𓋹
heaven 		небо  nebo !! 𓋞Nobel-Nebel-Narbe-Nepumuk? @SUMER <<<
heavy 		тяжёлый  tiaζeёlėiy <<<
height 		высота  vėisota ™™ <<< <> бугор:berg?
hell 		ад  ad --
helpless 		беззащитный беспомощный  беś-śa.schitnėiy bes.pomoschnėiy 
her 		она  ona  ✓
here are 		вот  vot voisi!✓ what 
here is 		вот  vot voisi!✓ what
high 		высокий  vėisokiy ™ <<<
hill 		бугор  bugor ~ Berg!
him 		он  on  ✓
hip 		бедро  bedro @bed;) ///
hippo 		бегемот  begemot  !! ~✓
hippopotamus 		бегемот  begemot !! ~✓ 
hire 		аренда  arenda @agenda? <<
history 		история  (h)istoriia  ✓
hit 		бить ударить  bit udarit √bat  драть dratʹ ~ trete
holiday 		праздник  praśdnik √free?
home 		домой  domoy  ✓
hope 		надеяться  nadeiatsia Nadia <3 ™
horse 		конь лошадь  kon / loshad ~knight✓ √laša “horse”@Turk ??? lash-a? lasso? <<<
hospital 		больница  bolnissa polonaise:bol=foul <<>>
hot 		горячий  goriachiy ≠gor << (vulkan?)
hotel 		гостиница  gostinissa Gast…ness? ✓
house 		дом  dom  ✓
how 		как  kak  ✓ que.que
human being 		человек  chelovek <<<< MAN
hundred 		сто  sto cento ~
iceberg 		айсберг  aysberg  ✓
if 		если  esli as…like…else;) <<
illiterate 		безграмотный  беś-gramotnėiy ✓ GR des¬grammatic
ill 		больной  bolnoy 
illness 		болезнь  boleśn @poles? <<
image 		картина  kartina <> karta ~ ✓
impartial 		беспартийный беспристрастный  bespartiynėiy bespristrastnėiy 
important 		важный  vaζenėiy big>vage,vachement,vhuge? <<<
in 		в на  vna (by)inner
incendiary bomb 		зажигательная бомба  śaζeigatelnaia bomba 
incidental 		боковой  bokovoy 
inexpensive 		дешёвый  deshёvėiy des¬___
infant 		ребёнок  rebёnok <<< RehBen?
infernal 		адский  adskiy @sky? <
inquiry 		анкета  anketta  ✓?
insane 		безумный  беś-umnėiy 
insanity 		безумство  беś-umstvo 
inside 		в на  v na by.ina
insist 		настаивать настоять  nastaivat nastoiat ~~ insta'ist
instructor 		учитель  uchitel učítʹer ~ teacher <>  iaukint exercise 𐌱𐌹𐌿𐌷𐍄𐍃 biūhts used-to
intelligent 		умный  umnėiy ™ <<< > des'umn
intercessor 		адвокат  advokat  ✓
interest 		интерес  interes  ✓
interesting 		интересный  interesnėiy  ✓
into 		в на  v na by.nach << ~ ✓
investigation 		анкета  anketta !!  ✓?
in English 		по‐английски  po‐angliyski  ✓
in action 		активный  aktivnėiy  ✓
in a way 		будто  budto ?
in exchange for 		против  protiv << tit.pro.tiv
in the evening 		вечером  vecherom vesper<< ~✓
in what way 		как  kak que… ~ ✓
it 		оно  ono 1 <<
jail 		тюрьма  Turma  ✓
jester 		арлекин  (h)arlekin  ✓
job 		работа  rabota  ✓
journal 		газета  gaśeta  ✓
journey 		путешествие  puteshestvie pode.шест.vie <<
judge 		судья  sudia  ✓
jug 		бак  bak  ✓
jump 		прыгать прыгнуть  prėigat prėignut 
just 		только  tolko tell? <
keeper of the records 		архивариус  archivarius ✓
kill 		убивать убить  ubivat ubit orbit! ✓ <<
kilo 		килограмм  kilogramm ✓
kilometre 		километр  kilometr  ✓
kitchen 		кухня  küchnia ✓
knee 		колено  koleno Kehle ✓ kelis@Baltic
knife 		нож  noζe  ✓
know 		знать  śnat  gnat,gnost ~ ✓
know how 		знать  śnat gnat,gnost ~ ✓
laborer 		рабочий  rabochiy  ✓
labourer 		рабочий  rabochiy  ✓
lake 		озеро  ośero Wassereau ~ ✓
lament 		ахать  axat  ✓

lamb 		агнец  agness <3 <<GR

lamp‐shade 		абажур  abaζeur <
lamp 		лампа  lampa  ✓
land 		страна  strana strand;)  ✓?
language 		язык  iaśėik sayque? <<
large 		большой  bolshoy ~bausch ~polis? ✓?
lass 		девушка  devushka ?
lasso 		аркан  arkan ~✓ 𓍯
late 		поздно  pośdno past ✓
lawyer 		адвокат  advokat ✓
lay a distress upon 		наложить арест на  naloζeit arest na ?
lay down 		ставить поставить  stavit postavit ~stand-post
lay hold of 		брать взять  brat vśiat 
leader 		капитан  kapitan  ✓
leaf 		лист  list  <<!
leap 		прыгать прыгнуть  prėigat prėignut ??<< ≠pregnant
lease 		арендовать снимать в аренду  arendovat snimat v arendu 
leasurely 		медленно  medlenno ?
lesson 		урок  urok <<
let 		пускать пустить  puskat pustit postulate! post.let;)  ~✓?
leave 		пускать пустить  puskat pustit  ^^ <<
leave behind 		оставлять оставить  ostavliat ostavit 
letter 		письмо  pismo !!
lewd 		блудливый  bludlivėiy ?
librarian 		библиотекарь  bibliotekar  ✓
library 		библиотека  biblioteka  ✓
lie 		лежать полежать  leζeat poleζeat lieget ✓
lie down 		ложиться лечь  loζeitsia lech  ✓
light 		свет  svet  ✓
like 		как  kak  ✓
likewise 		также тоже  takζee toζee : totze ha earth esche <<
like that 		так  tak !
lion 		лев  lev  ✓
liquidate 		убивать убить  ubivat ubit 
listen 		слушать послушать  slushat poslushat pos'listen <<< ✓ 🔏?
literal 		буквальный  bukvalnėiy Buch… ✓<
little brother 		братец  bratess ✓✓   ц~rus!
live 		жить пожить  ζeit poζeit Seiet:Zooit ++? <<<
location 		место  mesto << MA?
loch 		озеро  ośero 𓍯Öse,lasso,аркан  arkan ~✓ 
lofty 		высокий  vėisokiy 
long 		длинный  dlinnėiy ~de'longue line <✓
look 		вот  vot  ✓ voit:voir <<
look at 		смотреть посмотреть  smotret posmotret s'moygt <<<<
lorry 		грузовой автомобиль  gruśovoy avtomobil ✓ 
lose 		терять потерять  teriat poteriat << tear?
loud 		громкий  gromkiy vs Gram! <<
lounge 		зал  śal  ✓
love 		любить полюбить  lubit polubit 
lovely 		красивый  krasivėiy 
lower‐arm 		нижная часть руки  niζenaia chast ruki 
luggage 		багаж  bagaζe  ✓
lump 		булка  bulka 
lust 		азарт  aśart ~lasart
lyric 		текст  tekst  ✓!
lunacy 		безумство  беś-umstvo 
mad 		безумный  беś-umnėiy omni-mind
madness 		безумство  беś-umstvo 
magazine 		газета  gaśeta  ✓
maintain 		аргументировать  argumentirovat ;)
majority 		большинство  bolshinstvo 
major road 		большак  bolshak <<
make 		делать сделать  DELAT sdelat << delate~relate?
make an appeal to 		апеллировать к  apellirovat k  ✓
make a note 		записывать записать  śapisėivat śapisat √sapiens <3  
man 		человек  chelovek <<<
manage 		администрировать  administrirovat  ✓
management 		администрация  administrassiia  ✓
manager 		администратор  administrator  ✓
map 		карта  karta  ✓
march 		ходить походить  xodit poxodit √POD  ✓?
market 		базар  baśar ✓ 
marketplace 		базар  baśar ✓
marriage 		брак  brak <> Braut? <<
marsh 		болото  boloto <<
matter 		дело  delo << Teil?
mayor 		бургомистр  burgomistr ✓ DE:)
melon 		арбуз  arbuś 
menu 		карта  karta ✓
meteoric stone 		аэролит  aairolit aero.lith++ ✓
meteorite 		аэролит  aairolit  ✓
middleclass 		буржуазный  burζeuaśnėiy :
middleclass citizen 		буржуй  burζeuy Burgeoise:Bursche:Person<< ✓?
midwife 		акушерка  akusherka 
military 		армейский  armeyskiy ✓
minute 		минута  minuta  ✓
miserable 		бедственный  bedstvennėiy badest-veni;) ✓?
mistake 		ошибка  oshibka <<
monkey 		обезьяна  oбеś-iana << 𓂝 𓂝 𓈖 𓂝 𓃷    𓂝𓂝bis-2
month 		месяц  mesiass  ✓!
moon 		луна  luna  ✓!
more 		более  bolee  ✓
morning 		утро  utro <<
motorcycle 		мотоцикл  motossikl  ✓
motorway 		автострада  avtostradha  ✓+
motor road 		автострада  avtostrada  ✓
mountain 		гора  gora  ✓!
movie theatre 		кино  kino  ✓
museum 		музей  muśey  ✓
must 		должен  dolζeen <<
mutiny 		бунт  bunt  ✓
mutton 		баранина  baranina ?
my 		моё мой моя  moё moy moia  ✓
name 		имя  imia Nomer!  ✓
nameless 		безымянный  беś-ėimiannėiy ~dеs¬a-mnomne ~ ✓
nasty 		плохой  ploxoy 
nearly 		почти  pochti 
needle 		булавка  bulavka <<
neither 		никто  nikto  ✓
neither ... nor 		ни...ни  ni...ni  ✓
new 		новый  novėiy  ✓
newspaper 		газета  gaśeta  ✓
next 		будущий  buduschiy by'dux? <<
near 		около у  okolo u 
nearby 		около у  okolo u 
near to 		около у  okolo u 
next to 		около у  au'kolo au 
nice 		хороший  xoroshiy <<
nine 		девять  deviat 
nitrogen 		азот  aśot 
no 		нет  net  ✓
no‐one 		никто  nikto 
nobody 		никто  nikto :
none 		никто  nikto Nichts ✓
nonsense 		абсурд  absurd  ✓
north 		север  sever Sibir  ✓
nose 		нос  nos  ✓
not 		не  ne  ✓
note 		билет  bilet  ✓
notebook 		тетрадь  tetrad 
notice 		афиша  athisha  office? <<
nought 		ноль  nol  ✓
novel 		новый  novėiy  ✓
now 		теперь  teper <> HOTEP? <<
nowhere 		нигде  nigde  ✓
nuts 		безумный  беś-umnėiy ¬mind!
nutty 		ароматический ароматичный  aromaticheskiy aromatichnėiy 
object 		вещь  vesch 
obstetrician 		акушерка акушер  akusherka akusher 
occur 		бытовать  bėitovat 
of a battle 		боевой  boevoy 
of a beaver 		бобровый  bobrovėiy Bieberovėiy + ✓
of the coast 		береговой  beregovoy ^Berg
okay 		хороший  xoroshiy klaro.shì:是 ?
old 		старый  starėiy 𓇽 <>sterben senior
omnibus 		автобус  avtobus  ✓
on 		в на  v na 
once more 		опять  opiat 
one 		кто‐то  kto‐to 
onerous 		тяжёлый  tiaζeёlėiy 
one hundred 		сто  sto 
only 		только  tolko 
on account of 		из‐за  iś‐śa 
on the other side of 		поперёк  poperёk 
on time 		аккуратный  akkuratnėiy 
on top 		наверху  naverxu 
open 		открывать открыть  otkrėivat otkrėit 
open up 		открывать открыть  otkrėivat otkrėit 
operative 		рабочий  rabochiy 
opposed to 		против  protiv 
opposite 		против  protiv  ✓
orange 		апельсин  apelsin 
order 		приказывать приказать  prikaśėivat prikaśat 
ordinarily 		обычно  obėichno 
other 		другой  drugoy 
ought to 		должен  dolζeen 
outline 		абрис  abris 
over 		над  nad 
overhead 		наверху  naverxu 
over there 		там  tam 
owing to 		из‐за  iś‐śa 
own 		собственный  sobstvennėiy 
page 		страница  stranissa 
pain 		боль  bol 
painful 		болезненный  boleśnennėiy 
painting 		картина  kartina  ✓
pale 		бледный  blednėiy 
pancake 		блин  blin 
pants 		брюки  bruki 
paper 		бумага  bumaga 
paragraph 		абзац  abśass 
pardon 		объявить амнистию  obhiavit amnistiю 
parings 		брак  brak 
parliament 		парламент  parlament  ✓
parlour 		зал  śal 
passion 		азарт  aśart 
passionate 		азартный  aśartnėiy 
pastor 		батюшка  batюshka 
patient 		больной  bolnoy 
pawn 		солдат  soldat 
pay 		платить заплатить  platit śaplatit 
peanut 		арахис  araxis 
pencil 		карандаш  karandash 
per 		в на  v na 
perform 		входить войти  vxodit voyti 
periodical 		газета  gaśeta 
persist 		артачиться  artachitsia 
personal 		собственный  sobstvennėiy 
petrol 		бензин  benśin 
physician 		врач доктор  vrach doktor 
physicist 		физик  Phiśik 
pick out 		выбирать выбрать  vėibirat vėibrat 
pick up 		собирать собрать  sobirat sobrat 
picture 		картина  kartina 
pilgrim 		богомолец  bogomoless 
pilgrimage 		богомолье  bogomole 
pin 		булавка  bulavka 
pineapple 		ананас  ananas 
pious 		благочестивый богобоязненный  blagochestivėiy bogoboiaśnennėiy 
placard 		афиша  athisha  p/t? <<
place 		место  mesto 
plain 		яркий  iarkiy 
plan 		план  plan  ✓
plane 		аэроплан самолёт  aairoplan samolёt 
plate 		блюдо  bludo  ✓
platter 		блюдо  bludo 
play 		играть сыграть  igrat sėigrat 
plea 		аргумент  argument 
please 		пожалуйста  poζealuysta 
pleased 		довольный  dovolnėiy 
plume 		перо  pero  ✓
pole 		брусок  brusok 
pool 		бассейн для плавания  basseyn dlia plavaniia 
poor 		плохой  ploxoy  ✓
popular 		популярный  populiarnėiy  ✓
pork 		буженина  buζeenina 
poster 		афиша  aphisha ++
poverty 		бедность беднота  bednost bednota 
practice 		упражнение  upraζenenie 
precipice 		бездна  беś-dna 
pregnant 		беременная  beremennaia 
present‐day 		актуальность  aktualnost 
present 		актуальность  aktualnost 
pricey 		дорогой  dorogoy 
priest 		батюшка  batюshka 
prison 		тюрьма  turma ✓
prisoner 		арестант  arestant ✓
problem 		вопрос проблема  vopros problema ✓
professor 		профессор  professor  ✓
profit 		барыш  barėish ~? 
project 		план  plan ✓
prompt 		аккуратный  akkuratnėiy ✓
proper 		правильный  praвilnėiy ✓

ranch 		ферма  therma  perma farm terra << ф +++
property 		ферма  therma perma farm terra << ф +++

provided that 		если  esli   es ist al ✓~

pub 		бар  bar  ✓
pulley 		блок  blok ~✓
punctual 		аккуратный  akkuratnėiy ✓!! EG
purchase 		покупать купить  pokupat kupit Kauf ✓ 

pure 		чистый  chistėiy  christi crystal !!! <<< !!! <<<<<< ✓✓✓

purpose 		цель  ssel Ziel ✓

put 		ставить поставить  stavit postavit   put=post!!! ✓✓✓ <<<
put down 		ставить поставить  stavit postavit !! <3 <<< ~™

quite 		очень  ochen : ogen=[schw]eigen @ EG !!!<<<<

race 		бегать бежать  begat beζeat weges… ✓/3 <> run 

rain 		дождь  doζed shed 𓁿 <<<

ram 		баран  baran  ✓ boram <<?
rapid 		быстрый  bėistrėiy fėist:fast ~~✓ <<<<<
quick 		быстрый  bėistrėiy fėist:fast ~~✓ <<<<<
quickly 		быстро скоро  bėistro skoro fėist:fast s'curier  ~✓
razor 		бритва  britva @Bart ✓™
read 		читать  chitat  ~ read.at ✓??<<<
read прочитать prochitat 
realize 		понимать понять  ponimat poniat <> penser? ✓?
rearguard 		арьергард  arergard  ✓
rear 		арьергард  arergard ✓ ^^! <3
rebellion 		бунт  bunt : Wende ~~✓
rebel 		бунтовать взбунтоваться  buntovat vś.buntovatsia  ^^
rebuke 		браковать  brakovat 
receive 		принимать  prinimat 
recline 		лежать полежать  leζeat poleζeat 
recognize 		узнавать узнать  uśnavat ut.znat  re.gnost ✓~~
records 		архив  arxiv ✓
red 		красный  krasnėiy <<<

referee 		арбитр  arbitr ✓

refuse 		брак  brak Pfusch:Fehler/Ehe LOOL

regard 		считать  schitat  schäśen ✓
regrettably 		к сожалению  k soζealeniю 
regulation 		правило  pravilo 
release 		пускать пустить  puskat pustit 
remain 		оставаться остаться  ostavatsia ostatsia 
rent 		аренда  arenda  ✓
rental 		аренда  arenda  ✓
renter 		арендатор  arendator  ✓
reply 		отвечать ответить  otvechat otvetit 
reservoir 		бассейн  bassin ✓

resist 		артачиться  artachitsia  (sträuben , widerseśen  ) <<

respond 		отвечать ответить  otvechat otvetit aus-wiedern = erwiedern!!<< ~ aus-sprechen?

rest 		отдыхать otdėixat ausdösen = ausruhen ✓ ++ <3
rest 		отдохнуть  otdoxnut ausdösen = ausruhen ✓
repose 		отдыхать отдохнуть  otdėixat otdoxnut ✓ ^^

revolt 		бунтовать   buntovat <> bend:wend ✓!! <3 <<
revolt 		взбунтоваться vez.buntovatsia  ^^

rich 		богатый  bogatėiy  BIG be-Gabt : ergiebig ausgiebig ✓
rich man 		богач  bogach / ^^ bogota;)

river 		река  reka  ✓ ReikiaWik? <<< rod@Pers 
rod 		брусок  brusok ~brush <>bat?
rogue 		бестия  bestiia ✓
room 		комната  komnata commun.at ✓/2
rouble 		рубль  rubl  ✓

road 		дорога  doroga   ✓~✓! direction   rog~rod
route 		дорога  do'roga ✓~✓! direction 
rubbish 		абсурд  absurd ✓ ! ++
ruble 		рубль  rubl  ✓

right 		правый  pravėiy  1. first <<<+++?  private:polit,bravo,brave… !? _____
righthand 		правый  pravėiy 
rule 		правило  pravilo ^^



roam 		бродить  brodit beroad<>bereisen!! ++ <<< <3 vs

run 		бегать бежать  begat weg-ga-*!! beζeat √pod
run away 		бежать  beζeat √pod
run across 		бить ударить  bit udarit √pod audire…

safety 		безопасность  беś-opasnost Aufpass;) <?
safety pin 		английская булавка  angliyskaia bulavka 
sagacious 		умный  umnėiy omni:mind
sallow 		бледный  blednėiy blass~platt ✓
salon 		зал  śal  ✓
sandbank 		банка  banka  ✓
satisfied 		довольный  dovolnėiy do¬wollen ✓?

saucer 		блюдечко блюдце  bludechko bludsse Bloedsinn;)
sausage 		колбаса  kolbasat 

say 		говорить  govorit 'geben'? <<?
say 		сказать skaśat  chat<>kaśe!! <<<!

scale 		забираться в забраться в забираться на забраться на  śabiratsia v śabratsia v śabiratsia na śabratsia na 
scheme 		план  plan 
school 		школа  shkola  ✓
screen 		забирать забрать  śabirat śabrat 
scuffle 		битва бой борьба  bitva boy borba 

sea 		море  more Mare ✓

seaside 		берег  bereg ?

security 		безопасность  беś-opasnost    ἔγγυ.ος? --?<

see 		видеть увидеть  videt uvidet ✓!

seize 		наложитьарест на  nalo.ζeitarest na  <<<

sell 		продавать продать  prodavat prodat <<✓? weg-geben!

send 		посылать послать  posėilat poslat ✓ postilat

sentence 		фраза  phraśa ✓

serious 		важный  vaζenėiy <<<>  	bedeutend,maśgeblich

set 		аппарат  apparat ✓
settlement 		аул  aul  "der Aul" Gau? Tal tell?

seven 		семь  seьm  ✓

several times 		бывало  bėivalo  <<<<<

share 		акция  aktiea ✓
shareholder 		акционер  akssioner ✓
shark 		акула  akula  aqua-haiena ~✓ 'dog'
shave 		брить  brit : Bart ✓™
she 		она  ona  <<
shed 		будка  budka  Bude ✓
sheen 		блеск  blesk  Bliśen✓  Glanz, Schein vs blass!
sheet 		лист  list  ✓!
shock‐absorber 		амортизатор  amortiśator  ✓
shoe 		ботинок  botinok boot ++ √pod ✓
shop 		магазин  magaśin  ✓
shore 		берег  bereg  ✓
shortness of breath 		астма  astma  ✓
should 		должен  dolζeen dois:must^^
shut 		закрывать закрыть  śakrėivat śakrėit secret+++  ✓
sick 		больной  bolnoy polen? mal
side 		боковой  bokovoy <<

sideboard 		шкаф  shkapth  s'cupboard <

silent 		безмолвный  беś-molvnėiy des-molest
sing 		петь спеть  pet spet ?<
sister 		сестра  sestra  ✓
sit 		сидеть посидеть  sidet posidet 
sitting‐room 		зал  śal Saal ✓
sit down 		садиться сесть  saditsia sest  ✓
six 		шесть  shest  ✓
ski 		лыжи  lėiζei leucht?
sky 		небо  nebo 𓋞𓋟 Nebel Nobel Nebo:Merkur <> heaven 
slay 		убивать убить  ubivat ubit orbit…
slaughterhouse 		бойня  boynia 
slowly 		медленно  medlenno middle:man?
snow 		снег  sneg  ✓
snow white 		белоснежный  belo.sneζenėiy bella.Schnee
so 		так  tak™ ✓ 
society 		клуб  klub ✓
soldier 		солдат  soldat  ✓
solicitor 		адвокат  advokat  ✓
sole 		один  odin at-one?
solitary 		один  odin Oden?

some 		кто‐то  kto‐to que.to2?
somebody 		кто‐то  kto‐to 
someone 		кто‐то  kto‐to 
some one 		кто‐то  kto‐to 

sometimes 		бывало  bėivalo by… <<

son 		сын  sėin  ✓ +++
soon 		скоро  skoro  
soup 		суп  sup  ✓
south 		юг  юg jugo αὐγή augḗ augora  “light, beam” jour

speak 		говорить поговорить  govorit pogovorit  govori:CRY>CALL! << ++ ✓

speed 		быстрота  bėistrota fetz √pod best > fast !! +++ ✓?
speedy 		быстрый  bėistrėiy ^^ best > fast ;) ✓?
sport 		спорт  sport  ✓
spot 		место  mesto Mist!

spring 		весна  vesna !! <<  वसन्त vasantá, “spring”
springtime 		весна  vesna  fresh?  بهار‎ (bahâr, “spring”), Ancient Greek ἔαρ (éar), Latin ver

squirrel 		белка  belka /

stairs 		лестница  lestnissa ??  *lězti (“to climb”)  λαχύς (lakhús, “low”)
staircase 		лестница  lestnissa 

stand 		будка  budka √pod
stand up to 		артачиться  artachitsia ?

start 		начало  nachalo  начѧло √NEU… <<✓

station 		вокзал станция  vokśal stanssiia✓  standtion✓

stay 		оставаться остаться  ostavatsia ostatsia  !!! √static +++ <<<
stay over 		оставаться остаться  ostavatsia ostatsia  √STAT ostentativ guest?

steak 		бифштекс  bifshteks✓! <>  bifteki ✓
storage battery 		аккумулятор  akkumuliator ✓
store 		магазин  magazin ✓
stork 		аист  aist << air äste easter ... ?
storm 		буря  buria boreal ~✓ vs quria!
story 		история  istoriia  ✓
stress 		акцент  akssent ~✓
strike 		бить ударить  bit udarit bat audire:go
striking 		броский  broskiy brüsk... << ✓
stroll 		гулять погулять  guliat poguliat GO…
strong 		сильный  silnėiy <<<<< síela:sky?  seul,saal?
struggle 		бороться  borotsia war:Borussia ✓?
student 		студентка  studentka  ✓
stupid 		глупый  glupėiy  ✓
subscriber 		абонент  abonent ✓
such 		так  tak™ ✓ <>
such a 		как  kak  queque ~✓
such as 		как  kak 
suddenly 		вдруг  vdrug abrugt~~
summer 		лето  leto levt:white?  year/laithe (“day”)
supper 		ужин  uζein ESSEN!  угъ ugŭ *jugъ ^^ South/Noon
surname 		фамилия  familiia ✓
swamp 		болото  boloto 
swift 		быстрый  bėistrėiy FAST<best^^ ✓?

swiftly 		быстро скоро  bėistro skoro ^^

swim 		плавать  plavat pleuvoir✓
swimming‐bath 		бассейн для плавания  basseyn dlia plavaniia Bassin dela Pleuvanau +++++<< ✓
swimming‐pool 		бассейн для плавания  basseyn dlia plavaniia 
table 		стол  stol  ~✓ Stuhl@Stell
take 		принимать  prinimat prendre++ ✓
take in 		принимать  prinimat pre.Nehme^^ ✓!++<<
take along 		забирать забрать  śabirat śabrat 
take away 		забирать забрать  śabirat śabrat 
take into account 		считать  schitat  Zitat;)
take over 		покупать купить  pokupat kupit 
talk 		говорить поговорить  govorit pogovorit govori:CRY/call^^  
tall 		высокий  vėisokiy ™ feist? <<<<
tangle 		беспорядок  besporiadok 
tank 		бак  bak  
target 		цель  ssel Ziel ✓ ++
tasteless 		безвкусный  беś-vkusnėiy beaucoup,verkost?<<
tasty 		аппетитный  appetitnėiy ✓
tea 		чай  chay  ✓
teacher 		учитель  uchitel ^^
tell 		говорить сказать  govorit skaśat chat!<<< ✓/EG
tell a lie 		брехать  brexat  Bruch✓? sprechen;)
ten 		десять  desiat dix ✓
tenant 		арендатор  arendator !?
testimony 		аттестат  attestat ✓
text 		текст  tekst  ✓
thankful 		благодарный  blagodarnėiy 
that 		что  chto  ✓
that over there 		это  aito Thato э<TH!
that way 		так  tak !
theatre 		театр  teatr  ✓
thee and thou 		быть на ты  bėit na tėi 
then 		потом   potom pan.time ~✓
then		тогда togda[n] der.Tag? 
theologian 		богослов  bogoslov bog=god
theology 		богословие  bogoslovie 
there 		вот  vot 
the Antarctic 		Антарктика  antarktika  ✓
the Netherlands 		Нидерланды  niderlandėi 
thigh 		бедро ляжка  bedro liaζeka √pod /leg? <<
thing 		вещь  vesch   
think 		думать подумать  dumat podumat 
third 		третий  tretiy 
this evening 		сегодня вечером  segodnia vecherom 
this morning 		сегодня утром  segodnia utrom 
those 		это  aito 
though 		хотя  xotia 
thrash 		бухать бухнуть  buxat buxnut 
three 		три  tri  ✓
throat 		горло  gorlo 
through 		из‐за  iś‐śa 
thumb 		большой палец  bolshoy paless 
thus 		так  tak  ✓
ticket 		билет  bilet  ✓
tiger 		тигр  tigr  ✓
time 		время  vremia 
tin 		банка  banka 
tin can 		банка  banka  ✓
to 		в к на  v k na 
today 		сегодня  segodnia 
together 		вместе  vmeste 
tomorrow 		завтра  śavtra 
tongue 		язык  iaśėik 
too 		также тоже  takζee toζee 
topical 		актуальность  aktualnost 
topicality 		актуальность  aktualnost 
toward 		в к на  v k na 
towards 		в к на  v k na 
towel 		полотенце  polotensse 
tower 		башня  bashnia 
town 		город  gorod 
translate 		переводить перевести  perevodit perevesti 
transmit 		посылать послать  posėilat poslat 
travel 		путешествовать  puteshestvovat 
tree 		дерево  derevo 
trip 		путешествие  puteshestvie 
trouble 		вопрос проблема  vopros problema 
trousers 		брюки  bruki 
truck 		грузовой автомобиль  gruśovoy avtomobil 
trunk 		чемодан  chemodan 
tummy 		брюхо  bruxo 
tup 		баран  baran 
twaddle 		брехать  brexat 
twenty 		двадцать  dvadssat 
two 		два две  dva dve 
type 		печатать отпечатать  pechatat otpechatat 
typewriter 		пишущая машинка  pishuschaia mashinka 
umpire 		арбитр  arbitr 
uncle 		дядя  diadia 
underneath 		внизу  vniśu 
understand 		понимать понять  ponimat poniat 
unemployed 		безработный  беś-rabotnėiy 
unemployment 		безработица  беś-rabotissa 
unfortunately 		к сожалению  k soζealeniю 
university 		университет  universitet  ✓
university graduate 		академик  akademik 
unknown 		безвестный  беś-vestnėiy 
up‐to‐date 		актуальность  aktualnost 
up 		наверх  naverx 
uphill 		наверх  naverx 
upon 		против  protiv 
upper‐arm 		верхняя часть руки  verxniaia chast ruki 
upper arm 		верхняя часть руки  verxniaia chast ruki 
upstairs 		наверху  naverxu 
upwards 		наверх  naverx 
useful 		полезный  poleśnėiy 
useless 		бесполезный  bespoleśnėiy 
usually 		обычно  obėichno 
valiant 		бравый  bravėiy 
valuable 		дорогой  dorogoy 
vase 		ваза  vaśa  ✓
velvet 		бархатный  barxatnėiy 
vend 		продавать продать  prodavat prodat 
very 		очень  ochen 
very much 		очень  ochen 
vessel 		бак  bak 
view 		смотреть посмотреть  smotret posmotret 
vigour 		активность  aktivnost 
village 		аул  aul 
visa 		виза  viśa  ✓
visit 		посещать посетить  poseschat posetit 
visitor 		посетитель  posetitel 
visé 		виза  viśa  ✓
vocabulary 		словарь  slovar 
vodka 		водка  vodka  ✓
voyage 		путешествие  puteshestvie 
wail 		ахать  axat 
wainscot 		забирать забрать  śabirat śabrat 
wait 		ждать подождать  ζedat podoζedat 
waitress 		официантка  othissiantka  << p/t?
wait for 		ждать подождать  ζedat podoζedat 
wake 		разбудить  raśbudit 
wake up 		разбудить  raśbudit 
walk 		ходить походить  xodit poxodit 
wander 		бродить  brodit 
want 		хотеть захотеть  xotet śaxotet 
warrior 		армеец боец борец  armeess boess boress 
wart 		бородавка  borodavka 
wash 		бучить  buchit 
waste 		брак  brak 
watch 		часы  chasėi 
water‐bottle 		баклага  baklaga 
water‐colour 		акварель  akvarel 
water 		вода  voda 
way 		дорога  doroga 
wealth 		богатство  bogatstvo 
wealthy 		богатый  bogatėiy 
weather 		погода  pogoda 
week 		неделя  nedelia 
weep 		плакать заплакать  plakat śaplakat 
well‐off 		богатый  bogatėiy 
well 		хорошо  xorosho 
wench 		девушка  devushka 
what 		что  chto  ✓
what a 		как  kak << quaque
what for 		почему  pochemu 
wheeziness 		астма  astma ✓
wheezy 		астматический  astmaticheskiy 
when 		когда  kogda 
where 		где  gde  zu-da??<<
whereas 		за пока  śa poka 
which 		кто  kto 
while 		за пока  śa poka 
whilst 		за пока  śa poka 
whip 		бичевать  bichevat 
white 		белый  belėiy[k] ✓  bei beige bveiś blanc vs black!! <<
who 		кто  kto  ✓
why 		почему  pochemu  <<< EG?
why? 		почему?  pochemu? 
windfall 		брак  brak ?
window 		окно  okno  ✓
wine 		вино  vino  ✓

wind 		ветер  veter ✓  <>
winter 		зима  śima zimmer time <<

wish 		желать пожелать  ζeelat poζeelat 

witch 		баба‐яга  baba‐iaga ;) << humbaba!

with 		с  s as zu
within 		в на  v na  vith ina <3 <<<

without 		без  беś- des- weg-

without a name 		безымянный  беś-ėimiannėiy 
withstand 		артачиться  artachitsia 
with young 		беременная  beremennaia 
woman‐chaser 		бабник  babnik ;)
woods 		лес  [fo]les  ✓
word 		слово  slovo[d] Slaven sloWord @ lip? <<
work 		работать  rabotat ✓  *karbeit
worker 		рабочий  rabochiy ✓
working man 		рабочий  rabochiy ✓
workman 		рабочий  rabochiy ✓

worship 		боготворить  bogotvorit <> Gott << ^^

writer 		автор  avtor  ✓
write down 		записывать записать  śapisėivat śapisat 
yacht 		яхта  iaxta  ✓
year 		год  god <<>> Jahrde !!
yes 		да  da  ✓ tja
yesterday 		вчера  vchera  ✓
yet 		уже  ~yuζee 

yon 		там  tam  
yonder 		там  tam  <> kar.tam!! <<<<

young 		молодой  molodoy  ??
young woman 		барышня  barėishnia 
your 		твоё твой твоя  tvoё tvoy tvoia  tu✓
zero 		ноль  nol ✓

Saturday 		суббота  subbota ✓
Thursday 		четверг  chetverg 
Wednesday 		среда  sreda  ✓
holiday 		праздник  praśdnik 
present‐day 		актуальность  aktualnost 
today 		сегодня  segodnia 
yesterday 		вчера  vchera  ✓
