Adán 		Adam 
Alcorán 		Koran 
Alejandro 		Alexander 
Alemania 		Germany 
Alpes 		Alps 
Amberes 		Antwerp 
Amsterdam 		Amsterdam 
América 		America 
América del Sur 		South America 
América meridional 		South America 
América septentrional 		NorthAmerica 
Andalucía 		Andalusia 
Andorra 		Andorra 
Antillas 		Antilles 
Anunciación 		Annunciation LadyDay 
Apocalipsis 		Apocalypse 
Aquisgrán 		Aix‐la‐Chapelle 
Arabia 		Arabia 
Argel 		Algiers 
Argentina 		Argentina 
Arizona 		Arizona 
Aruba 		Aruba 
Ascensión 		AscensionDay 
Asia 		Asia 
Asia Menor 		AsiaMinor 
Asturias 		Asturias 
Atenas 		Athens 
Australia 		Australia 
Austria 		Austria 
Balkanes 		Balkans 
Barcelona 		Barcelona 
Bengala 		Bengal 
Berlín 		Berlin 
Biblia 		Bible 
Blanca‐Nieve 		LittleSnowWhite 
Bolivia 		Bolivia 
Brasil 		Brazil 
Bruselas 		Brussels 
Bulgaria 		Bulgaria 
Burdeos 		Bordeaux 
Báltico 		Baltic Sea 
Bélgica 		Belgium 
Canadá 		Canada 
Candelaria 		Candlemas 
Castilla 		Castile 
Cataluña 		Catalonia 
Cenicienta 		Cinderella 
Cenopegias 		FeastofTabernacles 
Cerdeña 		Sardinia 
Checoeslovaquia 		Czechoslovakia 
Chile 		Chile 
China 		China 
Colombia 		Colombia 
Colonia 		Cologne 
Colón 		Columbus 
Costa Brava 		CostaBrava 
Costa Rica 		CostaRica 
Creta 		Crete 
Cristo 		Christ 
Cruz Roja 		RedCross 
Cuba 		Cuba 
Curazao 		Curaçao 
Cáucaso 		Caucasus 
Córcega 		Corsica 
Córdoba 		Cordova 
Dinamarca 		Denmark 
Dios 		God 
Ecuador 		Ecuador 
Egipto 		Egypt 
El Salvador 		ElSalvador 
Escalda 		Scheldt 
Escandinavia 		Scandinavia 
Escocia 		Scotland 
España 		Spain 
Estados Unidos 		United States of America USA 
Estonia 		Estonia 
Estrasburgo 		Strasbourg 
Estrecho de Gibraltar 		StraitofGibraltar 
Etna 		Etna 
Europa 		Europa 
Europa occidental 		WesternEurope 
Extremadura 		Estremadura 
Extremo Oriente 		Far East theFarEast 
Fiesta de los Tabernáculos 		FeastofTabernacles 
Finlandia 		Finland 
Flandes 		Flanders 
Florencia 		Florence 
Francia 		France 
Frisia 		Friesland 
Gales 		Wales 
Galicia 		Galicia 
Gante 		Ghent 
Gibraltar 		Gibraltar 
Ginebra 		Geneva 
Gran Bretaña 		Britain GreatBritain 
Grecia 		Greece 
Groenlandia 		Greenland 
Guatemala 		Guatemala 
Guinea Ecuatorial 		EquatorialGuinea 
Güeldres 		Guelderland Guelders 
Génova 		Genoa 
Havana 		Havana 
Holanda 		Holland 
Holanda septentrional 		NorthHolland 
Honduras 		Honduras 
Hungría 		Hungary 
IVA 		VAT 
India 		India 
Indonesia 		Indonesia 
Inglaterra 		England 
Irlanda 		Ireland 
Islandia 		Iceland 
Islas Baleares 		BalearicIslands 
Islas Canarias 		CanaryIslands 
Islas Malvinas 		Falkland Islands Falklands 
Italia 		Italy 
Japón 		Japan 
Java 		Java 
Jesucristo 		JesusChrist 
Laponia 		Lapland 
Latvia 		Latvia 
La Haya 		TheHague 
Letonia 		Latvia 
Lieja 		Liège 
Lisboa 		Lisbon 
Lituania 		Lithuania 
Livonia 		Livonia 
Londres 		London 
Lorena 		Lorraine Lothringen 
Los Países Bajos 		Holland the Netherlands 
Lovaina 		Louvain 
Luxemburgo 		Luxemburg 
Madrid 		Madrid 
Mahoma 		Mohammed Muhammad 
Malinas 		Malines Mechlin 
Mallorca 		Majorca 
Marruecos 		Morocco 
Marsella 		Marseilles 
Mar Cantábrico 		BayofBiscay 
Mediterráneo 		Mediterranean 
Moisés 		Moses 
Mosa 		Meuse 
Moscú 		Moscow 
Mosela 		Moselle 
Munich 		Munich 
Méjico 		Mexico 
México 		Mexico 
Navidad 		Christmas Yule 
Nicaragua 		Nicaragua 
Nilo 		Nile 
Nimega 		Nimwegen 
Norteamérica 		NorthAmerica 
Noruega 		Norway 
Noé 		Noah 
Nuestra Señora 		OurLady 
Nueva Gales del Sur 		NewSouthWales 
Nueva York 		New Amsterdam New York NewYorkCity 
Nápoles 		Naples 
Oceanía 		Oceania Oceanica 
Océano Pacífico 		Pacific PacificOcean 
Pacífico 		Pacific PacificOcean 
Panamá 		Panama 
Paraguay 		Paraguay 
París 		Paris 
Pascua 		Easter 
Patagonia 		Patagonia 
País Vasco 		BasqueCountry 
Pentecostés 		Pentecost Whitsunday 
Persia 		Persia 
Perú 		Peru 
Pirineos 		Pyrenees 
Polonia 		Poland 
Portugal 		Portugal 
Prusia 		Prussia 
Purificación 		Candlemas 
Redentor 		Redeemer Saviour 
Rin 		Rhine 
Rio Brava 		RioGrande 
Rio Grande del Norte 		RioGrande 
Roma 		Rome 
Rumania 		Romania 
Rusia 		Russia 
Sahara 		Sahara 
Sajonia 		Saxe Saxony 
Salvador 		Redeemer Saviour 
Satanás 		Lucifer Satan 
Satán 		Lucifer Satan 
Sevilla 		Seville 
Siberia 		Siberia 
Suecia 		Sweden 
Suiza 		Switzerland 
Surinam 		Surinam 
Tajo 		Tagus 
Todos los Santos 		All Hallows AllSaints'Day 
Trinidad 		Trinity 
Turquía 		Turkey 
Támesis 		Thames 
Túnez 		Tunis 
Union Europea 		EuropeanUnion 
Unión soviética 		Soviet Union USSR 
Uruguay 		Uruguay 
Valencia 		Valencia 
Venezuela 		Venezuela 
Viena 		Vienna 
Viernes Santo 		GoodFriday 
Vizcaya 		Biscay 
Vístula 		Vistula 
Yugoeslavia 		Yugoslavia 
Zelandia 		Zealand 
¿cuánto tiempo? 		howlong? 
¿cómo está usted? 		how are you? howdoyoudo? 
¿qué hora es? 		whattimeisit? 
a 		at to toward towards 
abad 		abbot 
abadesa 		abbess 
abadía 		abbey 
abajo 		below downstairs underneath 
abandonar 		cede give in give up give way relinquish yield 
abastacimiento 		catering 
abatido 		dejected depressed 
abecé 		alphabet 
abedul 		birch 
abeja 		bee 
abeto 		fir 
abierto 		open 
abismo 		abyss chasm gulf precipice 
abjurar 		abjure forswear swear off renounce 
abolas 		bearing 
abolición 		abolition abrogation 
abolir 		abolish abrogate 
abominable 		abhorrent abominable alien awful hideous horrible gruesome 
abonado 		subscriber 
abonar 		fertilize 
abonarse 		subscribe subscribeto 
abono 		subscription 
abordaje 		collision 
abordar 		land 
abrazar 		embrace 
abrelatas 		can opener tin‐opener 
abreviación 		abbreviation 
abreviar 		abbreviate abridge shorten 
abreviatura 		abbreviation 
abridor de tapones 		bottleopener 
abrigo 		cloak mantle 
abril 		April 
abrir 		open openup 
abrogar 		abolish abrogate 
absceso 		abscess 
abstinencia 		teetotalism totalabstinence 
abuela 		grandmother 
abuelo 		grandfather 
aburrido 		boring stodgy 
aburrir 		bore 
acabado 		finishingoff 
acabar 		finish workout 
academia 		academy 
acampar 		camp be encamped lie encamped campout 
acaso 		accidence chance hazard 
accidente 		accident 
accionista 		shareholder 
acción 		action activity 
acechar 		set a trap setatrapfor 
aceite 		oil 
aceite de oliva 		oil of olives olive‐oil 
aceituna 		olive 
acelerador 		accelerator acceleratorpedal 
acento 		accent stress 
acentuar 		accent accentuate stress 
aceptable 		acceptable 
aceptación 		acceptance admission 
aceptar 		accept receive take takein 
acera 		pavement sidewalk 
acercarse 		advance come close come closer comeon 
acero 		steel 
acertar 		catch hit run across strike 
achicoria 		chicory 
acidez de estómago 		heartburn 
acoger 		greet salute 
acogida 		greeting salutation 
acometer 		commitaggression 
acometida 		access aggression attack 
acomodado 		in easy circumstances well‐to‐do 
acomodar 		accomodate 
acompañamiento 		accompaniment escort 
acompañar 		accompany 
aconsejar 		advise counsel 
acontecer 		become come about grow happen 
acontecimiento 		chance event occurence opportunity 
acordar 		accede agree consent 
acordarse 		think 
acorde 		accord accordance agreement concurrence 
acordeón 		accordion 
acortar 		abbreviate abridge shorten 
acostar 		puttobed 
acostarse 		gotobed 
acostumbrarse 		accustom oneself getused 
activo 		active 
actor 		actor 
actriz 		actress 
actual 		current present present‐day topical up‐to‐date 
actualmente 		at present now 
acuarela 		water‐colour 
acuario 		aquarium 
acuerdo 		accord accordance agreement concurrence 
acumulador 		accumulator battery storagebattery 
acusación 		accusal accusation 
acusado 		accused defendant 
acusar 		accuse 
adaptar 		accomodate 
adelantar 		overhaul overtake pass 
adelante 		ahead foreward on 
adelgazar 		fall away lose lose flesh loseinweight 
además 		besides in addition moreover 
además de 		apart from besides except exceptfor 
adiestrar 		tame train 
adivinar 		guess 
adiós 		adieu farewell bye goodbye 
adjetivo 		adjective 
administración 		administration management 
administración del Sacramento 		administrationofthelastsacraments 
administrador 		manager 
administrar 		administer manage 
admirar 		admire 
admisible 		acceptable 
admitir 		accept receive take takein 
adoptivo 		adopted 
adoración 		adoration worship 
adorar 		adore worship 
adornado 		adorned 
adquisición 		accession acquisition gain 
aduana 		customs 
adular 		flatter 
adverbio 		adverb 
advertidor de incendios 		fire‐alarm firecall 
adyacente 		adjacent 
aeroplano 		aeroplane airplane plane 
aeropuerto 		aerodrome airdrome airfield 
aeróstato 		balloon air‐balloon 
afable 		lovable 
afectación 		affectation 
afectar 		affect 
afectuosidad 		adherence attachment 
afectuoso 		affectionate devoted selfless 
afeitar 		shave 
aficionado 		amateur fancier 
afligido 		sad 
afligir 		afflict grieve 
africana 		Africanwoman 
africano 		African 
afán 		attempt effort 
agarrar 		grasp 
agencia 		agency 
agencia de viaje 		tourist agency travelagency 
agenda 		agenda appointmentbook 
agente 		agent 
agilidad 		expertness skilfulness skill skillfulness 
agosto 		August 
agotado 		exhausted tired out wornout 
agradable 		agreeable enjoyable lovely nice pleasant 
agradar 		please 
agradecer 		thank 
agrado 		pleasure 
agrario 		agrarian agricultural farm‐ 
agresión 		access aggression attack 
agresor 		aggressor assailant attacker 
agridulce 		sweet‐and‐sour 
agrio 		acetous acid sour tart 
agua 		water 
aguardar 		bide abide stay for wait await waitfor 
aguas 		spa 
agua dolce 		freshwater 
agua dulce 		freshwater 
agua potable 		drinking‐water 
agudo 		acute 
aguijón 		sting 
aguja 		needle 
agujero 		hole 
agüero 		indication omen portent precursor presage sign 
ah 		ah aha 
ahogarse 		drown 
ahora 		at present now 
ahora mismo 		at once immediately just right away rightnow 
ahumado 		smoked 
aire 		air 
aire acondicionado 		airconditioning 
aislado 		remote 
aislamiento 		insulation isolation 
ajuar 		furniture 
ajustar 		makeacontract 
ají 		chilli 
ala 		wing 
alabar 		commend laud praise 
alambre 		wire 
alargar 		give 
alarma 		alarm 
albaricoque 		apricot 
albaricoquero 		apricot‐tree 
albergue 		hostel inn 
albergue juvenil 		youthhostel 
alcachofa 		artichoke 
alcade 		mayor 
alcanzable 		accessible 
alcanzar 		achieve acquire attain get obtain 
alcohol 		alcohol booze liquor spirits strongdrink 
alcohol de quemar 		methylatedspirit 
alcázar 		fortification 
aldea 		village 
alegre 		happy glad 
alegría 		gladness joy 
alemana 		German Germanwoman 
alemán 		German 
alentar 		encourage 
aleta 		fin 
alfabeto 		alphabet 
alfiler 		pin needle 
alfombra 		carpet 
algo 		anything something 
algodón 		cotton 
alguien 		a any anybody some somebody one some one someone 
alguno 		a any anybody some somebody one some one someone 
alhaja 		adornment decoration ornament 
aliento 		breath 
alimentar 		feed nourish 
alimento 		food nourishment 
alistar 		recruit 
alma 		soul 
almacén 		warehouse 
almanaque 		almanac 
almeja 		mussel 
almendra 		almond 
almirante 		admiral 
almohada 		pillow 
almorranas 		haemorhoids 
almorzar 		lunch 
almuerzo 		lunch snack 
almíbar 		syrup 
alojamiento 		accommodation 
alojarse 		be a guest of staywith 
alondra 		lark 
alquilado 		hiredout 
alquilar 		let 
alquitrán 		tar 
alrededores 		environment environs surroundings 
alrededor de 		about round around towards 
altar 		altar 
alternar 		alternate 
alternativa 		alternation 
altitud 		altitude height 
alto 		contralto contraltovoice 
altura 		height 
altura barométrica 		barometer reading heightofthebarometer 
alumbrado 		lighting 
alumbrar 		illuminate light 
alumbre 		alum 
aluminio 		aluminium aluminum 
al amanecer 		atdaybreak 
al contrario 		reverse reversed 
al dorso 		attheback 
al día 		aday 
al fin 		at last finally ultimately 
al la derecha 		ontheright 
al menos 		atleast 
al mismo tiempo 		atthesametime 
al norte de 		above 
al presente 		currently nowadays thesedays 
al principio 		first firstly firstofall 
al revés 		reverse reversed 
amable 		affable friendly good‐natured kind 
amainar 		abate weaken 
amanecer 		dawn daybreak 
amar 		love 
amargo 		acerbic bitter 
amarillo 		yellow 
amarradero 		landing‐stage pier 
amasadura 		massage 
amazona 		Amazon 
ambos 		both 
amenaza 		menace threat 
amenazar 		menace threaten 
americana 		jacket 
americano 		American 
amerindio 		Indian AmericanIndian 
amianto 		asbestos 
amiga 		friend 
amigo 		friend 
amistad 		friendship 
amnistía 		act of grace amnesty 
amo 		boss chief leader 
amojonar 		mark out trace traceout 
amoníaco 		ammonia 
amor 		affection love 
amortiguador 		shock‐absorber 
amortización 		redemption 
amortizar 		amortize deaden 
ampliación 		aggrandizement enlargement increase 
ampolla 		bulb 
amputar 		amputate 
amén 		amen 
amén de 		apart from besides except exceptfor 
anales 		annals 
analfabeto 		illiterate 
ananás 		pineapple 
anatema 		anathema ban excommunication 
ancas de rana 		frog'slegs 
anchas 		comfort 
ancho 		broad 
anchoa 		anchovy 
anchura 		width 
anciano 		old 
ancla 		anchor 
anclar 		anchor 
andar 		march walk 
andas 		litter strecher 
andén 		platform quay wharf 
anexar 		annex 
anexionar 		annex 
anexión 		annexation 
anguila 		eel 
angustia 		agony anguish fear 
angustioso 		afraid fearful 
anillo 		ring 
animación 		encouragement 
animal 		animal 
animar 		encourage impel instigate spur on stimulate urge 
ano 		anus arse 
anoche 		lastnight 
anonchecer 		dusk 
anormal 		abnormal 
anotación 		annotation note 
anotar 		note make a note writedown 
anteayer 		thedaybeforeyesterday 
antebrazo 		lower‐arm 
antecedente 		antecedent 
antena 		aerial antenna 
anteriormente 		ahead formerly previously 
antes 		before infrontof 
antes de que 		before previousto 
anticongelante 		antifreeze 
antideslizante 		non‐skid 
antiguo 		ancient antique 
antigüedad 		antiquity 
antiséptico 		antiseptic 
anualidad 		instalment repayment 
anualmente 		annual yearly 
anudar 		tieon 
anular 		cancel countermand 
anunciar 		advertise announce givenotice 
anuncio 		announcement notification notice 
anzuelo 		hook 
anécdota 		anecdote 
anís 		anise 
anónimo 		anonymous 
apagar 		extinguish putout 
aparador 		chest dresser 
aparador de cocina 		dresser 
aparato 		apparatus device set 
aparato para sordos 		hearingaid 
aparcamiento 		parkinggarage 
aparcamiento de taxis 		cab‐stand 
aparecer 		appear emerge perform 
apariencia 		appearance 
apartado 		paragraph 
apartamento 		apartment flat 
apartar 		divide separate 
aparte 		apart particular separate special 
apelación 		appeal 
apellido 		surname 
apenas 		barely hardly only just scarcely 
aperitivo 		dram nip peg snifter snorter 
apestar 		reek smell smell bad stink 
apetito 		appetite 
apio 		celery 
aplaudir 		acclaim applaud clap 
aplauso 		acclaim acclamation approval 
apoplejía 		fit apoplectic fit seizure stroke strokeofapoplexy 
aporrear 		thrash 
apostar 		bet wager 
apostatar 		apostatize 
apoyarse 		lean 
aprender 		learn 
apresurarse 		go fast hurry rush 
apretar 		press oppress squeeze 
aprovechar 		avail 
aprovecharse 		profit 
aprovisionamiento 		arrival arrivals supply 
aproximarse 		advance come close come closer comeon 
apróximadamente 		about approximately 
apuntar 		note make a note writedown 
apéndice 		accessory side‐issue 
apócrifo 		apocryphal 
apóstata 		apostate 
apóstol 		apostle 
arabesco 		arabesque 
arado 		plough 
araña 		spider 
arbusto 		bush shrub 
arca 		ark 
archi‐ 		arch‐ chief‐ 
archiduque 		archduke 
archipiélago 		archipelago 
archivero 		archivist keeperoftherecords 
archivista 		archivist keeperoftherecords 
archivo 		archive archives files records 
arcilla 		clay 
arco iris 		rainbow 
arder 		burn 
ardilla 		squirrel 
arena 		arena 
arenas movedizas 		quicksand quicksands 
arenque 		herring 
arenque ahumado 		redherring 
argelina 		Algerianwoman 
argelino 		Algerian 
argentina 		Argentinianwoman 
argentino 		Argentine Argentinean 
argumento 		argument plea 
aristócrata 		aristocrat 
arma 		weapon 
armar 		arm 
armario 		cabinet closet cupboard sideboard 
armario para libros 		bookcase 
armario ropero 		clothes‐press wardrobe 
arquitecto 		architect 
arrancar 		pick pluck tearoff 
arranque 		run 
arreglar 		arrange put in order tidy 
arreglo 		accommodation adjustment arrangement 
arrendar 		hire 
arrepentimiento 		repentance 
arrestar 		arrest 
arresto 		apprehension arrest detention 
arriba 		above on top overhead upstairs 
arriesgado 		adventurous hazardous risky 
arriesgar 		hazard risk venture 
arroba 		atpersand commercial‐at sign snail 
arrodillarse 		kneel 
arrogante 		arrogant 
arrojar 		result 
arromar 		blunt 
arroyo 		stream 
arroz 		rice 
arruinar 		ruin 
arrurruz 		curry 
arte 		art 
arteria 		artery 
artesanía 		handiwork 
artificial 		artificial 
artillero 		artilleryman gunner 
artillería 		artillery 
artista 		artist 
artículo 		article commodity 
artículos de cuero 		leathergoods 
artículo determinado 		definitearticle 
artístico 		artistic 
arzo‐ 		arch‐ chief‐ 
arzobispado 		archbishopric 
arzobispo 		archbishop 
as 		ace 
asado 		roasted 
asalter 		assault violate 
asar 		roast toast 
ascender 		ascend climb scale 
ascender a 		amountto 
ascensor 		elevator lift 
asediar 		besiege 
asedio 		siege 
asegurador 		insurer 
asegurar 		insure 
asentir 		affirm assent sayyes 
asfalto 		asphalt 
asiento 		seat 
asilo 		asylum 
asir 		clutch grab grasp grip seize 
asistencias 		alimony 
asistente 		aid assistant helper 
asiático 		Asian Asiatic 
asma 		asthma shortness of breath wheeziness 
asombrar 		amaze 
asombrarse 		marvel marvel at wonder 
aspecto 		appearance aspect look sight view 
aspirina 		aspirin 
aster 		aster 
astilla 		splinter 
astrigente antidiárrico 		adstringent 
astronauta 		astronaut spaceman 
astucia 		snare 
astuto 		insidious 
asumir 		guess presume suppose surmise 
asunto 		affair business business deal case matter 
así 		so such thus 
así así 		soso 
así como 		and also and ... as well as well as togetherwith 
atacador 		aggressor assailant attacker 
atacar 		commitaggression 
ataque 		access aggression attack 
atención 		acuity advertence advertency attention 
atender 		advert pay attention pay attention to watchoutfor 
atender a 		advert pay attention pay attention to watchoutfor 
atentado 		assault 
atento 		attentive 
aterrizaje 		landing 
aterrizar 		land 
atleta 		athlete 
atletismo 		athletics 
atlántico 		Atlantic 
atlético 		athletic 
atmosférico 		atmospheric 
atmósfera 		atmosphere 
atomización 		fission 
atornillar 		screw 
atracar 		land 
atractivo 		attractive 
atraer 		attract draw 
atrasado 		backward mentally deficient retarded 
atrasarse 		belate 
atrasos 		arrears 
atravesar 		cross go beyond transfer 
atrayente 		attractive 
atreverse 		be bold dare 
atropallamiento 		collision 
atropellar 		collide run 
atrás 		at the back behind intherear 
aturdir 		drug 
atún 		tuna tuna‐fish tunny 
audiencia 		audience 
aula magna 		auditorium 
aumentar 		accrue grow 
aumento 		accretion growth 
aunque 		though although 
ausencia 		absence 
ausente 		absent 
australiano 		Australian 
austriaco 		Austrian 
autobús 		bus autobus omnibus 
autoestrada 		motor road motorway 
automático 		automatic 
automóvil 		car 
autopista 		motor road motorway 
autor 		author 
autoridad 		authority 
autorización 		authorization 
autovía 		motorway super highway turnpike 
autócrata 		absolute ruler autocrat 
autónomo 		autonomic autonomous 
avalancha 		avalanche 
ave 		bird 
avellana 		hazelnut 
avena 		oats 
avenida 		avenue 
aventajar 		exceed surpass 
aventura 		adventure 
aventurero 		adventurous 
avergonzarse 		beashamed 
averia 		brakedown 
aversión 		abhorrence abomination horror 
avería 		damage 
aves 		birds 
avestruz 		ostrich 
aviación 		aeronautics aviation 
avisar 		caution warn 
aviso 		warning 
avispa 		wasp 
avión 		aeroplane airplane plane 
axioma 		axiom 
ay 		ah oh ow 
ayer 		yesterday 
ayuda 		aid help 
ayudante 		adjutant aide‐de‐camp 
ayudar 		accomodate aid assist help 
ayunar 		fast 
ayuntamiento 		town‐hall 
azada 		hoe 
azafata 		stewardess 
azteca 		Aztec 
azucarero 		sugar‐bowl sugarbowl 
azul 		blue 
azulejo 		tile 
azúcar 		sugar 
aún 		still yet 
a bordo 		aboard 
a cuadros 		checked chequered 
a eso de 		about approximately 
a instancias de 		attheinstanceof 
a la cubana 		intheCubanway 
a la izquierda 		ontheleft 
a lo largo de 		along 
a lo menos 		atleast 
a menudo 		frequently often regularly 
a propósito 		bytheway 
a que 		until till 
a saber 		thatis 
a su salud 		cheers goodhealth 
a tiempo 		at the right time intime 
a través de 		across beyond ontheothersideof 
a veces 		several times sometimes 
año 		year 
año bisiesto 		leap‐year 
año nuevo 		NewYear'sDay 
babero 		bib 
babor 		portside 
babosa 		slug 
bacalao 		cod codfish 
bache 		pole 
bacteria 		bacterium 
badajo 		clapper 
bagatela 		trifle 
bagazo 		bagasse 
bahía 		bay 
bailar 		dance 
bailarín de ballet 		balletdancer 
baile 		ball dance 
baja 		abatement 
bajamar 		lowtide 
bajar 		getout 
bajo 		bass bassvoice 
bajorrelieve 		bas‐relief lowrelief 
bala 		bale 
balance 		balancesheet 
balancear 		rock swing 
balanza 		scales 
balaustrada 		balustrade banisters parapet railing 
balcón 		balcony 
baliza 		buoy 
ballena 		baleen whalebone 
ballet 		ballet 
balneario 		spa 
baloncesto 		basketball 
balotaje 		ballot balloting votingbyballot 
bambú 		bamboo 
bancarrota quiebra 		bankruptcy failure 
banco 		bank 
bandeja 		tray 
bandera 		banner flag 
bandido 		bandit 
banquero 		banker bankmanager 
banquete 		banquet 
bar 		buffet 
barato 		cheap inexpensive 
barba 		beard 
barbero 		barber 
barco 		bark barque 
barco de remos 		row‐boat rowing‐boat 
barco de vapor 		steamship 
barman 		barman bartender 
baronesa 		baroness 
barraca 		barrack barn shack shanty shed 
barra de chocolate 		barofchocolate 
barrena 		bore 
barrendero 		sweeper 
barrer 		sweep 
barricada 		barricade 
barrio 		district neighbourhood quarter 
barrio bajo 		back street slum 
barro 		mud 
barítono 		baritone 
barómetro 		barometer 
barón 		baron 
basalto 		basalt whimstone 
basar 		base 
bastante 		a little rather some somewhat tosomeextent 
bastar 		suffice 
bastardo 		bastard 
bastidor 		flat 
basurero 		dump refuse dump tip rubbishtip 
bata 		négligé undress 
batalla 		action battle scuffle struggle 
batallón 		battalion 
batata 		sweet potato yam 
batería 		battery 
batista 		batiste cambric lawn 
baya 		berry 
bayeta 		baize 
bazar 		bazaar fair market 
baúl 		trunk 
bañador 		swimmingtrunks 
bañar 		bathe 
bañarse 		bathe haveabath 
bañero 		bath superintendant bathssuperintendant 
baño 		bath 
beber 		drink 
bebida 		beverage drink 
bebé 		baby 
beige 		beige 
belga 		Belgian 
belleza 		beauty 
bencina 		gasolene gasoline petrol 
besar 		kiss 
beso 		kiss 
bestia 		animal beast 
bestial 		beastly bestial 
biblioteca 		library 
bicarbonato 		bicarbonateofsoda 
bicicleta 		bike cycle bicycle 
bien 		okay well 
bienvenida 		welcome 
bife 		steak beefsteak 
biftec 		steak beefsteak 
bigoti 		moustache 
bilis 		bile gall 
billete 		bill ticket note 
billete del tren 		railway ticket trainticket 
billete de banco 		bank‐note 
billete de entrada 		admissionticket 
billete de equipaje 		luggageticket 
billete de ida y vuelta 		return‐ticket 
billete de viaje 		ticket 
billete por un día 		day‐ticket 
biquini 		bikini 
birrete 		beret 
bisnieta 		greatgranddaughter 
bisnieto 		greatgrandson 
bistec 		steak beefsteak 
bisté 		steak beefsteak 
bizcocho 		bicuit 
blanco 		white 
bloc de notas 		notepad 
bloque 		block pad 
blusa 		blouse 
boca 		mouth 
bocadillo 		roll 
boca arriba 		backward onone'sback 
bocina 		hooter 
boda 		wedding wedding‐party 
boina 		beret 
bola 		chunk clod lump 
bolsa 		hand‐bag 
bolsa de trabajo 		employment exchange labor exchange labourexchange 
bolsa para bicicletas 		cycle‐bag 
bolsa para señoras 		lady's bag vanitybag 
bolígrafo 		ballpointpen 
bomba 		bomb 
bomba atómica 		atombomb 
bomba incendiaria 		incendiarybomb 
bombón 		bonbon bon‐bon 
bondad 		goodness 
boniato 		sweet potato yam 
bonito 		affable friendly good‐natured kind 
borde 		border brim brink edge edging fringe rim 
borracho 		drunk intoxicated 
bosque 		forest woods 
bota 		boot 
bota de montaña 		mountaineeringboot 
botella 		bottle 
botella de gas 		gas cannister gascylinder 
botica 		chemist's shop drugstore 
boticario 		chemist 
botón 		button 
botón de presión 		push‐button 
boxeador 		boxer 
boya 		buoy 
braguitas 		briefs 
branquia 		gill 
brasileña 		Brazilianwoman 
brasileño 		Brazilian 
bravo 		brave courageous valiant 
brazalete 		bracelet 
brazo 		arm 
brema 		bream 
brezal 		heath 
brillar 		shine 
britano 		Briton 
británico 		British 
brocha de afeitar 		shaving‐brush 
broma 		gag joke 
bromear 		jest joke 
bronco 		abrupt 
brumoso 		fuzzy misty 
brusco 		abrupt 
brusko 		brutal gruff harsh rough sour surly unkind unpleasant 
brújula 		compass 
bucear 		dive plunge 
buenas noches 		goodnight 
buenas tardes 		goodevening 
bueno 		good nice okay 
buenos días 		goodmorning 
buey 		ox 
buho 		owl 
bujía 		plug sparkplug 
bula 		indulgence 
burdel 		brothel 
burla 		gag joke 
burro 		ass donkey 
buscar 		fetch get pickup 
butaca 		armchair 
butifarra de hígado 		liversausage 
buzón 		letterbox mailbox 
bálsamo 		balm balsam 
báltico 		Baltic 
bárbaro 		barbarian 
bázico 		basic 
búfalo 		buffalo 
búlgara 		Bulgarianwoman 
búlgaro 		Bulgarian 
cabal 		absolute complete 
caballero 		cavalier knight 
caballería 		cavalry 
caballo 		horse 
caballos 		horsepower 
caballo padre 		stallion 
cabana 		cabin hut shack 
cabeza 		head pate 
cabina 		bathingbox 
cabina telefónica 		call box telephone kiosk phone booth telephonebooth 
cable 		cable 
cable de remolque 		towing‐line 
cabra 		goat 
cabrón 		he‐goat 
cacahuete 		peanut 
cacahué 		peanut 
cacao 		cocoa 
cacerola 		casserole saucepan 
cacto 		cactus 
cada vez 		each time everytime 
cadena 		chain 
cadena antideslizante 		non‐skidchain 
cadera 		hip 
caer 		drop fall 
caer enfermo 		be taken ill fallill 
cafetera 		coffee‐pot 
cafetería 		cafetaria 
café 		café coffee‐house 
caja 		cashier's stand fund money box money‐box till 
caja de cambios 		gear‐box gear‐case 
cal 		lime 
calabacín 		courgette zucchini 
calabaza 		calabash gourd 
calamar 		sepia 
calcetín 		sock 
calcular 		calculate count figure workout 
caldo 		bouillon 
calefacción 		heating 
calefacción central 		centralheating 
calendario 		almanac 
calentar 		heat stoke 
calidad 		property quality 
caliente 		warm 
callarse 		bequiet 
calle 		street 
calleja 		alley lane 
callo 		corn 
calmar 		appease calm quiet soothe still 
calmarse 		abate subside 
calor 		heat 
caloría 		calorie 
calumniar 		slander 
calzador 		shoe‐horn shoe‐lift 
calzoncillos 		drawers panties underpants 
cama 		sleeping‐accomodation sleeping‐place 
camarera 		dressing‐gown 
camarero 		waiter 
camarote 		cabin 
cama de matrimonio 		doublebed 
cambiar 		alter change 
cambio 		variety 
camello 		camel 
camilla 		litter strecher 
camino 		path road way 
camino sin salida 		blind alley cul‐de‐sac 
camisa 		shirt 
camisa de deporte 		sportsshirt 
camiseta 		shirt 
camisón 		night‐shirt 
camita 		bedstead 
camita de niño 		child's bed cot 
camión 		lorry truck 
camote 		sweet potato yam 
campamento 		camping ground campingsite 
campana 		hood suctionapparatus 
campanilla 		bell 
campesino 		farmer 
camping 		camping ground campingsite 
campo 		field 
campo deportivo 		sportsground 
campo santo 		cemetery God's acre graveyard 
canal 		canal channel 
canapé 		couch sofa 
canario 		Canary 
canción 		song 
candelero 		candlestick 
cangrejo 		crayfish 
cansado 		tired 
cansar 		fag out jade overdrive override 
cantar 		sing 
cantidad 		quantity 
cantor 		singer 
cantora 		singer femalesinger 
cantábrico 		Cantabrian 
caos 		chaos tangle 
capacidad 		ability 
capaz 		able capable 
capital 		capital 
capitanear 		govern head up restrain 
capitular 		capitulate surrender 
capitán 		boss chief leader 
capot 		bonnet hood 
cara 		face 
caracol 		snail 
carburador 		carburettor 
carbón 		charcoal 
cardo 		thisle 
carga 		burden charge load 
cargar 		burden load 
cargo 		accusal accusation 
carnada 		bait 
carnaval 		carnival 
carne 		flesh 
carnero 		ram tup 
carnestolendas 		carnival 
carnet 		notebook 
carnet de conducir 		driving‐licence 
carne de cerdo 		pork 
carne de cordero 		lamb 
carne de ternera 		veal 
carne de vaca 		beef 
carne picada 		mincedmeat 
carne salada 		salt meat saltedmeat 
carnicero 		butcher 
carnicería 		butcher'sshop 
carné 		attempt test 
caro 		dear expensive valuable 
carrera 		career 
carrete 		film 
carretera 		motor road motorway 
carretera principal 		majorroad 
carretera resbaladiza 		dangerofskidding 
carretera secundaria 		by‐way side‐way 
carrete de rueda 		hub nave 
carro 		cart chariot 
carrocería 		body coach‐work 
carroña 		carrion 
carta 		letter 
carta aérea 		air letter aerogramme 
cartearse 		correspond 
cartel 		notice placard poster 
cartera 		wallet 
cartero 		postman 
casa 		house 
casada 		married 
casado 		married 
casarse 		marry be married getmarried 
casa de huéspedes 		boarding house boardingschool 
cascada 		waterfall 
cascajo 		broken stones chippings road‐metal rubble stone‐chippings 
casi 		almost nearly 
caso 		affair case matter 
caspa 		dandruff 
castaña 		chestnut horse‐chestnut 
castaño 		chestnut‐tree 
castellano 		Castillian 
castigar 		punish 
castigo 		redemption 
castillo 		castle 
castor 		beaver 
catalán 		Catalonian 
catecismo 		catechism 
catedral 		cathedral 
catorce 		fourteen 
catálogo 		catalogue directory 
católico 		Catholic 
cauce 		bed watercourse 
caucho 		rubber 
caudillo 		boss chief leader 
causa 		cause reason 
causar 		activate cause giveriseto 
cavar 		dig grub spade 
cazar 		chase hunt 
caótico 		chaotic 
caña 		fishingrod 
caña de pescar 		fishingrod 
cebada 		barley 
cebo 		bait 
cebolla 		onion 
cebollana 		chive 
ceder 		cede give in give up give way relinquish yield 
ceja 		brow eyebrow 
celebrar 		celebrate 
celebrar su cumpleaños 		celebratingone'sbirthday 
celebrar una fiesta 		celebrate 
celo 		fervor fervour zeal 
cementerio 		cemetery God's acre graveyard 
cena 		dinner middaymeal 
cenicero 		ashtray 
ceniciento 		ashen 
ceniza 		ash cinder 
censura 		censor 
censurable 		blameworthy censurable condemnable objectionable 
censurar 		censor 
centeno 		rye 
central 		central 
centro 		centre 
centímetro 		centimetre 
cepillar 		brush 
cepillo 		brush 
cepillo de dientes 		tooth‐brush 
cerca 		close near nearby 
cercar 		bar obstruct 
cerca de 		at beside by near nearby near to nextto 
cerda 		sow 
cerdo 		hog pig swine 
cerebro 		brain 
ceremonia 		ceremony 
cereso 		cherry‐tree 
cereza 		cherry 
cero 		nought zero 
cerrado 		closed shut 
cerradura 		lock 
cerrar 		close shut 
certificación 		certificate testimony 
certificado 		certificate testimony 
certificar 		record register 
cerveza 		ale beer 
cerámica 		crockery earthenware pottery 
cesión 		abandonment 
cesto 		basket 
chal 		shawl 
chaleco 		vest waistcoat 
champaña 		champagne 
champiñon 		mushroom 
champú 		shampoo 
chanza 		gag joke 
chaqueta 		jacket 
charco 		pool 
charlar 		chat chatter 
chauffeur 		chauffeur driver 
checo 		Czech 
cheque 		check cheque 
chicle 		chewing‐gum 
chico 		boy lad laddie 
chilena 		Chileanwoman 
chileno 		Chilean 
chino 		Chinese 
chispa 		spark 
chocar kun 		collide with crashinto 
chocolate 		chocolate 
choque 		collision 
chuleta 		cutlet 
chupar 		suck 
chófer 		conductor driver 
ciclo 		cycle 
ciclomotor 		moped 
ciclón 		cyclone 
ciego 		blind 
cielo 		heaven sky 
ciencia 		science 
ciento 		hundred onehundred 
ciertamente 		certainly 
cierto 		certain sure 
cifra 		cipher digit figure numeral 
cigarillo 		cigarette 
cigarro 		cigar 
cilindro 		cylinder roller 
cincel 		chisel 
cinco 		five 
cine 		cinema movietheatre 
cinta 		bond tie 
cinta pegante 		adhesivetape 
cinto 		belt girdle 
cintura 		waist waistline 
cinturón 		belt girdle 
ciprés 		cypres 
circo 		circus 
circuito 		circuit 
circular 		circular 
circuncisión 		circumcision 
circunspecto 		thoughtful 
ciruela 		plum 
cirujano 		surgeon 
cita 		citation quotation 
citación 		citation quotation 
citar 		cite quote 
ciudad 		city town 
ciudadela 		citadel 
civil 		civil civilian non‐military 
civilización 		civilization 
cizalla para setos 		hedge clippers hedgeshears 
claro 		bright clear light 
clase 		class 
clasificar 		classify 
clavel 		carnation pink 
clavo 		nail 
cliente 		buyer client purchaser 
clientela 		clientèle 
clima 		climate 
cloaca 		sewer 
cloro 		chlorine 
club 		club society 
cláusula 		clause 
coartada 		alibi 
cobertizo 		penthouse shed 
cobrador 		guard 
cobre 		copper 
cocaína 		cocaine 
cocer 		bake 
coche‐cama 		sleeping‐car 
coche 		car 
coche remolque 		trailer 
cochina 		sow 
cochinillo 		piglet 
cocina 		kitchen 
cocinar 		cook 
cocinera 		cook femalecook 
cocinero 		cook malecook 
cocodrilo 		crocodile 
codiciar 		covet 
codicioso 		acquisitive eager greedy 
codo 		elbow 
coger 		clutch grab grasp grip seize 
cohete 		rocket 
cojear 		limp 
cojo 		lame 
col 		cabbage 
cola 		glue 
colcha de cama 		bedspread counterpane coverlet 
colchón 		mattress 
colecta 		collection 
colega 		colleague 
colegio 		college 
coles de Bruselas 		Brussels‐sprouts 
colgar 		droop hang 
coliflor 		cauliflower 
colina 		hill 
colisión 		collision 
colocar 		invest 
colonia 		colony settlement 
color 		colour dye 
columna 		column pillar 
comadrona 		nurse dry‐nurse monthlynurse 
comandante 		boss chief leader 
comarca 		region 
combiar 		change 
combinación 		combination 
comedor 		dining‐room 
comenzar 		begin commence start 
comer 		lunch 
comerciante 		merchant 
comercio 		business commerce trade 
comerse 		eatup 
comestible 		edible 
comestibles 		food 
cometer 		achieve act do make perform 
comida 		meal 
comienzo 		beginning commencement start 
comisaría 		police‐station 
comisión 		commission 
comitiva 		procession 
comité 		committee 
communicación 		account communication 
como 		how inwhatway 
como es debido 		decently properly 
como si 		as if as though inaway 
compadecer a 		have compassion on pity 
comparar 		compare 
compartir 		divide separate share 
compañero 		colleague 
compañía 		company 
compensar 		compensate 
competencia 		competition 
competidor 		rival 
competir 		compete rival 
complacer 		meet with satisfy 
complekso 		complex 
completamente 		completely entirely through 
completar 		complete 
completo 		absolute complete 
componerse 		consistof 
compositor 		composer 
compra 		accession acquisition asset 
comprador 		buyer client purchaser 
comprender 		understand realize 
comprendido 		understood 
comprensible 		understandable 
compromiso 		accommodation 
computador 		computer 
computar 		calculate count figure workout 
comunicación 		connection 
comunicar 		communicate report 
comunista 		communist 
comunión 		communion 
común 		commonplace dismal trite 
con 		with 
concernir 		concern 
concha 		shell 
concierto 		concert 
concisión 		brevity briefness conciseness 
conciso 		concise 
concluir 		accomodate end finish terminate 
conclusión 		conclusion inference 
concordación 		accord accordance agreement concurrence 
concurso 		competition contest 
condenar 		condemn sentence 
condición 		circumstance 
condom 		condom rubber 
conducir 		conduct guide lead 
conducirse 		behave conductoneself 
conejo 		rabbit 
conejo macho 		buck buck‐rabbit 
conexión 		relation 
confección 		making manifacture 
conferencia 		conference 
confesar 		acknowledge admit confess profess 
confesión 		acknowledgement admission confession 
confianza 		confidence 
confirmación 		confirmation 
confirmar 		affirm assent sayyes 
confiscar 		confiscate 
conflicto 		conflict 
conforme 		agreed okay 
congreso 		congress convention 
conminación 		menace threat 
conminar 		menace threaten 
conmovedor 		affecting moving touching 
conmover 		move stir 
conmovido 		seizedwithemotion 
conocido 		famous 
conocimiento 		acquaintance knowledge 
conocimientos 		fame renown 
conquistar 		conquer 
consecuencia 		consequence consistency 
consecuente 		consistent 
consecutivo 		following next 
conseguir 		succeed 
consejero 		counsellor 
consejo 		advice counsel 
consentir 		spoil 
consequir 		achieve acquire attain get obtain 
conserje 		porter 
conservación 		conservation maintenance preservation retention 
conservador 		conservative 
conservar 		conserve keep maintain preserve 
conservatorio 		academyofmusic 
considerable 		considerable sizable 
consideración 		consideration deliberation 
considerar 		account consider esteem regard takeintoaccount 
consolar 		comfort console 
constipado 		constipation 
constitución 		constitution 
construcción 		accommodation adjustment arrangement 
construir 		build construct 
consulado 		consulate 
consulta 		consultation 
consumidor 		consumer 
consumir 		consume useup 
consumo 		demand sale 
contable 		book‐keeper 
contacto 		contact 
contador público 		accountant 
contagiado 		contaminated infected 
contagiar 		infect 
contagioso 		catching contagious infectious 
contante 		cash incash 
contar 		count 
contemplación 		consideration deliberation 
contemplar 		account consider esteem regard takeintoaccount 
contemporáneo 		current present 
contener 		bridle check restrain 
contento 		contented pleased satisfied 
contestación 		answer reply 
contestar 		answer reply respond 
contestar a 		answer 
contiguo 		adjacent 
continuamente 		constantly continually continuously 
continuar 		continue hold last 
continuo 		abiding lasting 
contra 		across from against in exchange for opposed to opposite upon 
contradecir 		contradict 
contramandar 		cancel countermand 
contraste 		contrast 
contratar 		invite tenders for putouttotender 
contrato 		contract 
contribución 		tax 
contribuyente 		ratepayer taxpayer 
controlar 		audit check check up on supervise verify 
conulla 		inverted comma quotation mark quote 
conullas 		quotation marks quotes 
convencer 		convince persuade 
convenido 		agreed okay 
conveniente 		decent fitting proper suitable 
convenio 		accord accordance agreement concurrence 
convenir 		befit befitting 
convento 		monastery 
conversar 		converse 
conversión 		conversion 
convertir 		convert 
con motivo de 		because of onaccountof 
copa 		goblet 
copia 		copy 
copiar 		copy 
copla 		verse 
copo de nieve 		snowflake 
corazón 		heart 
corbata 		tie necktie 
corcho 		cork 
cordel 		line 
cordero 		lamb 
cordillera 		chain of mountains mountain chain mountain range rand 
cordón 		shoe‐lace 
coronar 		crown 
correcto 		correct right 
corregir 		correct 
correo 		mail post 
correo aéreo 		airmail 
correr 		flow 
corresponder al 		answer answer to comeupto 
corriente 		current flow stream 
corromper 		spoil 
corrupción 		corruption 
cortacircuito 		shortcircuit 
cortar 		cutoff 
cortesía 		politeness 
corteza 		bark 
cortina 		curtain 
corto 		short 
cortés 		courteous polite well‐mannered 
corzo 		roe 
cosa 		thing 
cosecha 		harvest 
coser 		sew 
costa 		coast seaside shore 
costar 		cost 
costear 		bear the cost of defray the cost of paytheexpensesof 
costumbre 		custom habit way 
costura 		seam 
costurera 		tailor femaletailor 
coñac 		brandy cognac 
crecer 		accrue grow 
creer 		account accredit believe deem 
crema 		cream 
cremallera 		zipper 
crema para zapatos 		polish wax 
crepe 		pancake 
criada 		maid servant 
criado 		boy servant 
crimen 		crime 
crisis 		crisis depression emergency 
cristianismo 		Christianity 
cristiano 		Christian 
criticar 		censure criticize 
cruce 		crossroads 
crudo 		crude raw rough 
cruz 		cross 
cráneo 		skull 
crítica 		criticism 
crítico 		alarming grave serious 
cuadra 		stable stall sty 
cuadro 		bed 
cuartel 		barracks 
cuarto 		apartment flat 
cuarto de baño 		bathroom 
cuatro 		four 
cubierta 		deck 
cubierto 		forks knivesandspoons 
cubierto de verdor 		covered grown over overgrown 
cubo 		bucket pail 
cubrir 		cover 
cucaracha 		cockroach 
cuchara 		spoon 
cuchichear 		whisper 
cuchillo 		knife 
cuello 		neck 
cuenta 		account bill invoice 
cuenta bancaria 		bank account bankingaccount 
cuerda 		cord rope string 
cuerno 		horn 
cuero 		leather 
cuerpo 		body 
cuervo 		raven 
cuesta 		acclivity hillside slope 
cuesta abajo 		down the slope downhill 
cueva 		cave grotto 
cuidado 		care concern 
cuidar 		attend nurse tendto 
cuidarse de 		care about takecareof 
cuidar de 		lookafter 
culpa 		blame fault guilt 
culpable 		guilty 
cultivar 		cultivate grow 
cultivo 		planting 
culto 		service worshipservice 
cultura 		culture 
cumpleaños 		birthday 
cumplimiento 		replacement replenishment supplement 
cuna 		cradle placeofbirth 
cuota 		dues subscription 
cupón 		coupon 
cura 		treatment 
curar 		care for cure treat 
curioso 		agog curious inquisitive 
cursillo 		class course 
curso 		class course 
curva 		bend curve 
curvar 		bend 
cáliz 		goblet 
cámara 		camera 
cámara de películas 		camera 
cándido 		guileless inoffensive 
cápsula 		capsule firing‐cap 
cáscara 		bark husk peel shell 
célula 		cell 
címbalo 		cymbal 
cínico 		cynical 
círculo 		circle 
cítara 		zither 
código 		code 
cólera 		cholera 
cómico 		amusing entertaining funny 
cómo 		how inwhatway 
cómodo 		homy 
cónsul 		consul 
dado que 		supposingthat 
dama 		lady 
damas 		checkers 
danés 		Danish 
dar 		give 
darse de baja 		quit resign 
darse tono 		attitudinize pose putonairs 
dar a destajo 		invite tenders for putouttotender 
dar a la bomba 		pump 
dar a luz 		bear givebirthto 
dar dentelladas a 		snap at snarl at snub 
dar de comer 		feed 
dar el pésame a 		expresscondolences 
dar gracias a 		thank 
dar la bienvenida 		welcome 
dar lugar a 		cause causetotakeplace 
dar parte de 		issue proclaim 
dañar a 		be detrimental to detract from doharmto 
daño 		damage 
de 		from of 
debajo de 		below beneath under underneath 
deber 		duty obligation 
debutante 		beginner 
decadencia 		decay 
decentar 		cutinto 
decidirse 		decide 
decir 		say tell 
decisivo 		decisive 
decisión 		decision 
declaración 		declaration proclamation statement 
declarar 		declare state 
declararse en huelga 		strike 
decorar 		adorn decorate ornament 
decrecer 		abate decrease diminish drop fall 
decrépito 		decayed decrepit dilapidated lapsed rickety 
decudir 		abstract deduce gather 
decímetro 		decimetre 
dedo 		finger 
dedo de pie 		toe 
deducción 		demand sale 
deducir 		countdown 
defecto 		damage 
defender 		protect 
defensa 		defence defense 
definir 		define determine 
dejar 		allow leave let release 
dejar en pos 		leavebehind 
dejo 		accent 
delante 		ahead formerly previously 
delante de 		before infrontof 
delatar 		accuse denounce 
delegar 		delegate 
deletrear 		spell 
demandar 		ask ask for beg bid request 
demasiado 		too toomuch 
demoler 		break down demolish pull down takedown 
demolición 		demolition 
demontar 		takeapart 
demostrable 		apparent 
demás 		besides in addition moreover 
dengoso 		prudish 
dentista 		dentist 
dentro 		inside 
dentro de 		a in inside into on per within 
denuncia 		accusation 
denunciar 		accuse 
departamento 		compartment coupé 
departamento de fumar 		smokers 
dependencia 		dependence 
depender 		depend 
depender de 		be dependent on dependonldependupon 
dependienta 		saleswoman 
dependiente 		dependent 
deplorable 		regrettable 
deplorar 		be sorry about regret 
deporte 		sport 
depositar 		deposit 
depósito 		depository 
depósito de gasolina 		gas tank petroltank 
derecho 		claim presumption pretence 
derechos de consumo 		excise excise‐duty 
derivación 		derivation 
derivar 		derive 
derivar del rumbo 		drift beadrift 
derramar 		pour scatter shed 
derretir 		melt 
derretirse 		melt 
derribar 		break down demolish pull down takedown 
derribos 		rubbish oldmaterials 
derrota 		defeat 
derruirse 		crumble crumble away crumbleoff 
desaconsejar 		advise against dissuadefrom 
desacostumbrar 		break of a habit teach 
desagüe 		draining 
desanimado 		dejected depressed 
desaprender 		unlearn 
desaprobación 		censure condemnation disapprobation disapproval 
desaprobar 		condemn disapprove disapprove of rebuke 
desarrollar 		account for explain 
desatinar 		drivel twaddle 
desayuno 		breakfast 
descalzo 		barefoot 
descansar 		repose rest 
descanso 		break intermission pause recess 
descargar 		writeoff 
descendencia 		lineage 
descender 		accrue come derive originate result 
descendiente 		offspring successor 
descolgar 		abstract takeaway 
desconcharse 		flake off peel off scaleoff 
desconocido 		unknown 
descortés 		rude 
describir 		describe 
descripción 		account description 
descubrimiento 		discovery 
descubrir 		discover uncover 
descuento 		abatement discount rebate 
descuidado 		careless negligent 
descuidar 		neglect 
desde 		from since 
desear 		ache 
desechos 		clippings cuttings parings refuse rubbish waste windfall 
desembarcadero 		landing‐stage pier 
desembocadura 		mouth 
desempeñar 		occupy take 
desenfrenado 		lawless licentious riotous 
desentenderse de 		ignore leaveoutofaccount 
deseo 		avidity covetousness eagerness greediness 
deserción 		apostasy defection 
desertar 		apostatize desert secede 
desfiladero 		pass 
desgastarse 		wear away wear off wearout 
desgracia 		accident 
desgraciadamente 		unfortunately 
deshielo 		melting thaw 
deshonesto 		nasty 
desierto 		desert 
designar 		indicate suggest 
desigual 		bumpy 
desinteresado 		disinterested 
desistir de 		relinquish renounce waive 
deslumbar 		dazzle 
desmayado 		unconscious 
desmayarse 		faint swoon 
desmayo 		faint swoon 
desmejorarse 		decline go back falloff 
desmoronarse 		crumble crumble away crumbleoff 
desnatar 		cream skim 
desnudo 		bare naked nude 
despachar 		dispatch send off ship 
despacho 		demand sale 
despedida 		farewell goodbye good‐bye 
despedir 		dismiss turnaway 
despedirse 		say goodbye say goodbye to take leave takeleavefrom 
despeñadero 		abyss chasm gulf precipice 
despojar 		rob 
despreciar 		despise 
desprecio 		contempt 
desprendimiento de tierras 		landslide 
despuntar 		blunt 
después 		after behind 
destajar 		makeacontract 
destajista 		builder contractor building contractor masterbuilder 
destajo 		contract 
desterrado 		exile 
destierro 		exile 
destinatario 		consignee recipient 
destino 		destiny fate 
destituir 		depose 
destornillador 		screwdriver 
destreza 		expertness skilfulness skill skillfulness 
destruir 		destroy quash 
desviar 		divert 
desviarse 		deviate 
desván 		attic 
desvío 		aberrance aberration 
detalle 		detail 
detective 		detective 
detención 		apprehension arrest detention 
detener 		arrest 
detenido 		arrested person prisoner 
deterioración 		corruption decay depravation taint 
deteriorar 		damage injure spoil 
deterioro 		damage 
determinar 		determine fix 
detestar 		abhor abominate loathe 
detrimento 		harm 
detrito 		clippings cuttings parings refuse rubbish waste windfall 
detrás 		at the back behind intherear 
detrás de 		behind after 
deuda 		debt 
deudo 		relative 
devanar 		unroll unwind windoff 
devolver 		give back return 
de acuerdo 		agreed okay 
de aire acondicionado 		airconditioned 
de confianza 		reliable trustworthy 
de cuando en cuando 		nowandthen 
de dia 		by day duringtheday 
de espaldas 		backward onone'sback 
de golpe 		all of a sudden suddenly 
de hierro 		iron 
de madera 		wooden 
de mala fama 		ofillrepute 
de memoria 		byheart 
de nilón 		nylon 
de ninguna manera 		by no means in no way not at all notonanyaccount 
de ningún modo 		notatall 
de nuevo 		afresh again all over again anew 
de otra manera 		differently else 
de paso 		bytheway 
de poca profundidad 		shallow superficial 
de prisa 		fast quickly swiftly 
de propósito 		deliberately onpurpose 
de repente 		all of a sudden suddenly 
de segunda mano 		second hand secondhand 
de sopetón 		all of a sudden suddenly 
de todos los días 		daily 
de veras 		absolutely genuinly indeed really truly 
diabetes 		diabetes 
diamante 		diamond 
diariamente 		daily 
diario 		daily 
diarrea 		diarrhoea 
dibujar 		design draw 
diccionario 		dictionary vocabulary 
dicho 		concerned inquestion 
diciembre 		December 
dieciocho 		eighteen 
diestro 		adroit clever dexterous skillful 
dieta 		diet 
dietario 		agenda appointmentbook 
diez 		ten 
diez y nueve 		nineteen 
diez y ocho 		eighteen 
diez y seis 		sixteen 
diez y siete 		seventeen 
diferencia 		difference 
diferente 		different 
diferir 		differ bedifferent 
dificil 		difficult hard inconvenient 
dificultar 		hamper hinder thwart 
difundir 		send transmit 
digestión 		digestion 
digresar 		stray from one's subject wanderfromone'ssubject 
dimensión 		dimension measurement 
dimitir 		resign 
dinamarqués 		Danish 
dinero 		money 
dinero del embase 		pledge security 
diputado 		delegate 
diputar 		delegate 
dirección 		address 
directamente 		at once instantly immediately withoutdelay 
director 		director manager 
directorio 		addresslist 
dirigir 		address 
dirigirse 		go 
dirigirse a 		accost address 
dirigir la palabra a 		accost address 
disco 		grammophonedisc 
discreto 		discrete 
discriminación 		discrimination 
disculpa 		apology 
disculparse 		apologize 
disferente 		different 
disfrutar 		delight in enjoy 
disminuir 		abate decrease diminish 
disponible 		available 
disposición 		ability capability fitness suitability 
disputar 		quarrel wrangle 
dispénseme 		excuseme 
distancia 		distance offset 
distinguir 		distinguish 
distinto 		different 
distracción 		distraction diversion 
distraer 		distract divert entertain 
distraído 		absent‐minded abstracted distracted 
distribuir 		distribute 
distrito 		district 
divergente 		different 
diversión 		amusement fun 
divertido 		amusing entertaining funny 
divertimento 		amusement fun 
divertir 		amuse 
divertirse 		enjoy oneself haveagoodtime 
dividir 		divide separate share 
divorcio 		divorce 
divulgar 		publish reveal 
diámetro 		diameter 
doblar 		fold 
doble 		double dual 
doce 		twelve 
doctor 		doctor physician 
documento 		document paper 
doler 		ache be painful hurt 
dolerse por 		have compassion on pity 
dolor 		ache pain 
dolor de muelas 		toothache 
domesticado 		tame 
domicilio 		abode dwelling‐place residence 
dominga de Ramos 		PalmSunday 
domingo 		Sunday 
donde 		where 
dormir 		be asleep sleep 
dos 		two 
dosis 		dose 
dos veces 		twice 
dotado 		gifted talented 
dotar 		endow 
dromedario 		dromedary 
ducha 		shower 
ducharse 		takeashower 
duda 		hesitation wavering 
dudar 		doubt 
dueño 		boss chief leader 
dueño de sí mismo 		composed restrained self‐possessed 
dulce 		gentle soft sweet tender 
durar 		continue endure keep on last 
duro 		hard 
dyschatell 		couch divan 
dátil 		date 
débil 		faint light weak 
día 		day 
día del Corpus 		CorpusChristi 
dólar 		dollar 
dómine 		pastor 
ebrio 		drunk intoxicated 
echar 		throw 
echar a perder 		spoil 
echar la siesta 		doze nap slumber 
económico 		thrifty 
edad 		age 
edad media 		MiddleAges 
edecán 		adjutant aide‐de‐camp 
edificar 		erect establish 
edificio 		building 
edificio anexo 		annexation 
editor 		publisher 
eficaz 		effective effectual efficacious 
efigie 		effigy head 
egipcio 		Egyptian 
egipcíaco 		Egyptian 
egoísta 		self‐interested selfish 
eje 		axis axle 
ejemplo 		example 
ejercicio 		exercise practice 
ejército 		army 
el 		the 
elección 		choice election 
electricidad 		electricity 
elefante 		elephant 
elegante 		elegant 
elegir 		choose elect pickout 
elevación 		altitude height 
ella 		her she 
eléctrico 		electric 
el día de Todos los Santos 		AllSouls'Day 
embajada 		embassy 
embajador 		ambassador 
embalsamar 		embalm 
embarcación 		ship vessel 
embarcarse 		embark 
embargar 		confiscate 
embelesar 		charm 
embotado 		blunt 
embragar 		couple 
embriaguez 		drunkenness inebriety 
embudo 		funnel 
embuste 		swindle 
embustero 		cheat deceiver imposter 
emigrar 		emigrate 
emigrarse 		emigrate 
emoción 		emotion 
empacar 		pack package wrapup 
empalmar 		correspond 
empalme 		connection 
empezar 		begin commence start 
empleado 		employee 
emplear 		apply practice 
empleo 		post 
emprender 		undertake 
empresa 		industry 
empujar 		push thrust 
en 		a in inside into on per within 
enamorarse de 		fallinlovewith 
encadenación 		order 
encadenamiento 		order 
encajar 		palmoffon 
encaje 		lace 
encamado 		bedridden confined to one's bed laidup 
encantador 		charming lovely 
encantar 		attract draw 
encanto 		charm 
encargarse de 		undertake 
encendedor 		lighter 
encender 		burn 
encentar 		cutinto 
enciclopedia 		encyclopaedia 
encima de 		above over 
encogido 		afraid timid 
encontrar 		come across encounter meet see 
encontrarse 		be found be located findoneself 
encuadernación 		binding cover 
encuentro 		encounter 
encuesta 		inquiry investigation 
encía 		gum 
endrino 		sledge sleigh 
enemigo 		adversary enemy 
enero 		January 
enfermedad venérea 		venerealdisease 
enfermera 		nurse 
enfrenar 		brake 
enfrente de 		opposite 
enfriar 		cool cooldown 
engañar 		fool hoax mystify trick 
engaño 		swindle 
engañoso 		deceptive delusive fallacious 
enjugar 		dry 
enlace 		startingpoint 
enmohecerse 		getmouldy 
enorme 		enormous 
enrollar 		envelop 
ensalada 		salad 
ensangrentado 		blood‐stained coveredwithblood 
enseñar 		indicate suggest 
enteblar 		begin commence start 
entender 		understand realize 
enteramente 		at all entirely quite wholly 
entero 		entire overall whole 
enterramiento 		burial funeral interment 
enterrar 		bury 
entierro 		burial funeral interment 
entonar 		intone raise 
entonces 		then 
entrada 		entrance portal 
entrante 		future 
entrar 		go in enter perform 
entrar en cuenta 		be considered count 
entre 		among between 
entrecortado 		broken 
entrega 		delivery 
entregar 		hand handover 
entretener 		amuse 
entristecer 		afflict grieve 
envejecer 		be on the decline go downhill gooff 
envenenar 		poison 
enviar 		dispatch send off ship 
envidia 		envy 
envidiar 		envy 
envidioso 		envious 
envolver 		pack package wrapup 
en alta voz 		loudly 
en casa 		athome 
en cuanto a 		about concerning 
en cuestón 		concerned inquestion 
en efecto 		absolutely actually infact 
en el acto 		at once immediately just right away rightnow 
en el extranjero 		abroad 
en el fondo 		below downstairs underneath 
en ninguna parte 		nowhere 
en orden 		agreed okay 
en otra parte 		elsewhere 
en parte 		partially partly 
en pos 		at the back behind intherear 
en primer lugar 		first firstly firstofall 
en principio 		inprinciple 
en realidad 		absolutely genuinly indeed really truly 
en seguida 		at once instantly immediately withoutdelay 
en su mayor parte 		for the greater part forthemostpart 
en todas partes 		all about everywhere 
en todos conceptos 		ineveryway 
en torno de 		about round around towards 
en un principio 		at first at the outset inthebeginning 
en vano 		invain 
equipaje 		baggage luggage 
equipajes 		baggage luggage 
equis 		X 
equivocación 		aberration error mistake 
equivocarse 		err makeamistake 
error 		aberration error mistake 
escala 		ladder 
escalar 		ascend climb scale 
escalera 		staircase stairs 
escama 		scale 
escandaloso 		aggravating 
escandálo 		offence scandal 
escaparate 		showwindow 
escarola 		endive 
escarpado 		abrupt steep 
escaño 		bank 
esclusa 		lock sluice 
escocés 		Scottish 
escoger 		choose elect pickout 
escombro 		mackerel 
escopeta 		gun rifle 
escribir 		write 
escribir a máquina 		type 
escrupuloso 		accurate scrupulous 
escuchar 		listen 
escuela 		school 
escultor 		sculptor 
escupir 		spit 
esforzarse por 		aim attempt endeavour take steps undertake 
eslavo 		Slavic 
eso 		that that over there those 
espacio 		room space 
espalda 		back 
espantar 		deter discourage scare 
espanto 		fright 
esparadrapo 		plaster 
español 		Spanish 
española 		Spanishwoman 
especia 		spice 
especial 		particular special 
especie 		kind sort 
espejo 		looking‐glass mirror 
esperanto 		Esperanto 
esperanza 		hope 
esperar 		foresee 
espiga 		ear 
espinaca 		spinach 
espina dorsal 		spine 
espolear 		encourage impel instigate spur on stimulate urge 
esponja 		sponge 
esposa 		wife 
esposo 		husband 
espuma 		foam froth 
esputo 		mucus phlegm 
espárrago 		asparagus 
esqueleto 		skeleton 
esquiar 		ski 
esquimal 		Eskimo 
esquina 		corner 
esquí 		ski 
esta 		these this thishere 
establo 		stable stall sty 
estación 		season 
estación balnearia 		spa 
estación de servicio 		fillingstation 
estado 		state 
estafar 		fleece 
estandarte 		flag standard 
estanque 		pond 
estar 		be 
estar ...ando 		busyoneself 
estar de acuerdo con 		agreeto 
estar de pie 		stand 
estar sentado 		sit 
estar tendido 		lie recline 
estatua 		statue 
esta mañana 		thismorning 
esta tarde 		thisevening 
estaño 		tin 
este 		east East 
estima 		esteem regard 
estimación 		esteem regard 
estimar 		esteem thinkwellof 
estimular 		rouse stimulate stirup 
estipular 		set conditions stipulate 
estofado de carne húngaro 		goulash stew 
estorbar 		bar inhibit prevent 
estornudar 		sneeze 
estrecho 		narrow 
estrella 		star 
estrofa 		verse 
estropeado 		broken damaged 
estuche 		jug box container vessel 
estudiante 		academic student 
estudiar 		learn 
estudio 		study 
estufa 		furnace kiln oven stove 
estómago 		stomach 
es decir 		thatis 
es una lástima 		alas regrettably unfortunately 
europeo 		European 
evidente 		clear distinct plain 
evidentemente 		apparently obviously 
evitar 		avoid evade 
exacción 		exaction extortion 
exacto 		exact 
exagerar 		exaggerate 
examen 		investigation examination test 
examinar 		examine 
excelente 		fine great 
excepto 		apart from but except otherthan 
excluir 		exclude 
excursión 		excursion outing sightseeingtrip 
excusado 		toilet 
exhortación 		admonition exhortation 
exhortar 		admonish scold 
exigir 		demand postulate require 
existencia 		existence 
existir 		exist 
expedir 		dispatch send off ship 
experiencia 		experience 
experto 		experienced expert skilful skilled skillful practised 
expiración 		end terminate 
expirar 		end come to an end end up expire 
explicación 		account explanation 
explicar 		account for explain 
explotar 		exploit utilize 
exposición 		exhibition exposition 
exterior 		external outer outside 
externo 		external outer outside 
extorsión 		exaction extortion 
extra 		additional extra 
extracto 		extract infusion 
extranjero 		alien foreigner 
extraviarse 		go astray strayoff 
extremamente 		extremely 
fabricación 		making manifacture 
fabricar 		fabricate manufacture 
faisán 		pheasant 
falaz 		deceptive delusive fallacious 
falda 		skirt 
falta 		absence lack shortage shortcoming 
faltar 		be lacking bemissing 
familia 		family 
familiar 		relative 
famoso 		famous 
fardo 		bale 
farmacia 		chemist's shop drugstore 
farmacéutico 		chemist 
faro 		headlight 
farol 		lantern 
farsante 		attitudinizer poseur 
fatal 		fateful ill‐fated 
fatigar 		fag out jade overdrive override 
favor 		favor favour 
favorable 		advantageous favourable 
favorecer 		favor favour 
faz 		face 
febrero 		February 
fecha 		date 
federal 		federal 
felicitar 		congratulate 
feminino 		female feminine 
fender 		split 
fenomenal 		phenomenal 
feo 		nasty ugly 
fidedigno 		plausible 
fiebre 		ague fever 
fiel 		faithful 
fiero 		savage wild 
fiesta 		celebration festival party 
figurado 		figurative 
figurarse 		fancy imagine 
fijar 		attach determine fasten fix affix make fast secure 
fijo 		fixed 
fila 		grade rank rate 
filete 		slice 
filtro 		filter 
fin 		aim goal purpose target 
final 		end ending 
finalmente 		at last finally ultimately 
finca 		estate farm property ranch 
finesa 		Finnish Finnishwoman 
fingir 		give as an excuse pretend 
finlandesa 		Finnish Finnishwoman 
finlandés 		Finnish 
fino 		dainty delicate fine refined 
finés 		Finnish 
firma 		company firm 
firmar 		sign 
fisonomía 		face 
flamenco 		Flemmish 
flan 		cream 
flauta 		flute 
flecha 		arrow 
flema 		mucus phlegm 
flor 		bloom flower 
florin 		guilder gulden 
foca 		seal sea‐dog 
folleto 		leaflet pamphlet paperback 
fondear 		anchor 
fondo 		background 
formulario 		blank form 
forrar 		cover overlay 
forro 		lining 
forta leza 		fortress 
forzar 		compel force 
foto 		photograph 
fotografía 		photograph 
fotógrafo 		photographer 
frambuesa 		raspberry 
francesa 		Frenchwoman 
francés 		French 
franela 		flannel 
franqueo 		postage 
frase 		sentence 
fregadero 		dresser 
fregar 		washup 
freir 		fry 
freno 		brake 
freno de emergencia 		communication‐cord 
frente 		forehead 
fresa 		strawberry 
fresco 		fresh recent 
fresno 		ash 
friolera 		trifle 
frisio 		Frisian 
frisona 		Frisian Frisianwoman 
frisón 		Frisian 
frontera 		boundary frontier limit 
frontón 		façade 
frotar 		rub 
fruta 		fruit 
frutal 		fruit‐tree 
frío 		bleak chilly cold 
fuego 		fire 
fuente 		fountain 
fuera 		abroad out outside 
fuera de 		outside outsideof 
fuerte 		strong 
fuerza 		force strength vigour 
fuerza de caballos 		horsepower 
fulminante 		acute 
fumar 		smoke 
funcionar 		function operate run work 
funcionario 		officer official 
función 		function job office post 
fundar 		base 
furgón 		luggage‐van 
fusilar 		shootdead 
fábrica 		factory 
fácil 		easy facile 
fácilmente 		easily 
fécula 		potatoflour 
fécula de patata 		potatoflour 
fértil 		fertile 
física 		physics 
fósforo 		match 
gafas 		glasses spectacles 
gafas oscuras 		sun‐glasses 
gallego 		Galician 
galleta 		biscuit cookie 
gallina 		chicken fowl 
gallo 		cock rooster 
ganado 		livestock 
ganancia 		accession acquisition gain 
ganar 		earn gain win 
gancho 		hook 
ganso 		goose 
garaje 		garage 
garantía 		guarantee warrant 
garganta 		throat 
garra 		claw 
garrafa 		carafe decanter 
gas 		gas 
gasolina 		gasolene gasoline petrol 
gastado 		worn 
gastar 		pay out spend 
gastos 		charge cost expense 
gas natural 		naturalgas 
gata 		femalecat 
gato 		cat 
gaviota 		seagull 
gemelos 		twins 
gemir 		groan moan 
general 		general usual 
generalmente 		generally 
gente 		people 
geografía 		geographic geographical 
gerente 		manager 
geógrafo 		geographer 
ginebra 		gin 
girar 		turn 
giro postal 		moneyorder 
globo terráqueo 		globe worldglobe 
gobernar 		control govern restrain rule 
gobierno 		administration government 
godo 		Goth 
golondrina 		swallow 
golpe 		blow 
golpear 		beat hit strike 
goma 		rubber 
gordo 		fat fatty greasy 
gorrión 		sparrow 
gorro 		cap 
gota 		arthritis 
grabado 		image picture 
gracia 		charm 
gracias 		gratitude thanks 
gracioso 		affable friendly good‐natured kind 
grado 		degree grade 
gram 		gram gramme 
gramática 		grammar 
grande 		big great large 
granero 		barn shed stand 
granito 		granite 
granizo 		hail 
granja 		estate farm property ranch 
grasa 		fat grease 
gratitud 		gratitude 
gratuito 		free 
grave 		important serious 
greda 		chalk 
grieco 		Greek 
griega 		Greekwoman 
griego 		Greek 
grieta 		crack crevice 
grifo 		faucet tap 
gripe 		flu grip influenza 
gris 		grey 
gritar 		cry out scream shout 
grito 		cry shout 
grosella 		gooseberry 
grosero 		rude 
grueso 		bold corpulent fat thick 
grupo 		bevy collection group heap herd set 
guadaña 		scythe 
guante 		glove mitten 
guardabarros 		mudguard 
guardar 		guard preserve protect save 
guardarropa 		cloakroom 
guardavía 		signalman 
guardia 		guard 
guardiamarina 		middy midshipsman navalcadet 
guerra 		war 
guiar 		conduct direct guide head lead 
guisante 		pea 
gusano 		worm 
gustar 		please 
gusto 		taste 
guía 		leader 
gámba 		prawn 
gótico 		Gothic 
haba 		bean 
haber 		credit 
habilidad 		ability 
habitación 		chamber room 
habitante 		inhabitant 
habitar 		dwell live 
habituarse 		accustom oneself getused 
hablar 		speak talk 
hacer 		achieve act do make perform 
hacerse 		become come about grow happen 
hacer dimisión 		quit resign 
hacer incribir 		register 
hacer las compras 		shop 
hacer la manicura 		manicure 
hacer uso de 		employ use makeuseof 
hace ... 		...ago 
hace poco 		just justnow 
hacha 		axe 
hacia atrás 		backward backwards 
halcón 		falcon 
hallar 		come across encounter meet see 
hallarse 		be found be located findoneself 
hambre 		fame hearsay renown repute rumor rumour 
harina 		flour 
hasta la vista 		bye goodbye solong 
hasta luego 		bye goodbye solong 
hasta que 		until till 
hay 		there is thereare 
haya 		beech 
haz el favor 		please 
haz favor 		please 
hebilla 		buckle 
hebraico 		Hebrew Jewish 
hebreo 		Hebrew Jewish 
hecho 		fact 
hectolitro 		hectolitre 
helada 		freezing cold frost 
hemorroides 		haemorhoids 
hendedura 		crack crevice 
henderse 		burst split 
hendidura 		ravine 
heno 		hay 
heredar 		inherit 
herida 		injury wound 
herido 		injured wounded 
herir 		hurt wound 
hermana 		sister 
hermano 		brother 
hermanos 		brothers and sisters siblings 
hermoso 		lovely 
herramienta 		agent means tool 
hervir 		boil 
hiedra 		ivy 
hielo 		ice 
hiena 		hyaena 
hierba 		grass 
hierro 		iron 
higo 		fig 
higuera 		fig‐tree 
hija 		daughter 
hijo 		son 
hilo 		thread 
hinchable 		airbed airmattress 
hindú 		Hindu 
hipopótamo 		hippo hippopotamus 
historia 		story history 
hoja 		leaf sheet 
hojalata 		sheet metal tin tinplate 
hoja de afeitar 		razor‐blade 
holandés 		Dutch 
holgazán 		lazy 
hombre 		man humanbeing 
hombre de ciencia 		scientist 
hombre político 		politician 
hombro 		shoulder 
homenaje 		honor honour 
hongo 		mushroom 
honor 		honor honour 
honorable 		respectable 
honrado 		above‐board honest 
hora 		hour o'clock time 
horario 		schedule time‐table 
horizonte 		horizon 
hormiga 		ant emmet 
hormigón 		concrete 
hornada 		bakedgoods 
horrible 		abhorrent abominable alien awful hideous horrible gruesome 
horror 		abhorrence abomination horror 
horroroso 		abhorrent abominable alien awful hideous horrible gruesome 
hospital 		hospital 
hospitalidad 		hospitality 
hotel 		hotel 
hoy 		today 
hoy día 		currently nowadays thesedays 
hueco 		fantastic offantasy 
huelga 		strike 
hueso 		bone 
huevas 		spawn 
huevo 		egg 
huevo frito 		boiledegg 
huir 		flee runaway 
humear 		smoke 
humedo 		damp humid moist 
humillante 		humiliating 
hurtar 		rob 
huésped 		guest 
hábil 		experienced expert skilful skilled skillful practised 
hígado 		liver 
húngara 		Hungarian Hungarianwoman 
húngaro 		Hungarian 
ibérico 		Iberian 
idea 		idea 
ideal 		ideal 
idem 		equally likewise 
identificar 		identify 
idolatría 		idolatry idolworship 
iglesia 		church church‐building house of worship placeofworship 
ignición 		ignition 
igual 		equal even level 
igualdad 		draw equality 
iguana 		iguana 
imagen 		image picture 
imitación 		imitation 
imitar 		imitate 
impedimento 		handicap impediment obstacle 
impedir 		bar inhibit prevent 
imperdible 		safety‐pin safetypin 
imperio 		empire 
implorar 		implore invoke 
imponer 		tax 
importancia 		concern 
importante 		important serious 
importar 		amountto 
importe 		amount sum 
imposible 		impossible 
impresión 		trace track 
imprimir 		print 
impuesto 		tax 
imán 		magnet 
incendio 		conflagration fire 
incitar 		encourage impel instigate spur on stimulate urge 
inclemente 		severe strict 
inclinado 		oblique slanting 
incluído 		including inclusively 
incomodar 		bother disturb hinder trouble 
inconveniente 		difficulty trouble 
incremento 		accretion growth 
increíble 		incredible 
incrustación 		fur scale 
indeciso 		indecisive 
indemnizar 		compensate 
indicación 		index 
indicar 		indicate suggest 
indicio 		index 
indico 		Indian 
indigencia 		misery 
indigente 		miserable poor 
indio 		Indian 
indio americano 		Indian AmericanIndian 
indispuesta 		not well upset 
individuo 		individual 
indole 		character nature personality 
indonesio 		Indonesian 
indonésico 		Indonesian 
indulgencia 		indulgence 
indígena 		aboriginal domestic 
infamar 		slander 
infección 		infection 
infectar 		infect 
infeliz 		unhappy 
inferior 		inferior 
inficionar 		infect 
inflamación 		inflammation 
inflar 		inflate 
influir en 		act affect influence 
información 		account information 
informar 		acquaint inform report 
ingeniero 		engineer 
ingenuo 		guileless inoffensive 
inglesa 		English Englishwoman 
inglés 		English 
ingrediente 		component element ingredient part 
iniciador 		pioneer 
inicial 		initial 
injuria 		abuse insult 
injuriar 		abuse insult offend 
inmediatamente 		at once immediately just right away rightnow 
inmóvil 		motionless 
innato 		congenital inborn inbred innate native 
innovador 		pioneer 
inocente 		guiltless innocent 
inpulsar 		encourage impel instigate spur on stimulate urge 
inquieto 		agitated anxious 
inscribir 		enter 
insecto 		bug insect 
insectos dañinos 		vermin 
insistencia 		insistence pressure urgency 
insistir 		insist 
insolente 		rude 
inspector 		checker controller 
instancia 		insistence pressure urgency 
instar 		insist 
instigador 		firebrand instigator 
instigar 		abet excite incite provoke rouse stimulate stirup 
instinto 		access impetus impulse 
instruir 		teach 
instrumento 		agent means tool 
insultar 		jeer jeer at taunt 
insulto 		abuse insult 
inteligencia 		notion sense realization 
inteligible 		understandable 
intención 		intention meaning plan 
intentar 		attempt test try 
interesante 		interesting 
interesar 		interest 
interior 		inner inside internal 
interna 		inner inside internal 
interprete 		interpreter 
interrumpir 		interrupt 
interruptor 		switch 
interés 		interest 
intestinos 		intestines 
inventar 		invent 
invierno 		winter 
invitar 		invite 
invocar 		invoke 
inválido 		disabled 
inyección 		injection 
ir 		go 
irlandés 		Irish 
irregular 		abnormal 
irse 		go 
ir a buscar a 		takealong 
ir por 		fetch get pickup 
isla 		island 
islas Filipinas 		Philippine Islands Philippines 
israelita 		Israelite 
israelí 		Israelian 
italiana 		Italianwoman 
italiano 		Italian 
jabalí 		wildboar 
jadeante 		breathless 
jamás 		never 
jamón 		ham 
japonesa 		Japanesewoman 
japonés 		Japanese 
jardinero 		gardener 
jardín zoológico 		zoo 
jarra 		jug pitcher 
jarro 		jug pot 
javanesa 		Javanesewoman 
javanés 		Javan Javanese 
jefe 		boss chief leader 
jengibre 		ginger 
jerez 		sherry 
jirafa 		giraffe 
joven 		young 
joya 		gem jewel 
joyero 		jeweller 
judía 		haricot 
judía verde 		haricot 
judío 		Israelite 
juego 		game 
juego de damas 		checkers 
jueves 		Thursday 
juez 		judge 
jugar 		play 
jugo 		juice sap 
jugo de grosellas 		currantjuice 
jugo de manzana 		applejuice 
juguete 		toy 
juicio 		judgment 
julio 		July 
junco 		cane reed 
junio 		June 
juntamente 		together 
juntar 		join unite 
juntarse 		associate come together join pool 
jurar 		blaspheme cuss curse swear 
justamente 		exactly 
juventud 		youth 
juzgado 		tribunal 
juzgar 		judge 
kilo 		kilo 
kilómetro 		kilometre 
la 		the 
labio 		lip 
laborioso 		active hardworking 
labrador 		builder 
laca para las uñas 		nail‐varnish 
lado 		side 
lado inferior 		bottom 
ladrar 		give tongue bark 
ladrillo 		brick 
ladrón 		thief 
lago 		lake loch 
lago Lemán 		LakeofGeneva 
lamer 		lick 
lanchamotora 		motor‐boat motor‐launch 
langosta 		lobster 
lanzar 		throw 
largo 		long 
largura 		length 
las 		the 
lastre 		ballast 
lata 		can tin tincan 
latino 		Latin 
latín 		Latin 
latón 		brass 
laurel 		laurel 
lava 		lava 
lavadero 		laundry 
lavaplatos 		dishwasher 
lavar 		wash 
lazo 		bond tie 
lección 		lesson 
leche 		milk 
lechería 		dairy 
lecho 		bed 
lechuga 		lettuce 
lechón 		piglet 
leer 		read 
legúa 		mile 
lejano 		distant far remote 
lejos 		away 
lengua 		tongue 
lenguado 		sole 
lenguaje figurado 		metaphor 
lente 		lens 
lenteja 		lentil 
lento 		slow 
letón 		Latvian Lett 
levantar 		lever lift raise 
levantarse 		get up rise stand standup 
ley 		law 
león 		lion 
leño 		timber wood 
liar 		bind connect join tie tieup 
libertino 		lawless licentious riotous 
libra 		pound 
librero 		bookseller 
librería 		bookshop bookstore 
libritode memoria 		notebook 
libro 		book 
libréria 		bookcase 
licor 		liqueur 
liebre 		hare 
liebre macho 		buck buck‐hare 
ligar 		bind connect join tie tieup 
ligero 		light 
lila 		lilac 
lima 		file 
lima para uñas 		nail‐scissors 
limitado 		confined limited restricted 
limitar 		abridge confine limit restrict 
limosna 		alms charity 
limpiar 		polish 
limpieza 		cleanliness purity 
limpio 		clean 
limón 		lemon 
lince 		lynx 
lindo 		delightful lovely 
lisera 		shoulder verge vergeofaroad 
liso 		even flat level smooth 
lista 		list 
lista de precios 		price‐list 
listo 		finished ready through 
litro 		liter litre 
llama 		flame 
llamada 		appeal 
llamar 		appeal to invoke 
llamarse 		becalled 
llamar a la puerta 		knock at the door rapatthedoor 
llano 		plain 
llanta 		felly felloe rim 
llanura 		plain 
llave 		key wrench 
llave inglesa 		monkey‐wrench shiftingspanner 
llegada 		arrival 
llegar 		pass spend 
llenar 		complete 
lleno 		complete full 
llevar 		bring fetch 
llorar 		cry weep 
llover 		rain 
lluvia 		rain 
lo 		the 
lobo 		wolf 
loma 		hill 
londinense 		Londoner 
loro 		parrot 
los 		the 
los dos 		both 
loza 		crockery earthenware pottery 
lucio 		pike 
lucir 		shine 
luego 		soon 
lugar 		inducement occasion motive 
lujo 		luxury 
lumbar 		loin 
luna 		moon 
lunes 		Monday 
luxemburgués 		Luxemburger 
luz 		light 
luz de Bengala 		bengal‐light bengal‐lights 
luz posterior 		rear‐lamp rear‐light tail‐light 
luz trasera 		rear‐lamp rear‐light tail‐light 
lágrima 		tear 
lámina 		plate sheet slab 
lámpara 		lamp 
lápiz 		pencil 
línea 		line 
líquido 		liquid 
lúgubre 		bleak dismal dreary horrible ghastly grisly nasty 
macarrones 		macaroni 
maciso 		massive 
madera 		timber wood 
madre 		bed watercourse 
maduro 		mature ripe 
maestra 		teacher femaleteacher 
maestro 		instructor teacher 
magnetófono 		tape‐recorder 
magnífico 		lovely 
majo 		pretty 
malayo 		Malay 
mala costumbre 		habit trick 
mala suerte 		badluck 
malentendido 		misunderstanding 
maleta 		trunk 
maleta de mano 		suitcase valise 
malo 		erroneous mistaken wrong 
mal olor 		stench 
mal reputado 		ofillrepute 
mancebía 		brothel 
mancha 		blot spot 
mandar 		direct guide manage steer 
mandarina 		tangerine 
mandato 		command 
mando 		command 
mandíbula 		jaw jawbone 
manga 		sleeve 
manido 		stale 
mano 		hand 
manso 		tame 
manta 		blanket 
mantel 		table‐cloth 
mantequilla 		butter 
manzana 		apple 
manzano 		apple‐tree 
mapa 		map 
maquinar 		initiate start 
mar 		sea 
marcar 		dial 
marea 		tide 
mareado 		dizzy 
mareado en avión 		airsick 
marfil 		ivory 
margarina 		margarine 
marido 		husband 
marina 		navy 
marinero 		sailor 
mariposa 		butterfly 
marroquí 		Moroccan 
marroquía 		Moroccanwoman 
marroquín 		Moroccan 
marroquína 		Moroccanwoman 
marrón 		brown 
martes 		Tuesday 
martes de carnestolendas 		Shrove‐Tuesday 
martillo 		hammer 
marzo 		March 
mar Báltico 		BalticSea 
mar Rojo 		RedSea 
mar del Norte 		NorthSea 
mas 		but 
masa 		lump mass 
masaje 		massage 
masajear 		massage 
masculino 		male 
masticar 		chew 
matar 		butcher slaughter 
materia 		matter 
material 		data material 
matrimonio 		marriage matrimony 
matrícula 		numberplate 
mayo 		May 
mayoría 		majority 
maíz 		corn Indian corn maize mealies 
mañana 		morning 
mañana pasado 		thedayaftertomorrow 
mañana por la mañana 		tomorrowmorning 
mañana por la tarde 		tomorrowevening 
mear 		urinate 
mecanógrafa 		stenotypist femalestenotypist 
mechero 		lighter 
mecánico 		mechanic 
media 		stocking 
media noche 		midnight 
medicamento 		drug medicine pharmaceutical 
medicina 		drug medicine pharmaceutical 
medida 		measure measurement 
medio 		half 
mediodía 		midday noon 
medir 		measure 
medroso 		afraid 
medusa 		jelly‐fish 
mejicana 		Mexicanwoman 
mejicano 		Mexican 
mejikano 		Mexican 
mejilla 		cheek 
mejor 		better 
melindroso 		prudish 
melocotón 		peach 
melón 		melon 
mencionar 		cite quote 
mendicidad 		begging 
mendigar 		beg 
mendigo 		beggar 
menesteroso 		abject dismal meager miserable wretched 
menguar 		abate decrease diminish drop fall 
menos 		apart from but except otherthan 
menos y menos 		lessandless 
mensaje 		errand message 
mensualmente 		monthly 
menta 		mint 
mentir 		lie tellalie 
mentira 		lie 
menú 		menu 
mercado 		fair market 
mercado de consumo 		market salesactivity 
merecer 		be worthy of deserve merit 
merluza 		haddock 
mermelada 		jam marmelade 
mermelada de manzanas 		apple‐sauce 
mes 		month 
mesa 		table 
metal 		metal 
meter 		lay down place put putdown 
meticuloso 		accurate scrupulous 
metro 		metre 
mezcla 		admixture mixture 
mezquino 		petty small‐minded 
mezquita 		mosque 
mi 		my 
miedo 		agony anguish fear 
miedoso 		afraid 
miel 		honey 
miembro 		limb member 
mil 		thousand onethousand 
millón 		million 
milímetro 		millimetre 
mimar 		spoil 
mimoso 		affectionate caressing cuddlesome cuddly 
mineral 		mineral 
ministerio 		ministry 
minuto 		minute 
miope 		near‐sighted short‐sighted 
mirada 		look 
mirlo 		blackbird 
misa 		mass 
miserable 		miserable poor 
misericordia 		charity mercifulness mercy 
misericordioso 		charitable merciful 
mismo 		even 
mito 		myth 
mitología 		mythology 
mitra 		miter mitre 
miércoles 		Wednesday 
mobilario 		furniture 
mochila 		backpack knapsack 
moda 		fashion mode 
moderno 		modern 
modesto 		modest 
modista 		milliner 
modo subjuntivo 		subjunctive 
mofarse de 		laughat 
mohoso 		mouldy 
mojado 		wet 
moler 		grind pulverize 
molestar 		bother disturb hinder trouble 
molestia 		hindrance 
momentito 		instant moment 
momento 		instant moment 
mondar habas 		string 
moneda 		coin 
monedas 		change 
monje 		monk 
mono 		ape monkey 
monopolio 		monopoly 
monstruo 		colossus 
montar 		go in enter perform 
montaña 		mountain 
monte 		mountain 
monumental 		monumental 
monólogo 		monologue soliloquy 
morado 		violet 
morar 		dwell live 
morder 		bite 
mordisco 		bite 
moreno 		brown 
morera 		mulberry‐tree 
morir 		die expire passaway 
mosaico 		mosaic mosaicwork 
mosca 		fly housefly 
mosquito 		mosquito 
mostaza 		mustard 
mostrador 		counter 
mostrar 		indicate point out show 
motel 		motel 
motivo 		inducement occasion motive 
moto 		motorcycle 
motocicleta 		moped 
motor 		engine motor 
moverse 		move 
mozo 		porter 
muchacha 		girl lass wench 
muchacho 		boy lad laddie 
muchacho travieso 		naughty boy pickle 
mucho 		a lot of much 
mudar 		alter change 
mudo 		dumb mute speechless 
mueblaje 		furniture 
muelle 		spring 
muerte 		death 
muerto 		dead 
mujer 		wife 
mulo 		mule 
multa 		fine 
multar 		fine 
multiplicar 		multiply 
mundo 		world 
municipio 		community 
museo 		museum 
muslo 		thigh 
muy 		quite very verymuch 
muérdago 		mistletoe 
muñeca 		wrist 
máquina 		engine machine 
máquina de escribir 		typewriter 
mármol 		marble 
más 		more 
mástil 		mast 
más adelante 		afterwards next subsequently 
más bien 		preferably 
más y más 		increasingly moreandmore 
máximo 		maximum 
máximum 		maximum 
médico 		doctor physician 
método 		method 
músculo 		muscle 
música 		music 
músico 		musician 
nabo 		turnip 
nacer 		arise beborn 
nacimiento 		birth 
nacional 		national 
nacionalidad 		nationality 
nada 		nothing 
nadar 		float swim 
nadie 		neither nobody none no‐one 
naranja 		orange 
naranjo 		orange‐tree 
nariz 		nose 
nata batida 		whippedcream 
natural 		coming 
naturaleza 		character nature personality 
naturalmente 		naturally 
navegar 		navigate 
necesario 		necessary 
necesidad 		need want 
necesitado 		abject dismal meager miserable wretched 
necesitar 		need require 
neerlandesa 		Dutchwoman 
neerlandés 		Dutch 
negar 		deny 
negativa 		refusal 
negativo 		negative 
negocio 		enterprise 
negro 		Negro 
nene 		baby 
nervio 		nerve 
neumático 		tyre 
nevado 		snowy 
nevar 		snow 
niebla 		fog mist 
nieto 		grandson 
nieve 		snow 
nilón 		nylon 
ninguno 		neither nobody none no‐one 
nivel 		level 
ni mucho menos 		notatall 
niño 		bairn child infant 
no 		no 
noble 		ofnoblebirth 
nobleza 		nobility 
noche 		night 
noción 		concept idea 
nogal 		walnut‐tree 
nombramiento 		appointment appointmenttooffice 
nombrar 		appoint 
nombre 		appellation name 
nombre de pila 		firstname 
normal 		normal 
norte 		north North 
noruega 		Norwegianwoman 
noruego 		Norwegian 
nosotras 		us we 
nosotros 		us we 
nostalgia 		nostalgia 
notable 		considerable sizable 
notar 		note make a note writedown 
notario 		notary 
noticia 		account communication 
noticias 		news novelty somethingnew 
notificar 		instruct notify summon 
notoriedad 		acquaintance conversance familiarity 
notorio 		well‐known 
novela 		novel 
noviembre 		November 
novio 		beloved loved one lover sweetheart well‐beloved 
no ... del todo 		notatall 
no ... mas 		nolonger 
no ... mas que 		exclusively just only 
no ... nunca 		never 
no tener razón 		bewrong 
no tocar 		keepone'shandsoff 
nube 		cloud 
nudo 		knot node 
nueve 		nine 
nuevo 		new novel 
nuez 		nut 
nuez moscada 		nutmeg 
nunca 		never 
níquel 		nickel 
número 		amount number 
o 		or 
oasis 		oasis 
obedecer 		obey 
obispo 		bishop 
objeción 		objection 
objecto 		article object thing 
objeto 		thing 
obligar 		compel force 
obligatorio 		compulsory 
obra 		work 
obrera 		female laborer femal labourer femalworker 
obrero 		hand laborer labourer operative worker working man workman 
observar 		keep mind observe 
obstrucción 		dam 
obtener 		achieve acquire attain get obtain 
obtuso 		blunt 
oca 		goose 
ocasionar 		activate cause giveriseto 
occipucio 		back of the head occiput 
ochenta 		eighty 
ocho 		eight 
ochocientos 		eighthundred 
octavo 		eighth 
octubre 		October 
oculista 		oculist ophtalmologist 
ocultar 		conceal hide 
ocultarse 		hide hideoneself 
oculto 		hidden 
ocupado 		busy 
ocupar 		occupy take 
océano 		ocean 
odiar 		hate 
odio 		hate 
oeste 		west West 
ofender 		abuse insult offend 
ofensa 		abuse insult 
oferta 		offer 
oficial 		official 
oficina 		bureau office 
oficina de correos 		postoffice 
oficina de informaciones 		inquiry‐office 
oficio 		handicraft occupation trade 
oficioso 		accommodating helpful 
ofrecer 		bid offer makeanofferof 
ofrecimiento 		offer 
ojo 		eye 
ola 		wave 
oleaje 		billow 
oler 		give off an odour reek smell 
oler a 		smellof 
oler mal 		reek smell smell bad stink 
olivo 		olive‐tree 
olla 		jug pot 
olmo 		elm 
olor 		aroma flavour 
olvidar 		forget 
omnipotencia 		omnipotence 
omnipotente 		almighty all‐powerful omnipotent 
omnisciente 		all‐knowing omniscient 
once 		eleven 
opinión 		opinion 
opio 		opium 
oponerse 		confront stand up to withstand 
oprimido 		stale 
oprimir 		suppress 
oración 		appeal entreaty supplication 
orden 		order 
ordenador 		computer 
orden del día 		agenda 
orden por escrito 		warrant writ 
oreja 		ear 
orgulloso 		proud 
origen 		lineage 
original 		aboriginal original 
originario 		coming 
orina 		urine 
orinal 		pot chamberpot 
orinar 		urinate 
oro 		gold 
ortiga 		nettle 
ortografía 		orthography 
oruga 		caterpillar 
osa 		she‐bear 
oscuro 		dark dim 
oso 		bear 
ostra 		oyster 
otoño 		autumn 
otra vez 		afresh again all over again anew 
otro 		other another else 
otro lado 		oppositeside 
oveja 		sheep 
oír 		hear 
paciencia 		patience 
padre 		father 
padres 		parents 
padre y madre 		parents 
pagar 		pay 
pagar a plazos 		payonaccount 
pago 		payment 
paisaje 		landscape scenery 
pala 		shovel 
palabra 		word 
palacio 		palace 
palmera 		palm palmtree 
palo 		baton cane stick 
paloma 		pigeon 
pan 		bread loaf 
pana 		brakedown 
panadero 		baker 
panadería 		bakery 
panecillo 		roll 
panne 		brakedown 
pantalón 		pants trousers 
pantalón corto 		short pants shorts 
pantorrilla 		calf 
papel 		paper 
papelería 		stationer'sshop 
papel de cartas 		writing‐paper 
papel higiénico 		toilet‐paper 
papel pintado 		tapestry wallcovering 
papel secante 		blotter blottingpaper 
paquete 		packet parcel 
par 		pair 
para 		for to in order to per 
parachoques 		buffer bumper 
parada 		stop 
parada del autobús 		busstop 
paraguas 		umbrella 
paralelo 		parallel 
paraninfo 		auditorium 
parar 		turnaway 
para que 		so sothat 
para una persona 		oneperson 
parche 		adhesiveplaster 
pardo 		brown 
pardone usted 		excuseme 
parecer 		appear look 
parecerse 		be similar resemble 
pared 		wall 
pariente 		relative femalerelative 
parir 		bear givebirthto 
parisiense 		Parisian 
parque 		park 
parra 		vine grapevine 
parroquiano 		client customer 
parte 		part Parthian share 
parte trasera 		back reverse reverseside 
particular 		affair business business deal case matter 
partidario 		acolyte member supporter 
partido 		adherents disciples following party supporters 
pasada 		former last previous prior 
pasado 		former 
pasado mañana 		thedayaftertomorrow 
pasaporte 		passport 
pasar 		pass spend 
pasillo 		corridor passage 
paso 		pass 
paso a nivel 		level‐crossing 
paso de montaña 		pass 
pasta dentrífica 		tooth‐paste 
pasta de almendras 		almondpaste 
pastel 		bakedgoods 
pastelero 		confectioner 
pastelería 		confectionery 
pastel de almendra 		almoundpastry 
pastor protestante 		pastor 
patada 		kick 
patata 		potato 
patillas 		whiskers side‐whiskers 
patinar 		skate 
patinete 		scooter 
patio 		court yard courtyard 
pato 		duck 
patria 		cradle placeofbirth 
patriarca 		patriarch 
patrono 		patron 
patrón 		boss chief leader 
pavo 		turkey 
paz 		peace 
país 		country land 
pañal 		swaddlingcloth 
peatón 		pedestrian 
pecho 		bosom breast chest 
pedal 		pedal 
pedazo 		bit lump piece 
pedido 		order 
pedir 		book order reserve 
pedir limosna 		beg 
pegar 		sew sewon 
peinar 		comb 
peine 		comb 
peligro 		danger peril 
peligroso 		dangerous 
pelota 		ball 
peludo 		hairy hirsute 
peluquera 		hairdresser femalehairdresser 
peluquero 		barber hairdresser 
pelvis 		basin bowl pelvis 
película 		film motion picture movie 
pendiente 		ear‐drop earring 
pensamiento 		thought 
pensar 		think 
pensión 		boarding house boardingschool 
península 		peninsula 
pepino 		gherkin 
pequeño 		diminutive little small 
pera 		pear 
peral 		pear‐tree 
perca 		bass 
perder 		miss 
perderse 		loseone'sway 
perdida 		loss 
perdido 		lost 
perdiz 		partridge 
peregrinación 		pilgrimage 
perejil 		parsley 
perfume 		perfume 
periodista 		journalist femalejournalist 
perito de contabilidad 		accountant 
periódico 		gazette magazine newspaper periodical 
perjudicar a 		harm 
perla 		pearl 
permiso 		permission 
permitir 		accord admit afford allow permit 
pero 		but 
perpetrar 		achieve act do make perform 
perro 		dog 
persa 		Persian 
perseguir 		chase persecute prosecute pursue 
persona 		person 
personal 		personal 
pertenecer a 		belongto 
peruana 		Peruvianwoman 
peruano 		Peruvian 
perímetro 		circumference 
pesado 		burdensome heavy onerous 
pesar 		weigh 
pescador 		fisherman 
pescar 		fish 
peso 		weight 
petición 		request 
petroleo 		paraffin‐oil petroleum 
petróleo 		crudeoil 
petulancia 		wantonness 
petulante 		wanton 
pez 		fish 
pezuña 		hoof 
pez de colores 		goldfish 
pez dorado 		goldfish 
picar 		pick stab sting 
picazón 		itch 
pichón 		dove pigeon 
pico 		beak bill 
pic nic 		picnic 
piedra 		stone 
piel 		fur hide skin 
pierna 		leg 
piernas torcidas hacia afuera 		knock‐kneed legs turned‐inlegs 
pieza 		fragment lump piece 
pijama 		pyjamas 
pila 		battery 
pimienta 		pepper 
pimiento 		paprika 
pino 		pine pine‐tree 
pintar 		paint 
pintor 		painter 
pintoresco 		picturesque 
pintura 		dye paint 
piojo 		louse 
pipa 		pipe 
pirenaico 		Pyrenean 
piscina 		pool swimming‐bath swimming‐pool 
piso 		apartment flat 
piso bajo 		ground‐floor 
pistón 		piston 
piña 		pineapple 
placer 		pleasure 
plancha 		iron flat‐iron 
planchar 		iron ironclothes 
plano 		even flat level smooth 
planta 		sole 
plantar 		plant 
plantío 		planting 
plata 		silver 
plataforma 		platform 
plataforma posterior 		rearplatform 
platija 		plaice 
platillo 		cymbal 
plato 		food 
playa 		beach 
plaza 		plaza square publicsquare 
plaza de toros 		bullring 
pleito 		complaint 
plemear 		hightide 
plombo 		lead 
pluma 		feather 
plástico 		plastic 
plátano 		banana 
población 		population 
pobre 		miserable poor 
pobreza 		poverty 
pobrezo 		misery 
poco 		a little rather some somewhat tosomeextent 
poco a poco 		gradually littlebylittle 
podadera 		bill pruning‐knife 
podadera de mango largo 		polepruner 
podadera de mano tipo yunque 		anvilpruner 
podadera de vanilla 		polepruner 
poder 		beableto 
podrido 		addled bad rotten 
poesía 		poetry 
polaca 		Polishwoman 
polaco 		Polish 
polaina 		gaiter legging 
policía 		police 
pollo 		chick chicken 
polonesa 		Polishwoman 
polonés 		Polish 
polvo 		dust 
polvos 		powder cosmeticpowder 
política 		policy politics 
político 		politician 
pomelo 		grapefruit 
poner 		put on start switch on turnon 
ponerse 		attitudinize pose putonairs 
poner en depósito 		deposit 
poner pleito a 		sue 
poney 		pony 
popa 		poop poopdeck stern 
poquito 		a little rather 
por 		a in inside into on per within 
porciento 		percent percentage 
porque 		because forthereasonthat 
portamonedas 		purse wallet 
portero 		porter 
portuguesa 		Portuguesewoman 
portugués 		Portuguese 
portátil 		portable 
porvenir 		future 
por decirlo así 		sotospeak 
por ejemplo 		for example forinstance 
por eso 		on that account therefore 
por favor 		please 
por fin 		at last finally ultimately 
por fortuna 		fortunately 
por la derecha 		right totheright 
por la izquierda 		left totheleft 
por la mañana 		inthemorning 
por la noche 		intheevening 
por la tarde 		intheevening 
por lo más 		atmost 
por lo tocante a 		about concerning 
por medio de 		by by means of on through with 
por qué 		what for why 
por razón de oficio 		officially 
por separado 		apart separately 
por suerte 		by accident bychance 
poseer 		own possess 
posible 		possible 
postal 		picturepostcard 
poste 		pole post stanchion stake 
postre 		dessert 
postrero 		last 
practicable 		passable practicable 
precavido 		careful cautious 
precio 		price 
precio de entrada 		admission admissionfee 
precipicio 		abyss chasm gulf precipice 
precipitadamente 		hastily hurriedly inahurry 
preciso 		accurate precise 
preferir 		prefer 
pregunta 		question 
preguntar 		ask 
preguntarse 		ask oneself wonder 
prejuicio 		prejudice 
premiar 		awardaprize 
preocupar 		agitate alarm 
preparar 		prepare 
presa 		dam 
presencia 		presence 
presentación 		accession 
presente 		present 
preservativo 		condom rubber 
presión 		pressure 
prestar 		borrow 
preste 		priest 
presumido 		attitudinizer poseur 
presupuesto 		budget estimate estimates 
pretensión 		offer offerofparriage 
pretina 		belt girdle 
prever 		foresee 
prima 		cousin 
primavera 		spring springtime 
primeramente 		first firstly firstofall 
primero 		first 
primeros socorros 		firstaid 
primitivo 		initial 
primo 		cousin 
primo segundo 		secondcousin 
princesa 		princess 
principal 		mostimportant 
principalmente 		above all especially chiefly mainly principally 
principiante 		beginner 
principiar 		begin commence start 
principio 		beginning commencement start 
prisa 		haste 
prisión 		jail gaol prison 
privar 		rob 
probablemente 		probably 
probar 		attempt test try 
procedente de 		a native of comingfrom 
proceso 		action lawsuit 
proceso verbal 		minutes protocol 
proclamación 		proclamation 
proclamar 		issue proclaim 
procurarse 		achieve acquire attain get obtain 
producción 		making manifacture 
producir 		activate cause giveriseto 
producto 		product 
profesional 		professional 
profesión 		profession 
profundidad 		depth 
profundo 		deep profound 
progreso 		advance advancement progress 
prohibir 		forbid prohibit 
prohijar 		affiliate 
promesa 		affirmation promise 
prometer 		promise 
prometida 		bride fiancée 
prometido 		fiancé 
promulgar 		issue proclaim 
pronombre demonstrativo 		demonstrative demonstrativepronoun 
pronto 		soon 
pronunciación 		pronunciation 
pronunciar 		pronounce 
propiedad 		ownership 
propietario 		owner 
propina 		tip 
propio 		own personal 
proposición 		offer tender 
propulsión 		drive 
propósito 		design diagram plan plane 
prostituta 		prostitute 
protección 		protection 
protectar 		protect 
protector 		patron 
proteger 		protect 
protegido 		protégé 
protesta 		protest 
protestante 		Protestant 
protestar 		protest 
provecho 		benefit gain profit 
proveniente 		coming 
provisionalmente 		for the time being temporarily 
proyectar 		make a project of plan 
prudente 		thoughtful 
prueba 		problem trouble 
prusiano 		Prussian 
prémio 		premium prize 
príncipe 		prince 
próximo 		future 
psiquiatra 		psychiatrist 
publicación 		advice announcement communication message notice report 
publicar 		advertise announce givenotice 
pudín 		pudding 
pueblecito 		hamlet township 
pueblo 		folk nation people 
puente 		bridge 
puerta 		gate gateway portal 
puerta trasera 		back‐door 
puerto 		harbor harbour port 
puesta del sol 		sunset 
puesto 		barn shed stand 
puesto de Primeros Auxilios 		first‐aidstation 
puesto que 		because forthereasonthat 
pulga 		flea 
pulgar 		thumb 
pulmón 		lung 
pulsera 		bracelet 
punta 		peak point tip summit 
puntiagudo 		pointed spiked 
punto 		dot period point spot 
punto de contacto 		startingpoint 
punto de partida 		startingpoint 
punto inicial 		startingpoint 
purgante 		laxative 
puro 		pure 
puré de patatas 		mashedpotatoes 
pus 		pus 
puta 		hooker whore 
putrefacción 		corruption decay depravation taint 
puño 		fist 
pájaro 		bird 
pálido 		pale sallow 
párpado 		eyelid 
párrafo 		paragraph 
píldora 		pill 
póliza 		policy insurancepolicy 
que 		that 
quebraja 		crack crevice 
quebrar 		break 
quedar 		meet 
quedarse 		remain stay stayover 
quedarse atrás 		be kept in be detained remain stayon 
queja 		complaint 
quejarse 		complain 
quemado 		burnt 
quemar 		burn 
quemarse 		sticktothepan 
queque 		cake 
querer 		love 
querer decir 		aim intend 
querido 		beloved loved one lover sweetheart well‐beloved 
queso 		cheese 
quieto 		calm quiet 
quince 		fifteen 
quinto 		fifth 
quitar 		abstract takeaway 
quitarse 		take off putoff 
quitar el polvo 		dust 
quitar el polvo a 		dust 
quizás 		maybe mayhap perchance perhaps possibly 
química 		chemistry 
químico 		chemist 
ración 		share 
radiador 		radiator 
radio 		radio wireless 
radio de acción 		radius 
ralea 		property quality 
rama 		bough branch 
rana 		frog 
raramente 		seldom 
raro 		rare 
rascar 		scratch 
rata 		rat 
ratón 		mouse 
raya 		ray strip stripe 
rayo 		beam ray 
rayos de Röntgen 		X‐rays 
rayos x 		X‐rays 
raza 		breed race 
razonable 		acceptable 
reaccionar 		react respond 
realizar 		accomplish achieve actout 
realizarse 		come about happen occur 
rebaja 		abatement discount rebate 
rebanada 		breadandbutter 
rebuznar 		bray 
recado 		errand message 
recalar 		endup 
recelo 		suspicion 
recelocaz 		suspicion 
receloso 		suspicious 
receta 		prescription recipe 
rechazar 		reject 
recibir 		get have receive 
recibo 		receipt 
recientemente 		recently 
recipiente de agua 		basin reservoir 
recitar 		recite 
recoger 		collect gather pickup 
recoger la mesa 		clear away removethecloth 
recomendable 		recommendable 
recomendación 		recommendation 
recompensa 		compensation reward 
recompensar 		compensate reward 
recorrer 		cover go through passthrough 
recreación 		entertainment 
recuerdo 		keepsake memento souvenir 
red 		net network 
redicho 		hackneyed 
redondear 		round roundoff 
redondel 		arena 
redondo 		round 
reducción 		abatement discount rebate 
reflexionar 		think think about reflecton 
reflexión 		consultation deliberation 
reflujo 		lowtide 
refrenar 		control govern restrain rule 
refugio 		asylum 
regalo 		gift present 
regar 		irrigate water 
registrar 		examine 
registro 		account book record register 
región 		region 
regla 		regulation rule 
reglamento 		regulations rules 
rehusar 		reject 
reina 		queen 
reino 		kingdom 
reja 		barrier fence 
relación 		relation understanding 
relampaguear 		lighten 
relevar 		taketheplaceof 
relevo 		replacement substitution 
religión 		religion 
relleno 		replacement replenishment supplement 
reloj 		watch 
relojero 		watchmaker 
reloj de pulsera 		watch wrist‐watch 
relámpago 		lightning 
remar 		row 
remendar 		mend patch patchup 
remitente 		sender 
remo 		oar 
remolacha 		beet 
remolcar 		drag tow 
remolque 		trailer 
renegado 		unfaithful 
renunciar a 		relinquish renounce waive 
reparar 		fix repair 
reparo 		criticism 
repeler 		protect from wardoff 
repetir 		repeat 
reponerse 		revive 
reprender 		reproach rebuke reprove scold 
representante 		agent 
representante exclusivo 		soleagent 
representar 		act for represent 
reprimir 		bridle check restrain 
reprobable 		blameworthy censurable condemnable objectionable 
reprobación 		censure condemnation disapprobation disapproval 
reprobar 		condemn disapprove disapprove of rebuke 
reproducción 		image picture 
reproducir 		depict represent 
repugnancia 		aversion dislike 
repulsar 		reducetheprice 
república 		republic 
requerir 		admonish scold 
resabio 		habit trick 
reservar 		reserve 
resfriado 		cold 
resignación 		acquiescence rezignation 
resistir 		resist withstand 
resolver 		decide 
respaldo 		prop support 
respectar 		esteem thinkwellof 
respecto de 		about concerning 
respetable 		respectable 
respetar 		respect 
respiración 		respiration 
respirar 		exhale 
responder 		answer reply respond 
responder a 		answer 
responsabilidad 		responsibility 
responsable 		accountable responsible 
respuesta 		answer reply 
resquebrajarse 		burst split 
restar 		remain stay stayover 
restaurante 		restaurant 
resultado 		result 
resultar 		pointouttobe 
resumen 		abridgement abstract resumé summery 
retaguardia 		rear rearguard 
retener 		detain hold back retain 
retirarse 		retreat 
retiro 		isolation separation 
retraso 		delay retardation 
retratar 		depict represent 
retrato 		image picture 
retrete 		toilet 
retroceder 		go back gobackwards 
retroceso 		decline goingdown 
retrovisor 		drivingmirror 
retrógrado 		backward retrograde 
reumatismo 		rheumatism 
reunir 		join unite 
reunirse 		join 
reunión 		joining junction 
revelar 		develop reveal 
reverso 		back reverse reverseside 
revisar 		examine 
revisor 		guard 
revista 		periodical 
revés 		back reverse reverseside 
rey 		king 
rezagado 		laggard straggler 
rezar 		pray 
reír 		laugh 
reírse de 		laughat 
reñir 		quarrel wrangle 
rico 		nice tasty 
ridiculizar 		ridicule 
ridículo 		ridiculous 
riesgo 		hazard risk 
rigido 		rigid stiff 
rinceronte 		rhino rhinoceros 
riqueza 		abundance affluence wealth 
risa 		laughter 
ritmo 		rhythm 
riñón 		kidney 
robar 		rob 
roble 		oak 
robo 		abstraction theft 
roca 		reef 
rocío 		dew 
rodar 		roll 
rodilla 		knee 
rojo 		red 
romano 		Roman 
romería 		pilgrimage 
romper 		break 
románico 		Romanesque 
ron 		rum 
roncar 		snore 
ropa 		clothes clothing 
ropa de la cama 		bed‐clothes bedding 
rosa 		rose 
rosado 		pink 
rostro 		face 
roto 		broken 
rubio 		blond fair 
rueda posterior 		back wheel hind wheel rearwheel 
ruego 		appeal entreaty supplication 
ruido 		ado din noise 
ruina 		ruin 
ruiseñor 		nightingale 
rumano 		Romanian Rumanian 
rusa 		Russianwoman 
ruso 		Russian 
ruta 		route 
rábano 		radish 
rábano picante 		horse‐radish horseradish 
rápido 		fast quick rapid speedy swift 
récord 		record 
río 		river 
río Amazonas 		Amazon 
saber 		know knowhow 
sabido 		well‐known 
saborear 		taste 
sacacorchos 		corkscrew 
sacerdote 		priest 
sajón 		Saxon 
salario 		salary wage wages 
saldar 		liquidate 
salida 		demand sale 
salida del sol 		sunrise 
salir 		exit goout 
salmo 		psalm 
salmón 		salmon 
salsa 		gravy sauce 
salsa de malzanas 		apple‐sauce 
salsa de manzanas 		apple‐sauce 
saltamontes 		grasshopper locust 
saltar 		jump leap spring 
salteo 		assault 
salto 		jump leap 
salud 		health 
saludar 		greet salute 
saludo 		greeting salutation 
salvar 		keep save rescue 
salvia 		sage 
salvo 		bar barring except for subject to withoutprejudice 
sanar 		recover 
sandalia 		sandal 
sandwich 		sandwich 
sangrar 		bleed 
sangre 		blood 
sangría 		bleeding blood‐letting 
santa 		saint 
santo 		saint 
sapo 		toad 
saque de comienzo 		kick‐off 
sartén 		frying‐pan fryingpan 
sastre 		tailor 
satélite de la tierra 		earthsatellite 
sauce 		willow 
secar 		dry 
sección 		section 
seco 		dry 
secreción 		secretion 
secreto 		hidden 
secta 		sect 
sed 		thirst 
seducir 		attract draw 
segregar 		divide separate 
seguido 		directly straighahead 
seguir 		follow 
segundo 		second 
seguridad 		safety security 
seguro 		insurance 
seis 		six 
sellar 		mark stamp 
sello 		stamp postagestamp 
sello de correos 		stamp postagestamp 
semanalmente 		weekly 
sembrar 		sow 
semejante 		like alike similar 
sencillo 		simple straightforward 
sendero 		path 
sensible 		sensitive 
sentarse 		sitdown 
sentencia 		decision judgement 
sentimiento 		feel feeling sensation 
sentir 		be sorry about regret 
sentirse 		feel 
separación 		separation partition 
separado 		apart particular separate special 
separar 		divide separate 
septiembre 		September 
ser 		be 
sereno 		serene untroubled 
serie 		series set 
serio 		earnest serious staid 
serpiente 		serpent snake 
servicial 		accommodating helpful 
servicio 		service worshipservice 
servilleta 		napkin 
servir 		accomodate 
ser arrojado a la playa 		bewashedashore 
ser de 		belongto 
ser partidario de 		adhereto 
ser presuntuoso 		attitudinize pose putonairs 
sesenta 		sixty 
seta 		fungus mushroom 
seudónimo 		pseudonym 
severo 		severe strict 
sexo 		sex 
sexto 		sixth 
sexual 		generative sexual 
seña 		character mark sign signal token 
señal 		mark sign signal token 
señas 		address 
señorita 		madam Mrs. 
si 		as like suchas 
siberiana 		Siberian 
siberiano 		Siberian 
sidra 		cider 
siempre 		constantly continually continuously 
sien 		temple 
sierra 		mountainchain 
siete 		seven 
siglo 		centennial century 
significar 		imply mean signify 
siguiente 		following next 
silbar 		whistle 
silencio 		calm quiet silence 
silla 		chair 
sillón 		armchair 
simple 		simple straightforward 
sin 		without 
sincero 		above‐board honest 
sin aliento 		breathless 
sin duda 		no doubt undoubtedly 
sistema 		system 
sitiar 		besiege 
sitio 		place 
sobre 		envelope 
sobretodo 		above all especially chiefly mainly principally 
sobre todo 		above all especially 
sobrino 		nephew 
sofocar 		choke quell suffocate suppress 
sol 		sun 
solicitación 		request 
solicitar 		ask ask for beg bid request 
solicitud 		request 
sollo 		sturgeon 
solo 		alone only sole solitary 
soltero 		single unmarried 
solterona 		unmarried woman spinster 
solterón 		bachelor 
sombra 		shadow 
sombrero 		hat 
somero 		shallow superficial 
sonido 		sound 
sonreír 		smile 
sonrisa 		smile 
sopa 		soup 
soplar 		blow 
sordo 		deaf 
sorprender 		surprise 
sorpresa 		surprise 
sosegado 		calm tranquil 
sosegar 		appease calm quiet soothe still 
sosegarse 		abate subside 
sospecha 		suspicion 
sospechar 		suspect 
sostener 		abet support sustain 
sostén 		bra 
soñar 		dream 
su 		her his its their 
subasta 		tender 
subir 		ascend get up go up lift rise arise 
subir a 		ascend climb scale 
subscripción 		subscription 
subscriptor 		subscriber 
substantivo 		noun substantive 
substituir 		taketheplaceof 
subyugar 		govern head up restrain 
sucesivamente 		consecutively 
sucesivo 		following next 
sucinto 		concise 
sucio 		dirty filthy nasty soiled unclean 
sudafricano 		SouthAfrican 
sudamericano 		SouthAmerican 
sudar 		sweat 
sudor 		perspiration sweat 
sueco 		Swedish 
suela 		sole 
suelo 		bottom foundation ground 
suelto 		loose 
suerte 		destiny fate fortune luck 
sueño 		sleep 
suizo 		Swiss 
sujetador 		bra 
sujetar 		hang onto hold 
suma 		amount sum 
sumar 		add up sumup 
superficie 		summit surface top 
supermercado 		supermarket 
suplemento 		replacement replenishment supplement 
suplicar 		implore invoke 
suponer 		guess presume suppose surmise 
sur 		south 
surtido 		assortment 
suscribirse 		subscribe subscribeto 
suscripción 		subscription 
suscriptor 		subscriber 
suspender 		reject 
suspicaz 		suspicious 
suspirar 		sigh 
sustraer 		subtract 
sábana 		sheet 
séptimo 		seventh 
sí 		yes 
sólido 		firm robust sturdy 
sólo 		exclusively just only 
sótano 		basement cellar 
tabaco 		tobacco 
taberna 		bar pub 
tabique 		wall 
tabla 		shelf 
tabla de planchar 		ironingboard 
taburete 		barstool 
taco 		nail 
tacón 		heel 
tajada 		slice 
tal 		such such a thatkindof 
talento 		aptitude disposition talent turn 
talentoso 		gifted talented 
taller 		workplace 
talonario 		cheque‐book 
talón 		heel 
tal vez 		maybe mayhap perchance perhaps possibly 
tamaño 		dimension measurement 
también 		also likewise too 
tambor 		drum 
tampoco 		neither nor 
tampón 		plug tampon 
tanque 		cistern tank 
tantico 		a little rather 
tanto 		thatmuch 
tapacubo 		hub‐cap 
tapicero 		paperer paper‐hanger 
tapizar 		paper 
tapon 		hub‐cap 
taquilla 		window ticket‐window 
tardar 		be kept in be detained remain stayon 
tarde 		afternoon 
tardío 		late tardy 
tarjeta 		card map menu 
tarjeta de crédito 		creditcard 
tarjeta postal 		picturepostcard 
tarjeta postal ilustrada 		picturepostcard 
tarta de manzana 		apple‐tart 
tasa 		assessment 
taxi 		taxi 
taza 		cup 
teatro 		theatre 
teatro de varietés 		varietyentertainment 
tejado 		roof 
tela 		bit lump piece 
telegrama 		telegram 
telemando 		remotecontrol 
televisión 		television TV 
teléfono 		telephone 
temer 		be afraid of fear 
temeroso 		afraid 
temor 		fear 
temperatura 		temperature 
tempestad 		storm 
templo 		temple 
temporada 		season 
temprano 		early 
tenazas 		pincers 
tenedor 		fork 
tenedor de libros 		book‐keeper 
tener 		desire wish 
tener cuidado 		advert pay attention pay attention to watchoutfor 
tener el propósito 		intend mean 
tener lugar 		come about happen occur 
tener puesto 		wear 
tener que 		have to must ought to should 
tener éxito 		succeed 
tenga 		behold here is here are look there 
tenis 		tennis 
tensión 		tension 
tentación 		disposal inclination tendency 
tercero 		third 
tercio 		third 
terciopelo 		velvet 
terminado 		completed done finished over through 
terminante 		effective effectual efficacious 
terminar 		accomodate end finish terminate 
terminarse 		end come to an end end up expire 
termos 		thermosbottle 
termómetro 		thermometer 
ternero 		calf 
terraza 		terrace 
terremoto 		earthquake 
terrenal 		terrestrial 
terreno 		ground grounds terrain 
terreno del camping 		camping ground campingsite 
terreno pantanoso 		marsh swamp 
terrestre 		terrestrial 
testigo 		witness 
tetera 		teapot 
texto 		lyric text 
teñir 		dye tint 
tibio 		lukewarm 
tiburón 		shark 
tiempo 		time while 
tienda 		boutique shop store 
tienda de campaña 		tent 
tierno 		soft 
tierra 		earth land soil 
tigre 		tiger 
tijeras 		scissors 
tijera para setos 		hedge clippers hedgeshears 
tilo 		lime‐tree linden‐tree 
timbrar 		mark stamp 
timbre 		bell 
timbre de alarma 		alarmbell 
timón 		handlebars helm rudder 
tinieblas 		darkness murk 
tinta 		ink 
tirantes 		braces suspenders 
tirar 		fire shoot 
titubear 		hesitate 
toalla 		towel 
tobillo 		ankle 
tocar 		touchupon 
tocino 		bacon 
todavia 		still yet 
toda clase de 		all everykindof 
todo 		entire overall whole 
todopoderoso 		almighty all‐powerful omnipotent 
todos 		all 
tolerar 		endure put up with tolerate 
tomar 		accept receive take takein 
tomar en consideración 		account consider esteem regard takeintoaccount 
tomate 		tomato 
tomo 		volume 
toque 		touch 
torcido 		furious 
tormenta 		storm 
tornillo 		screw 
toro 		bull 
torre 		castle tower 
torta 		pie tart 
tortilla 		omelette 
toser 		cough 
trabajador 		hand laborer labourer operative worker working man workman 
trabajar 		work 
trabajo 		job work 
traducir 		translate 
traer 		bring fetch 
tragar 		engulf swallowup 
traje 		costume outfit suit 
traje de baño 		bathing suit bathing‐suit 
tranquilo 		calm tranquil 
transbordador 		ferry 
transitable 		passable practicable 
transitivo 		transitive 
transpirar 		sweat 
transportar 		transport 
transporte 		transport 
tranvía 		streetcar tram 
tras 		behind after 
trasladar 		copy 
traslado 		copy 
trasporte 		transport 
trastornar 		overthrow turn turn over upset 
tratado 		treaty 
tratamiento 		treatment 
tratar 		treat 
tratar de 		aim attempt endeavour take steps undertake 
trato 		treatment 
trece 		thirteen 
treinta 		thirty 
tremblar 		quiver shiver tremble 
tren 		train 
tren corrido 		corridortrain 
trepar 		climb 
tres 		three 
tresillo 		lounge suite three‐piecesuite 
tres veces 		three times thrice 
tributo 		tax 
tricar 		carrier cycle carriertricycle 
trigo 		wheat 
trillado 		hackneyed 
trinquete 		clique coterie junto set 
tripulación 		crew 
triste 		sad 
tristeza 		sadness sorrow 
trivial 		commonplace dismal trite 
trombón 		trumpet 
tronar 		thunder 
tronco 		stem trunk tree‐trunk 
trono 		throne 
trozo 		slice 
trucha 		trout 
trueno 		thunder 
tráfico 		traffic 
tráfico de dirección única 		one‐waytraffic 
tu 		your 
tubo receptor 		cathodetube 
tuerca 		nut 
tumba 		grave tomb 
tumor 		tumor tumour 
turca 		Turkish lady Turkishwoman 
turco 		Turkish 
turista 		tourist 
turno 		file line rank row turn 
tutear 		theeandthou 
tápa 		cover hood lid 
té 		tea 
técnica 		technics technique 
término 		end ending 
tía 		aunt 
tímido 		afraid timid 
tío 		uncle 
título 		superscription 
tóxico 		poisonous 
tú 		thou you 
túnel 		tunnel 
uf 		shame 
ultrajar 		abuse insult offend 
un 		one 
una 		one 
unas 		a few any some 
una vez 		once onetime 
unirse 		associate join pool 
universal 		general usual 
universidad 		university 
unión 		joining junction 
uno 		one 
unos 		a few any some 
uno y medio 		oneandahalf 
un momento 		a few minutes amoment 
urbano 		urban 
urgente 		pressing urgent 
urgentemente 		urgently 
urraca 		magpie 
usado 		worn 
usar 		use up wearout 
uso 		use 
usted 		thou you 
ustedes 		ye you 
uva 		grape 
uña 		nail 
vaca 		cow 
vacaciones 		vacation 
vaciar 		empty 
vacilación 		hesitation wavering 
vacilar 		hesitate 
vacío 		empty void 
vainilla 		vanilla 
vale 		agreed okay 
valer 		beworth 
valle 		valley 
valor 		courage 
valorar en 		blame holdagainst 
valuta 		currency 
vampiro 		vampire 
variar 		vary 
variedad 		variety 
varios 		several 
vasco 		Basque 
vascuence 		Basque 
vaso 		glass 
vecino 		adjacent 
vegetación 		vegetation 
vegetariano 		vegetarian 
veinte 		twenty 
veinte y uno 		twenty‐one 
vejiga 		bladder bubble 
vela 		candle 
velludo 		hairy hirsute 
velocidad 		speed 
velocidad inicial 		initialvelocity 
vena 		vein 
vencimiento 		end terminate 
vendaje 		bandage 
vendar 		dress 
vendedor 		salesman 
vendedora 		saleswoman 
vender 		dispose of sell vend 
veneno 		poison 
venganza 		revenge vengeance 
vengar 		avenge avengeoneself 
venir 		come 
venir después 		arrive afterwards come afterwards come later follow 
venta 		sale 
ventaja 		advantage benefit 
ventana 		window 
ventilador 		electric fan ventilator 
ventilar 		aerate air out give an airing ventilate 
ver 		see 
verano 		summer 
verbena 		fair 
verdad 		reality truth 
verdaderamente 		absolutely genuinly indeed really truly 
verdadero 		true 
verde 		green 
verduras 		vegetable 
vergonzoso 		ashamed 
vergüenza 		shame 
vermut 		vermouth 
verter 		pourin 
vestido 		dress gown robe 
vestir 		cover overlay 
vestirse 		dress getdressed 
vestíbulo 		hall 
veterinario 		veterinarian 
viajar 		travel 
viaje 		journey trip voyage 
viajero 		traveller 
viaticar 		administerthelastsacraments 
victoria 		victory 
vida 		life 
vidrio 		glass 
viejo 		old 
viento 		wind 
vientre 		abdomen belly tummy 
viernes 		Friday 
viga 		beam girder 
vigilar 		guard keep look after watchover 
vinagre 		vinegar 
violento 		acute intense intensive 
violoncelo 		cello 
virtud 		energy 
visado 		visa visé 
visita 		visit 
visitación 		inspection 
visitar 		attend call on see visit 
vista 		appearance aspect look sight view 
vitamina 		vitamin 
viudo 		widower 
vivir 		be alive live 
vivo 		alive 
viña 		vine 
volante 		handlebars helm rudder 
volar 		fly 
voltaje 		tension voltage 
voluntad 		will willingness wish 
voluntariamente 		willingly 
volver 		turnaway 
vomitar 		throw up vomit 
vosotras 		you 
vosotros 		you 
votar 		vote 
voz 		voice 
vuelo 		flight 
válido 		valid 
válvula 		tube valve 
vía 		path road way 
víbora 		adder viper 
xilófono 		xylophone 
y 		and 
ya 		already by now yet 
yate 		yacht 
ya ... no 		nolonger 
ya que 		because forthereasonthat 
yedra 		ivy 
yerba 		grass 
yerno 		son‐in‐law 
yerro 		aberration error mistake 
yo 		I 
yodo 		iodine 
yogur 		yoghourt yoghurt 
yugo 		yoke 
y tambien 		and also and ... as well as well as togetherwith 
y también 		and also and ... as well as well as togetherwith 
zalamero 		affectionate caressing cuddlesome cuddly 
zambullirse 		dive plunge 
zanahoria 		carrot 
zanja 		hole ditch pit 
zapatero 		shoemaker 
zapatilla 		slipper 
zapato 		shoe 
zarza 		blackberry blackberry bush bramble 
zarzamora 		blackberry 
zelandés 		Zealand 
zinc 		zinc 
zona 		zone 
zorro 		fox 
zote 		addled foolish stupid 
zumo 		juice sap 
zumo de naranja 		orangejuice 
zurrar 		thrash 
África 		Africa 
África del Sur 		SouthAfrica 
ágata 		agate 
ágil 		adroit clever dexterous skillful 
águila 		eagle 
álamo 		poplar 
álbum 		album 
álgebra 		algebra 
ámbar amarillo 		amber 
ángulo 		angle 
árabe 		Arabian Arabic 
árbol 		tree 
árido 		barren 
áspero 		coarse rough 
áspid 		adder viper 
átomo 		atom 
ávido 		acquisitive eager greedy 
él 		he him 
ídolo 		idol 
ópera 		opera 
óptico 		optician 
órbita 		orbit 
úlcera 		ulcer sore 
último 		last 
único 		alone only sole solitary 
útero 		uterus womb 
ñajú 		gumbo okra okraplant 
ñame 		yam 
ñandu 		American ostrich nandu 
ñaña 		elder sister 
