birader 		Bruder 🗸🗸🗸🗸 <<<

beni/eyim/-um bin ich / I am !
seni er sein (shen@kartvelian)
onu/-sin on (man@french) 𓆑
bizi wir sind? note familiar -zi plural
sizi sie sind! note familiar -zi plural
onları on/leur

grammatical forms are very mixed but can still be recognised

Conditional -se "if only" ⇔ si, whether 𓇋𓂋 währe fir for…
Inferential -miş "seems" 𓏇
Past -di "walked"
Negative -me "mano" 𓅓𓂜𓅱
Positive -ier 𓂻 𓍘𓏲𓀁 ja sein 𓃹𓈖 being 𓃀
Necessitative -meli must-I ⇔ 马 mwahri 𓐙 «true?» vs 'really' خیلی

Interrogative particle mi is linked to Negative. German: ne? asiatic ma? 马mǎ?
Question particle NE~MA

var 	 faire/have/ha'va
vermek faire/make
etmek  do/make
lemek 	?/make

-ce -ci 士 -GER -KER Norveçce 		Norweger 🗸 
-lı -lu -LY -lisch Afrikalı 	-nisch!  Adjectives < like 🗸
-lı -LER Kıbrıslı 		Zypriot 🗸-ler!🗸 <> LAR = III
-li ali : to/with
-de to/at/of/from
-ya -IA -A : Land  Rusya 		Rußland 🗸 < Rus 		Russe 🗸
-ça -ISCH  Rusça 		russisch  
-istan Yunanistan = greece
-la  [noun]
-lama -ung [noun]
-lik [noun] lık luk lu [Reich/Tum/Schaft/...?]<> lı
-lamak machen
-mak machen
-miz wir we's -biz ours -uz
-yor  [verb]ier partier => part.yor
-um I.am
-sal 'Saal' Ort (kumsal with-Sand)
-sen Sie seien (you)
-sız -suz sans without   sızlık~Armut/Mangel
-dir -dar = seien/be
-cığım 		-chen
-diğıl DIs DES- not!
-ait at? @ kuzeye ait 		nördlich 

bugün 		heute  bu=𓅮𓅯=𓊪𓅱!!! sun=gün:journ
budar  here
sudar  there

Rumca 		Grieche <<<< RoMAN=Human!!! 
Yunanlı 		griechisch 🗸 ION
dinsizlik 		Atheismus DON.SIZ.LIK = sans-don-like

aleyhinde 		𓄚 an gegen gegenüber wider 🗸~~~!!!
arkasından 		𓄚 hinter << arka ~achter ante hindar
arasında 		𓄚 unter mittenunter zwischen 

bir daha 		anderer anders sonst  1anderer 2er! <<<

Day, daily gün, hergün GURN, HEHR-gurn HOUR:JOURN +++ < Sonne>Jaun>Gün
today bugün BOO-gurn 
tomorrow yarın YAHR-uhn ya=next
week hafta hahf-TAH HÄLFTE?


Sunday Pazar pah-ZAHR PASHAR 1.Pir=First
Monday Pazartesi pah-ZAHR-teh-see  2.nd PASHAR.Tagi | tesi ~ +1-Tag 
Tuesday Salı sah-LUH salut? sa'lun? 3.Sa
Wednesday Çarsamba char-shahm-BAH  4.Sambe[Tag]
Thursday Persembe pehr-shehm-BEH   5.Sambe[Tag]
Friday Cuma joo-MAH  Jom:Day@Sem 6.SysJom zusamm-join? Jourm 
Saturday Cumartesi joo-MAHR-teh-see ~ SAMSTAGE Sabbat Jourma'Tegi tesi ~ +1-Tag / 2nd

Afrika 		Afrika 🗸
Afrikalı 		afrikanisch 🗸
Alman 		deutsch 🗸
Almanya 		Deutschland 🗸
Amerika 		VereinigtenStaaten 🗸
Amerikalı 		amerikanisch 
Amerikan timsahı 		Alligator 
Anadolu 		Anatolien 
Ankara 		Ankara 
Arap 		Araber 🗸
Arjantin 		Argentinien 🗸
Arnavut 		albanesisch albanisch ?
Arnavutluk 		Albanien 
Asya 		Asien 🗸
Atlas Okyanusu 		Atlantischer Ozean 🗸
Avrupalı 		europäisch  🗸!
Avustralya 		Australien 🗸
Avustralyalı 		australisch 
Avusturya 		Österreich 
Avusturyalı 		österreichisch 
Belçika 		Belgien 🗸
Belçikalı 		belgisch 
Birleşik Devletler 		VereinigtenStaaten  <<?
Brezilya 		Brasilien 🗸
Brezilyalı 		brasilianisch 
Britanya 		Britannien 🗸
Bulgaristan 		Bulgarien 🗸
Cezayir 		Algerien << Czech!! <<
Cezayirli 		algerisch 
Danimarka 		Dänemark 🗸
Danimarkalı 		Däne 🗸
Filistin 		Palästina 🗸!
Fransa 		Frankreich 🗸
Fransız 		französisch 🗸🗸
Habeşistan 		Äthiopien <<<<
Hindistan 		India Indien 🗸🗸
Hintli 		Inder 🗸🗸
Hollanda 		Holland 🗸
Hollandalı 		holländisch 
Hıristiyan 		Christ 🗸!
Japonca 		japanisch 🗸
Japonyalı 		japanisch 
Kanada 		Kanada 🗸
Kanadalı 		kanadisch 
Kıbrıs 		Zypern 🗸~
Kıbrıslı 		Zypriot 🗸-ler!🗸
Kızılderili 		Indianer ??
Macaristan 		Ungarn <<?
Musevi 		Jude <<< MUSELMAN?? <<<<
Müslüman 		Mohammedaner 🗸🗸 ^
Mısır 		Ägypten 🗸🗸 Mizraim <<<<<
Mısırlı 		egyptisch 
Noel 		Weihnachten 🗸
Norveç 		Norwegen 🗸
Norveçce 		Norweger 🗸 -ce 士! <<< 
Norveçli 		norwegisch 
Paskalya 		Ostern Pashava Passover  🗸
Polonya 		Polen 🗸
Polonyalı 		polnisch 
Portekiz 		Portugal ~🗸
Portekizli 		portugiesisch 
Ren 		Rhein 🗸
Rumanya 		Rumänien 🗸
Rumca 		Grieche <<<< MAN 
Rus 		Russe 🗸
Rusya 		Rußland 🗸
Rusça 		russisch 
Suriyeli 		syrisch 🗸~<
Türkiye 		Türkei 
Yahudi 		Jude 🗸
Yugoslavya 		Jugoslawien 🗸
Yunanistan 		Griechenland 🗸
Yunanlı 		griechisch ION🗸 鱼于与月玉玊羽雨

abes 		absurd abgeschmackt ungereimt widersinnig ~🗸
abide 		Denkmal Monument abide! <<🗸?
abla 		Schwester <<
abluka 		Blockade a'block 🗸 ++
abluka etmek 		blockieren 
abone 		Abonnement 🗸
abuk sabuk 		Gallimathias Unsinn 
acayip 		befremdend kurios seltsam sonderbar wunderlich 
acele 		geschwind hurtig rasch schnell ++ 
acemi 		Novize 
acente 		Agent Geschäftsbesorger +
acı 		acid bitter ++ aci.de++
aciz 		flau gelinde schwach a-kiz?
acıklı 		ergreifend ~
acımak 		ache-make: Schmerzverursachen schmerzen wehtun ++
acıkmak 		ache-make^: bedauern 
ad 		Name@ 
ada 		Eiland Insel 𓏏! a'dell ~
adam 		Mensch 🗸
adres 		Adresse 🗸
af 		ab… off… Amnestie Begnadigung Straferlaß 
akasya 		Akazie 🗸
akordeon 		Ziehharmonika 🗸
akrobat 		Akrobat 🗸
aktör 		Schauspieler 🗸
akustik 		Akustik 🗸
akvaryum 		Aquarium 🗸
akümülatör 		Akkumulator 🗸
akşam 		Abend <<< Oxi.. vs Orient
akıl 		Gehirn Hirn 
alay 		Ironie 
alaşım 		Legierung 
albay 		Oberst ~<<
albüm 		Album 🗸
alev 		Flamme ~~🗸!
aley'hinde 		an gegen gegenüber wider 🗸~~~!!!
alfabe 		Alphabet 🗸
alkol 		Alkohol Spiritus 🗸
alkiş 		Applaus Beifall 
alkışlamak 		applaudieren Beifallspenden 
almak 		HALt.make 𓂋𓂢 fassen nehmen << -> buy
almanak 		Almanach 🗸
altı 		sechs   al.tis:6 alter:2*3 ? vs seki=8! sick alteration
alüminyum 		Aluminium 🗸
amatör 		Amateur Liebhaber 🗸
amerikalı 		amerikanisch 🗸
amiral 		Admiral 🗸
amonyak 		Ammoniak 🗸
amper 		Ampère 🗸
anahtar 		Schlüssel <<
anarşi 		Anarchie 🗸
anatomi 		Anatomie Zergliederungskunst 🗸
ancak 		kaum << un-chaque=very
anemi 		Blutarmut 🗸
anlamak 		begreifen erfassen verstehen << al=halt/fass
anne 		Mutter 🗸
ansiklopedi 		Encyklopädie 🗸
anten 		Fühler Fühlhorn 🗸!! antler!!
antika 		altertümlich antik 🗸
apostrof 		Apostroph 🗸
apse 		Abszeß Eiterbeule Geschwulst 🗸
aralık 		Dezember <<<
aramak 		ausschauennach suchen aufsuchen 🗸 < IR! AIR/ARA:eagle!!!! <<<🗸🗸🗸
arasında 		unter mittenunter zwischen  <<< arasUnter
arkasından 		hinter << achter's'hintern
arkadaş 		Freund << akkad?
arena 		Arena Kampfplatz 🗸
arpa 		Gerste <<🗸 ? Rebe?
arzu 		Appetit ~?
arı 		Biene <<™ aryan mari->miel
arı kovanı 		Bienenkorb Bienenstock 🗸
asfalt 		Asphalt Erdpech 🗸
asker 		Armee Heer askHeer@Ashur? << from Persian لشکر‎ (laškar, “army”) Turkish: leşker le Scare < Secure?
astronomi 		Astronomie Himmelskunde Sternkunde 🗸
astım 		Asthma 🗸
at 		Gaul Pferd 🗸~ <- hott asp
atmak 		schleudern werfen : hit ^^
ata 		Ahn Vorfahr Urahn 🗸 VATA <<🗸
atardamar 		Arterie Pulsader Schlagader 🗸 adamar=blood 🗸🗸 <<
ateş 		Feuer < hot <<
atlet 		Athlet 🗸
atmosfer 		Atmosphäre 🗸
atom 		Atom 🗸
ay 		Mond 🗸 IAH, yue
ayak bileği 		Knöchel ?
ayak parmağı 		Zehe ?

aç ~ AUS/AUF...
açmak 		aufmachen öffnen ~ ac/auf
aç 		hungrig <> ESS!
açgözlü 		unersättlich <> see?
açık 		hell licht lichtvoll <<
açıkgöz 		listig^^ abgefeimt arglistig gerieben gewiegt gewitzigt schlau 
açıklama 		Aufklärung Aufschluß Erläuterung 
açıklamak 		darlegen einleuchten erklären erläutern 
açıkça 		ausdrücklich 
ağustos 		August 🗸 

baba 		Väterchen 🗸
babacığım 		Väterchen ?🗸
baca 		Schornstein ?
bagaj 		Bagage Gepäck Verpackung 🗸
bakteriler 		Bakterie(n?) 🗸
bakışım 		Ebenmaß Gleichmaß SYMmetrie 
balina 		Walfisch 🗸 !!! Baltic belinea BAL:WAL!! 🗸🗸 <<
balık 		Fisch ™ ^^  vision:Fishen|stare:Stör|blick:Balik
balkon 		Altan Balkon 🗸
balon 		Ballon 🗸
balta 		Axt Beil Hacke 🗸~!
banka 		Bank 🗸
banyo 		Badestube 🗸🗸
banyo odası 		Badestube < Hoda/Hütte~room
barbar 		Barbar 🗸
barikat 		Barrikade Verhau 🗸
barometre 		Barometer 🗸
baron 		Baron Freiherr 🗸
basil 		Bazillus 🗸
basur 		Hämorrhoiden --
battaniye 		Bettdecke Decke 🗸🗸🗸!!!<<<+++
batı 		Abendland Okzident Westen ~<<< PARTIR vs DOGU/THAI:dagegen(Sonne)
batıya ait 		westlich 
baykuş 		Eule (white?) <?>
bayrak 		Banner Fahne Flagge <<~
başka 		anderer anders sonst <> both?
başlamak 		anbrechen anfangen beginnen ? bas~first~bir 1.
beden 		Körper Leib BODYN 🗸🗸 <<<
beden yapısı 		Anatomie Zergliederungskunst ^
beklemek 		gewärtigen harren warten erwarten 
belkemiği 		Rückgrat <> bulk back
benzin 		Benzin 🗸
beygir 		Pferd/Gaul ~~  <<<
beyin 		Gehirn Hirn 'behirn' <?
bez 		Tuch <> Fashio/Bett^^🗸 
beş 		fünf 🗸
beğenmek 		~billigen genehmigen gutheißen <> billigen>biegen>bien:gut?? <<🗸?
biftek 		Beefsteak 🗸🗸🗸
bilardo 		Billard 🗸
bilet 		Billett Fahrkarte Karte 🗸
bilezik 		Armband < bless?schick?
bilgisinde 		Adjektiv Eigenschaftswort 
bilmek 		wissen <<< Bildung!
bina 		Bau Bauwerk Gebäude ~ <
bir 		ein eine eins fir(st)🗸~ pre prä 1.
bir.iktir.mek 		sammeln EINsammeln 
birlik 		Einigkeit Einheit 
bira 		Bier 🗸
birader 		Bruder 🗸🗸🗸🗸 <<<
birden fazla kadın alma 		Polygamie Vielweiberei WTaF!
bir daha 		anderer anders sonst 2er!
bir uzvu kesmek 		abnehmen abschneiden amputieren 
bisiklet 		Fahrrad Rad Rover 🗸
biyografi 		Biographie Lebensbeschreibung 🗸
biyoloji 		Biologie Lebenslehre 🗸
biz 		uns unser wir wez we's ~ 
biçak 		Messer mbesserk < chuck/cut? ~
boksör 		Boxer 🗸 
bomba 		Bombe 🗸
boykot 		Ausperrung Boykott 🗸
boş 		leer << voids?
boğa güreşi alanı 		Arena Kampfplatz 
broşür 		Broschüre 🗸
bugün 		heute  bu=𓅮𓅯=𓊪𓅱!!! sun=gün:journ
bulmak 		finden befinden erachten ermitteln vorfinden 
bulunmayış 		Abwesenheit 
bulut 		Wolke b/cloud <~🗸
bulüz 		Bluse 🗸
burun 		Nase ??<<
burç 		Horoskop ?
buz 		Eis beiß bing
böbrek 		Niere /
bölüm 		Kapitel 
bülbül 		Nachtigall <<
bütün 		alles both,beiden <~
büyük 		groß BIYIG BIG!!🗸🗸   vehiculum<vehere:ferry/fuhre
büyük elçi 		Botschafter Gesandter  Big 'elçi' ?
büyük kilise 		Dom Kathedrale Münster Big Eglise 🗸
büyük zil 		Zimbel kymbalon ~
bırakmak 		abBRECHen aufBRECHen mak: abreisen fortgehen << partier ++🗸~~
cadde 		Straße <<!
cambaz 		Akrobat 
cami 		Moschee ??
cebir 		Algebra Buchstabenrechnung  <<
cephane 		Munition ?
cevap vermek 		antworten beantworten entgegnen erwidern  <<
cevap 		Antwort 
ceviz 		Walnuß 
ceylan 		Gazelle Gaceylan@Ceylon? ~~
coğrafya 		Geographie 🗸!
cuma 		Freitag ^^
cumartesi 		Sabbat 
cümle kuruluşu 		Syntax 
da 		auch ebenfalls gleichfalls   DJA YA+ DA=AD/UND@Slav
de 		auch ebenfalls gleichfalls 
daha iyi 		besser <<<
daha şimdiden 		bereits schon 
dahi 		auch ebenfalls gleichfalls 
daima 		√TIME immerda!! allemal allzeit fortwährend jederzeit stets <<
daire 		Kreis <> Turn ~~<<<+
damat 		Eidam[at] Schwiegersohn <> Adam!
dana 		Kalb  √dan~deer
dans 		Tanz 🗸
dans etmek 		tanzen 🗸
dar 		schmal 🗸~darb! vs Darius!
darı 		Mais darıs <> Reis
dağ 		Berg DACH  <> Kapadochia ... şibidak Schiebedach (loan)
demek 		erwähnen sagen deem:dire.mak 🗸 ^^
demir 		Eisen TIN.UR teminkur (“ore”) ~~ +
demirci 		Schmied -ker
deri 		Leder 🗸🗸
deve 		Kamel ??
difteri 		Diphtherie 🗸
dikenli çalı 		Dorn Grat Stachel 
diktatör 		Diktator 🗸
dilenci 		Bettler  dilenmeker (-ci=-ker)
dimağ 		Gehirn Hirn  denkmach--  vs dilenci
dinamit 		Dynamit 🗸
dinlemek 		sDn!! 𓋴𓄔𓅓 *diŋ=denk QED! 听	ting1/ting4 anhören horchen aushorchen zuhören   𐱃𐰃𐰭𐰞𐰀‎ tïŋla
dinsizlik 		Atheismus Atheïsmus Gottesleugnung  DON.SIZ.LIK = sans-don-like
dip 		Boden Grund 
diploma 		Diplom Prüfungszeugnis Urkunde 🗸
diplomat 		Diplomat 🗸
dirsek 		Ellbogen ??
diyalog 		Dialog Zwiegespräch 🗸
diz 		Knie <<?
diğer bir 		anderer anders sonst  2ter-1 <<
dokuz 		neun   deci-1
dolar 		Dollar 🗸
domuz 		dummes Schwein;)
domuz eti 		Schweinefleisch EAT🗸🗸
domuz pastarması 		Speck PASTA🗸~?
dondurma 		Eis Gefrorenes Speiseeis 
doğru 		akkurat genau d'accor! 🗸~??
doğum günü/tahir? 		Geburtstag Day of Days
doğu 		Orient Osten <<^^ TAG:birth!!
doğum 		Geburt <> tragen/Tag
doğuya ait 		östlich   东	dong1	DUNKel thai/chien/china
duka 		Herzog DUKE🗸  vs shop
dük 		Herzog  duke🗸
durmak 		DURE🗸 anhalten halten Haltmachen stocken stoppen 
dört 		vier  tetra🗸
dükkân 		Butike Geschäft Kramladen Laden  << dian
dülger 		Zimmermann  dach? -ger+ -ker -ci
dün 		gestern done! von dannen🗸? ≠jin
dünya 		Welt  <<<< DON?
düzenlemek 		arrangieren einrichten ordnen anorden veranstalten 'düsen'?;)
düşmek 		fallen dash/dussel@dassel.make
düşünmek 		denken ~++
ecnebi memlekette 		Ausland ??
ekim 		Oktober 8!
ekmek 		Brot ecc.mek ess.make Eck~Korn ++~!
elbise 		Kleider  el.bise? weisse Bluse?
elektrik 		Elektrizität 🗸
elma 		Apfel ~-
emniyet 		Polizei: Eminenz🗸
engel 		Barriere Schranke angle!🗸
erkek 		Mann  HerrKeck?
erkek kardeş 		Bruder  kheart?
eski 		Ex‐ 🗸
etmek 		tun machen anfertigen herstellen leiten zurücklegen  et.make
evet 		ja doch fait! effect! 🗸?
ev kadını 		Frau des Hauses ?
eylül 		September ?
eş 		Frau Gemahlin Ische🗸 ;)
eşek 		Esel 🗸 <~
eşkiya 		Bandit Räuber ?
eşlik etmek 		begleiten 
eğer 		GAR🗸 falls insofern wenn wofern währe GAR🗸
eğlendirmek 		amüsieren belustigen ergötzen unterhalten 
fakat 		aber allein dagegen sondern ? fact faut?
falı 		Horoskop /
fare 		Maus phanr? faRat فَأْرَة‎ (faʾra) rat @pharao?
fark 		Unterschied <> part?  fake faut?
fasulye 		Bohne 
felaket 		Katastrophe fail
fena 		böse schlecht  feind/fanal/BANE! +++√
feshetmek 		annullieren für null und nichtig erklären, kassieren   <> fisch/falsch/faschist ø ?
fikir 		Gedanke Idee Vorstellung <> vicir visior Fakir
fikir vermek 		raten beraten ratgeben  ?vermek+ ^^
fil 		Elefant ~🗸
fildişi 		Elfenbein 🗸🗸 dişi~teeth!!
fizik 		Physik 🗸
formül 		Formel 🗸
fren 		Bremse ~🗸
fıkra 		Anekdote 
fındık 		Nuß  < Ποντικόν κάρυον (@Pontikón káruon)   <> filbert = hazelnut
fırıncı 		Bäcker <~
fırında pişirmek 		backen ~ picir ~🗸
fıskiye 		Brunnen Fontaine Fontäne Springbrunnen 
gaga 		Schnabel ;) greif
gazeteci 		Journalist  🗸
gece 		Nacht  kikilia!!! 🗸 <<<
gelmek 		kommen  gelai 来 < garrib √  vs gidi=gehdir/geht!
gemi 		Boot  𓎡𓄿𓇋   𓐝 𓂝 𓎡 𓊛 marke <> gemir
genelev 		Bordell  gyne™√
genişlik 		Breite   geniş.like genus?
geometri 		Geometrie √
geriye doğru 		zurück <<~ doğru~directio/dagegen
getirmek 		bringen anbringen eintragen heranbringen überbringen   getrâ.gen <> gidi=geht!
girmek 		eintreten  GIR√ !<<
gitmek 		gehen fahren treten GEHT√🗸
gri 		grau 🗸🗸
grup 		Gruppe 🗸🗸
göbek 		Bauch Unterleib 
göndermek 		schicken senden einsenden sender🗸
görmek 		sehen ansehen <
gövde 		Körper Leib ~🗸
gün 		Tag < Sonn/Jaun/Journ 🗸
gündüz 		Tag SonnDays ++🗸
gündem 		Agenda Notizbuch ^^
gürültü 		Aufsehen Braus  Gerollturb...
güve 		Motte 
güzel 		hübsch schön 'Geselle/Gazelle' <3
güzel koku 		Aroma Duft  koku~Geruch +-
güç 		Energie Tatkraft Willenskraft  GOES?
haber vermek 		ankündigen anzeigen avisieren melden anmelden verkünden < hablar?
hafta 		Woche 1/2? Hälfte?=7/14 Tage
halihazırda 		bereits schon 
halita 		Legierung   ~Lack--
hareket 		Handlung Tat 
hasırdan yapılmış 		Stroh 
hava 		Luft @heaven + 🗸?
havaî 		Fühler Fühlhorn ~Haarfa? 
havuç 		Karotte Möhre Mohrrübe 
havyar 		Kaviar 🗸
haydut 		Bandit Räuber 
hayran olmak 		bewundern 
hayvan 		Tier 🗸
hayvansal 		Tier 
hayvanbilim 		Zoologie   <bilim!
haziran 		Juni 
hücum 		Anfall Angriff  Hack;)
hece 		Silbe  Hack;)
hedef 		Ziel Zweck 
hemen hemen 		beinahe fast nahezu schier ungefähr 
her 	ev'hery ~ hAll
her zaman 		allemal allzeit fortwährend immer jederzeit stets 
hesap 		Konto Rechnung 
heyet 		Ausschuß Komitee 
hidrojen 		Wasserstoff  🗸
hikâye 		Anekdote 
hiçbir yerde 		nirgends 
hiçbir şey 		nichts 
horoz 		Hahn ~ 🗸 HORUS !!!! 
hortlak 		Geist Gespenst Phantom Spuk 
hoş 		behaglich herrlich genehm angenehm   HAG/HAUS/KUSHel 🗸
hürmet göstermek 		ehren beehren verehren   Honor-Geste?
hırslı 		ehrgeizig   Hirsch;)
hırsızlık 		Diebstahl 
hıyar[ke] 		Gurke ~
hızlandırmak 		beschleunigen  HitzLänder 🗸
idealist 		Idealist 
ihtiras 		Ehrgeiz 
iki 		zwei * secoind
iklim 		Klima 🗸~ acclimate
ilahi 		Hymne Lobgesang  Ila:Allahi Eleison Lied ~🗸
ilahiyat 		Theologie  Ila:Allahi Eleison 🗸^
ilan 		Annonce Anzeige Inserat <
ilan etmek 		ankündigen anzeigen avisieren melden anmelden verkünden 
imparator 		Imperator Kaiser 🗸
imparatorluk 		Kaiserreich Kaisertum 🗸

inanmak 		glauben  <> Imman? ErInnern?
inanç 		Glaube Glauben ^ Sinnen
inek 		Kuh  1/Gnu a NiuKuh
iptal etmek 		annullieren fürnullundnichtigerklären kassieren 
irtifa 		Höhe << *girt...
ise 		insofern falls AS... wenn wofern ++ 🗸
isim 		Name <<
istek 		Appetit   IssTech;)
istihza 		Ironie 
istiridye 		Auster  ~🗸
itaat etmek 		[in-die-Tat] folgen befolgen gehörchen 
itham etmek 		anklagen beschuldigen @DOM=judge
iyod 		Jod 🗸
izin vermek 		erlauben gestatten 
iç 	drink! 'Iss;)'🗸
içilen şey 		Getränk Trank 
içmek 		rauchen 

iş 		Angelegenheit Ding Sache Werk ISM 🗸 res chose
işitmek 		hören vernehmen 
iştah 		Appetit ISS!:) 🗸?
jeoloji 		Geologie 🗸
kabul etmek 		annehmen empfangen genehmigen GRABul?
kafes 		1.Käfig 🗸  2.Bauer Kaffer?
kahve 		Kaffee 🗸
kahverengi 		braun 🗸  Kaffee-Range Kaffee
kalay 		Zinn <>color? <<<
kalça 		Schenkel Oberschenkel 
kan 		Blut <> DAN/Tran/Som/xuen/aDam <<~🗸
kansızlık 		Blutarmut 🗸
kanal 		Graben Kanal 🗸
kanarya 		Kanarienvogel 🗸
kanyak 		Kognak 🗸
kaos 		Chaos 🗸
kapı 		Tor  CAP🗸 :
kapamak 		schließen verschließen zumachen kappen/klappe-zu~🗸
kaplan 		Tiger  !
kaptan 		Hauptmann Kapitän 🗸
kara 		schwarz 🗸   vs svari
karartmak 		anschwärzen 
karaağaç 		Rüster Ulme /
karakol 		Polizeiamt Polizeiwache 
karmakarışık hal 		Chaos 
karnabahar 		Blumenkohl Karfiol~! 
kart 		Karte Zettel 🗸
kartpostal 		Postkarte 🗸 
kartal 		Adler !!! <<~
karşı 		an gegen gegenüber wider <<<

karı 		Frau Gemahlin Karin;) ++ Kora/Kuren ~🗸
karın 		Bauch Unterleib 
karınca 		Ameise 
kas 		Muskel 
kasap 		Fleischer ^
kasım 		November kasember;)
kasırga 		Wirbelwind Zyklon 
katalog 		Katalog Verzeichnis  🗸
kategori 		Kategorie  🗸
kat'î 		akkurat genau ~
kaybetmek 		verlieren 
kayık 		Boot Kayak🗸
kayısı 		[Apri]kose Marille ~🗸
kaza 		Unfall CASE🗸?
kedı 		Katze 🗸
kelebek 		Falter Schmetterling 
kemik 		Gebein Knochen ~~  Knick/Genick;)
kent 		Ort Stadt Kant? << 堑	qian4[t] 城	cheng2
kereviz 		Sellerie 
kesin 		akkurat genau ~
keskin 		bitter 
kesmek 		schneiden ~~Cuth
kestane 		Kastanie 🗸
keza 		auch ebenfalls gleichfalls  case?
keşiş 		Mönch 
kil 		[Ki]Lehm Ton Tonerde <>
kilo 		Kilogramm 🗸
kimya 		Chemie 🗸
kiraz 		Kirsche 🗸🗸! : RED
kirli 		unlauter 
kitap 		Buch 🗸
kitapçı dükkanı 		Buchhandlung 🗸 ^^
kişla 		Kaserne ~🗸?
klinik 		Klinik 🗸
kolera 		Cholera 🗸
koltuk 		Lehnstuhl 
komedi 		Komödie Lustspiel 🗸
komite 		Ausschuß Komitee 🗸
komünizm 		Kommunismus 🗸
komşu 		Nachbar  COM-zu 🗸!<<
kongre 		Kongreß 🗸
konuşma 		Dialog Zwiegespräch 
kova 		Eimer  cover Kelle <<
koşmak 		laufen KUSH! 🗸
kral 		König 
kraliyet 		Königreich 
kristal 		Kristall  🗸
kriz 		Krisis Krise 🗸
krom 		Chrom 🗸
kulak 		Ohr <<
kullanmak 		anwenden benutzen brauchen gebrauchen verwenden verwerten 
kulüp 		Klub 🗸
kulübe 		Hütte ^? <<
kum 		Sand ~<
kumsal 		Strand ^
kumaş 		Tuch  GAMASCHE!🗸🗸<<!
kurt 		Wurm CURVED KIR(red) <<<+++ 🗸🗸
kutsal 		heilig <<
kutu 		Büchse Schachtel <> cut/kitab?
kuvvet 		Energie Tatkraft Willenskraft 
kuyruklu yıldız 		Komet Schweifstern <
kuzey 		Norden 
kuzeye ait 		nördlich 

kuş 		Vogel !!<< <>
kuğu 		Schwan 
kyruk 		Bürzel Fahne Lunte Rute Schleppe Schwanz Schweif Sterz Wedel 
köknar 		Fichte Tanne 
köpek 		Hund  KöterPack 🗸?
kötü 		böse schlecht  KOT
köprü 		Brücke ~🗸🗸!
kül 		Asche cold Gülle
kültür 		Kultur  🗸
kül tablası 		Aschenbecher 
kâtip 		Angestellte Kanzlist 
kâğıt para 		Bon Schein 
kılçık 		Gräte 
kılıç 		Schwert 
kırlangıç 		Schwalbe 
kısım 		Kapitel 
kıyı 		Küste ~~🗸?
kız 		Tochter  girlz kursa!
kızgın 		arg böse  !
kız evlat 		Tochter 
kıç 		Boden Grund KIES🗸
lahana 		[Hannelore] Kohl   ;)
lehçe 		[Dia]lekt Mundart  ~🗸?
limon 		Zitrone 🗸
limonata 		Limonade 🗸
maaş 		Gage Gehalt Salär  Much Maß;)
macera 		Angelegenheit Ding Sache Werk MACHER<>mak/mek 🗸?
madde 		Ding MATTER🗸
makine 		Maschine 🗸
manda 		Büffel 🗸!!!  𓏠𓈖𓃒𓏥 
marangoz 		Zimmermann 
mart 		März 🗸
marul 		Kopfsalat Lattich Salat 
mavi 		blau Maui;) @Maar/Navi... 🗸
maymun[key] 		Affe monkey?
mayıs 		Mai 🗸
melek 		Engel Melchior@Malik=King! << 🗸 
merkez 		Mittelpunkt Zentrum MARK!🗸
mermi 		Kugel MURMEl 🗸
mesele 		Angelegenheit Ding Sache Werk Massel🗸? TM<<<<
meslekdaş 		Amtsbruder Amtsgenosse Genosse Kollege   𓐍 𓈖 𓌰 𓅓 𓋴 𓀙 𓀀|  ⲙⲉⲧϣⲫⲏⲣ 	 friendship Meth_fairen
mezarlık 		Friedhof Gottesacker Kirchhof MESSE
meşe 		Eiche  mESCHE 🗸<<<
millet 		Nation 1000 ~🗸?
milyar 		Milliarde 🗸
mimar 		Architekt MAURer🗸?
misafir 		Gast 
modern 		modern 🗸
molekül 		Molekül 🗸
motor 		Motor 🗸
motosiklet 		Kraftfahrrad Motorrad motocyclet🗸
muharebe 		Kampf Schlacht MUCH?RABI 2
muhasebeci 		Buchrevisor 
muhteris 		ehrgeizig 
muktedir 		begabt fähig imstande tüchtig MACHT/Maketh
mum 		Kerze Licht <<
mutfak 		Küche MutterFak;))
muvafakat etmek 		beipflichten beistimmen einwilligen zustimmen zuwilligen 
muz 		Banane Mus;)
mücadele 		Konflikt Streit Widerstreit 
mühendis 		Ingenieur Mechanic? Mühen:)Does
mühim 		MAHA arg bedeutend bedeutsam beträchtlich erheblich ernst wichtig 🗸🗸
müneccimlik 		Astrologie Sterndeutung <> Muhecin?
müsaade etmek 		erlauben gestatten <> Müssen?
müvekkil 		Klient Kunde 
müşteri 		Klient Kunde Muster;)
mısır 		Mais 🗸 !
mızrak 		Lanze Speer @Misraim? Mus:Tree mei 未 mo 末 mu 木 
nakletmek 		tragen @Nacken?
nalbant 		Schmied  BANT=bronze!! <<
namevcut 		abwesend <G
namus 		Ehre NAME! <
nashihat 		Rat Ratschlag 
nazari 		theoretisch 
nefes 		Atem Hauch @NAſE
nefes alma 		Atem Hauch 
nefes almak 		atmen 

nefis 		hübsch NEFAIRS!! 🗸🗸🗸
nehir 		Fluß  NAHIR>NILE <<<<<<< ++++ 🗸
nisan 		April 

o 		er ihm ihn seiner 

ocak ayı 		Januar 

ok 		Pfeil <<

oksijen 		Oxygen Sauerstoff 🗸
okumak 		lesen OKUL:eye/see🗸
olay 		Unfall <<
olmak 		geschehen vorkommen werden zustandekommen 
on 		zehn [t]en 🗸?
on bır 		elf 🗸
ordu 		Armee Heer ORDER🗸
otel 		Hotel 🗸
otobüs 		Autobus Bus 🗸
otomobil 		Auto 🗸
oturmak 		sitzen ^^ 
oğlan 		Junge Knabe  <> Ogre=scholar Göre!!
oğul 		Sohn OLe ^^

papatya 		Gänseblümchen kleinesMaßlieb Marienblume  <3
para 		Geld  <> payer <<
pars 		Leopard 🗸🗸🗸 Parser/Panther
patates 		Erdapfel Kartoffel 🗸
patron 		Befehlshaber Chef Haupt Häupling Herr Oberhaupt Vorsteher 🗸🗸
pazartesi 		Montag pazar=1. Sunday Pasha

pek 		sehr  VS poco <<< cok

pençe 		Klaue Kralle punch<
perde 		Gardine Vorhang 
perhiz 		Diät perhibit?
peri 		Nymphe <
perşembe 		Donnerstag  4./5.Sambe @Pers
peynir 		Käse   <3
pire 		Floh piroh <
piskopos 		Bischof 🗸
piç 		Bastard Mischling Bitch;)
plaj 		Strand 🗸
polis 		Polizei 🗸
porsuk 		Dachs <
portakal 		Apfelsine Orange Pomeranze @ Portugal🗸
puro 		Zigarre <
pusula 		Kompaß 

rahibe 		Nonne   RayHippe?
rejim 		Diät 

reklam 		Annonce Anzeige Inserat 🗸
renk 		Farbe RANGE 🗸
ressam 		Artist 
revolver 		Revolver 🗸
roman 		Roman 🗸
rüzgar 		Wind 

saat 		Uhr  ZEIT
sabah 		Frühe Morgen  Sabat@7AM
sabah kahvaltısı 		Frühstück 
sadece 		kaum  sadly;)
sadaka 		Almosen ^^
sahil 		Küste <> Sahel/Sahara? <<<
sakal 		Bart <
salata 		Kopfsalat Lattich Salat 🗸
salatalık 		Gurke ~🗸
saldırmak 		anfallen angreifen ausfallen befallen überfallen <> SOLD? Söldner?
saldırış 		Anfall Angriff 
salı 		Dienstag ?
saman 		Stroh 
sanatkâr 		Artist SchönertSenat ;)

sandal 		Boot !!!<
sandalye 		Stuhl <> Stand ^^ <<<

sandviç 		Sandwich 🗸
sanki 		alsob gleichsam  SansQue??
sanmak 		vermuten voraussetzen Syn... Denk?
santimetre 		Centimeter Zentimeter 🗸
sarmaşık 		Efeu 
sarışın 		blond saray=yellow(sun)
satmak 		veräußern verkaufen SOlD
savaş 		Krieg savage!! 🗸?
sayfa 		Folio Seite ~~🗸 
saymak 		zählen aufzählen ~🗸 sayl.make
saçma 		abgeschmackt absurd ungereimt widersinnig SICK/sack/schmack🗸? ;)
sağır 		taub 
sekiz 		acht sick 8!=6
selvi 		Zypresse < 
sembol 		Symbol 🗸
sene 		Jahr Sonne🗸
sepet 		Korb pet Serpent@sepet?
sesli harf 		Vokal 
ses düzeni 		Akustik 
sevmek 		gernhaben lieben mögen  SAVE <3 'savoir'/say/see=love
seçmek 		auslesen wählen auswählen erwählen  sek🗸 select second cut
sidik torbası 		Blase 
sigar 		Zigarre 🗸
sigara 		Zigarette 🗸 
silah 		Gewehr 
silindir 		Walze Zylinder 🗸
simetri 		Ebenmaß Gleichmaß Symmetrie 🗸
simetrik 		symmetrisch 🗸

sincap 		Eichhorn Eichhörnchen 

sinema 		Kino 🗸
sirk 		Zirkus 🗸
sivrisinek 		Moskito Stechmücke  ~ Insek'snek
siyah 		schwarz ~🗸 <<
sokak 		Straße 
solucan 		Wurm 
solumak 		atmen @soul?
som balığı 		Lachs Salm ~🗸  Wal SAMEN!🗸
sonbahar 		Herbst Sonn'Bahar ->

sonra 		hinter <<< SONDER s'hintera 
sonraları 		dann darauf hernach hierauf hinten hinterher nachher später 

sormak 		fragen anfragen vs swear vs answer
soyadı 		Familienname 
soğan 		Zwiebel ~

sporcu 		Athlet Sportzu 🗸
su 		Wasser  SHUI 🗸🗸🗸
susuzluk 		Durst  ^^^ sans-shui-like gluck;)
sultan 		Sultan 🗸
suçlu 		schuldig  sucla~sculda ~🗸
suçlamak 		anklagen beschuldigen  sucla~sculda ~🗸
söylemek 		erwähnen sagen SAY'le'make 🗸🗸
söz 		Vokabel Wort SAYs SATZ ~🗸
sözcük 		Vokabel Wort ^^
sülün 		Fasan 
süngü 		Bajonett 
süpürge 		Besen <~?
sıcak 		heiß chode SICK=hot! 🗸
sıfır 		Null Ziffer zefro zero << ++ 🗸
sıgır eti 		Rindfleisch 
sınıf 		Kategorie 
sıra 		Bank Syra
sıtma 		Malaria sick 
takdire değer 		bewundernswert wunderbar 
takdir etmek 		applaudieren Beifallspenden 
taksi 		Taxe Taxi 🗸
takvim 		Almanach 
tam 		akkurat genau <> tamat:alright 
tanımak 		kennen << DENK tan tcan kenn <<< +?
taparcasına sevmek 		anbeten verehren vergöttern 
tarak 		Kamm 
taramak 		kämmen 
tatlı 		süß 
tavan 		Decke Zimmerdecke DIVAN
tavşan 		Kaninchen SAN!! 🗸/2
tay 		Fohlen Füllen ?
tayyare 		Äroplan Flugmaschine Flugzeug  teuer;)
tayyare mayadanı 		Flugplatz  Maydan
taşımak 		tragen ~~ Tasche! 🗸?<
tedavi 		Therapie ~;) 🗸
tehlike 		Gefahr 
tehlikeli 		besorglich gefährlich 
tekrar 		abermalig abermals vonneuem wieder 
temmuz 		Juli <<
teoloji 		Theologie 🗸
teorik 		theoretisch 🗸
tepe 		Halde Hügel +🗸
tereyağı 		Butter < Taur 🗸
ter 		Schweiß sweater3 : 𓈙 𓂧 𓂧 𓈒 𓈒 𓈒
terlemek 		schwitzen 
termometre 		Thermometer 🗸
tertip etmek 		arrangieren einrichten ordnen anorden veranstalten 
terzi 		Schneider tears?
tezgâh 		Bank  τράπεζα
teşekkür 		danke thanker🗸
tilki 		Fuchs  Tolkien
timsah 		Krokodil +🗸
tiyatro 		Theater  🗸
top 		Gewehr 
toplamak 		sammeln einsammeln  topple/doppel
toprak 		Boden Erdboden Erde Grund Land Terrain < TopSoil < Topra Terra?? <<
tren 			train: Zug 🗸
tugay 		Brigade 
tunç 			Tin Zink 铜 tóng :  Bronze Erz Tinktur! 🗸🗸🗸
tutku 		Ehrgeiz 
tutkulu 	ehrgeizig 
tutmak 		halten aufhalten tot-mach;)

tuz 		Salz << tuzlu ~🗸
tuzlu 		salzen salzig ++ 🗸

tuğla 		Ziegel via tégla(Hun) cegła(Turk) +++  Backstein Ziegelstein 
tören 		Feierlichkeit Förmlichkeit Zeremonie 
tüfek 		Gewehr :defekt;)
tırmanmak 		klettern klimmen 
tırtıl 		Raupe 
ufuk 		gesichtskreis Horizont 
ulus 		Nation Alles🗸
ulusal 		national 🗸
ummak 		hoffen Omen?
umut 		Hoffnung MUT🗸
unutmak 		vergessen 
uygun 		~angenehm behaglich herrlich genehm 
uyumak 		schlafen heya🗸 
uzak 		entlegen fern entfernt weit <
uçak 		~~Flugzeug Äroplan Flugmaschine  🗸-?-
uçaklar 		Flugzeug(E?) 
uçmak 		fliegen huschen : husch.make 🗸 
vapur 		Dampfer ;) 🗸?
varil 		Faß Tonne ~-
varış 		Ankunft Eintreffen  VAire=COME 🗸
ve 		und 🗸🗸
vermek 		erteilen geben angeben herreichen <<<
vestiyer 		Garderobe Weste🗸
virgül 		Apostroph 🗸
viski 		Whisky 🗸
volkan 		Vulkan 🗸
vücut 		Körper Leib : Fass Vocat
yaban eşeği 		Zebra 
yakında 		bald alsbald baldig ya:next kinda:
yalan 		flunkern lügen belügen <
yalnız 		allein alleinig bloß einzig 
yamyam 		Kannibale Menschenfresser ;) ;)
yapmak 		anfertigen herstellen leiten machen tun zurücklegen !! <
yat 		Jacht Yacht 🗸-
yatak 		Bett Bettstelle 
yatak odası 		Schlafzimmer 
yavru kedi 		Kätzchen _🗸 
yazmak 		schreiben 
yazar 		Autor Urheber VerfASSER 
yaş 		Alter YEARS 🗸
yaşamak 		leben ^🗸
yağ 		Öl ~
yedi 		sieben s'yedi siette 7
yemin 		Eid 
yeni 		neu JEUN🗸
yeryüzü 		Boden Erdboden Erde Grund Land Terrain 
yetişkin 		gedeihen wachsen anwachsen 
yeşil 		grün 
yeğen 		Nichte < Gene
yine 		abermalig abermals vonneuem wieder YA:next
yokluk 		Abwesenheit  YOK~manque
yollamak 		schicken senden einsenden ;) yalla-yalla
yulaf 		Hafer ~-
yumurta 		Ei  ;)
yunus baliğı 		Delphin Tümmler 
yüksek okul 		Kollegium 
yün 		Wolle 
yürümek 		GIR🗸 gehen laufen marschieren treten 
yüz 		hundert <
yüzmek 		schwimmen YU-swimmek ++ 🗸<
yüzünden 		da denn weil  != sondern ja's'anten denn <<
yıldız 		Horoskop 
yıllık 		Almanach 
zabıta 		Polizei 
zambak 		Lilie <<<< Sambe!?
zarf 		Adverb Umstandswort 
zarif 		elegant geschmackvoll 
zar zor 		kaum ~ schwer
zebra 		Zebra 🗸
zehir 		Gift 
zeki 		abgefeimt arglistig gerieben gewiegt gewitzigt listig schlau 
zeytin 		Olive 
zincir 		Kette << Zinkern
zooloji 		Zoologie 🗸
zürafa 		Giraffe 🗸
öfkeli 		arg böse <<<
öldürmek 		ermorden töten make-elder;)
ölmek 		sterben old;)
ölmüş 		gestorben tot verstorben 
ölü 		gestorben tot verstorben 
ördek 		Ente ErpelDUCK🗸
örümcek ağı 		Spinngewebe ~<HEB
özel 		spezial speziell ~~-
özerklik 		Autonomie Selbstgesetzgebung  auto-self?
öğleden sonra 		Nachmittag SONNRAD=hinter/sonder
öğrenmek 		lernen Ogre~Göre '🗸'
öğüt 		[Guter] Rat Ratschlag '🗸'
öğüt vermek 		raten beraten ratgeben 
ülkücü 		Idealist 
üniversite 		Hochschule Universität 🗸
üstüne evlenme 		Bigamie 
üç 		drei 🗸<
Çin 		China 🗸
Şeytan 		Satanas Teufel 🗸
çakı 		Messer CHUCK🗸
çalar saat 		Wecker caller-Zeit🗸
çalişmak 		arbeiten  KAR!! 🗸<<
çalışkan 		beflissen emsig fleißig geflissentlich strebsam 
çaprazvari 		jenseits quer über hinüber 
çarşamba 		Mittwoch 3/4-SAMBE ~🗸
çarşı 		Basar Markt Warenhaus KARStadt🗸🗸🗸
çay 		Tee Chai 🗸🗸
çek 		Bankanweisung Scheck 🗸
çekmek 		ziehen verziehen ~~
çene 		KINN🗸 Kiefer Kinnlade 
çeşme 		Brunnen Fontaine Fontäne Springbrunnen  Cysm<<<
çikolata 		Schokolade 🗸
çilek 		Erdbeere ChilliLecker;)
çimento 		Zement 🗸
çingene 		Zigeuner 🗸!
çinko 		Zink 🗸
çiplak 		bloß nackt BLANK~🗸
çiğnemek 		kauen 
çok beğenmek 		bewundern 
çok geçmeden 		bald alsbald baldig 
çorba 		Suppe <> şarap/Sirup:liquid @Latvian 🗸🗸🗸
çoçuk 		Junge Knabe 🗸🗸
çoğulu 		Leben @Schoole
çünkü 		da denn weil  DENN-SO ~~🗸-
çıkmak 		ausgehen ausrücken KUSCH!🗸
şapka 		Hut SchlappCover ~🗸?
şarap 		Wein Sirup@Caraph🗸 @Arab
şarkı 		Gesang Lied Sakral🗸?
şehir 		Ort Stadt CAIR!🗸
şeref 		Ehre <<
şey 		Ding SACHE🗸~
şiddetli 		bitter  salt'deadly :)
şikâyet 		Beschwerde Klage Schikane? 🗸?
şikayet etmek 		klagen sichbeklagen verklagen 
şimdi 		jetzt gegenwärtig nun  'same-day';) 🗸--
şişe 		Flasche <<~
şoför 		Chauffeur Fahrer 🗸
şubat 		Februar Säubert!! 🗸
ılık 		warm <<<
ırmak 		Fluß <<<<<<<<<<
İncil 		Bibel <<
İngiliz 		englisch 🗸
İngilizce 		englisch 🗸
İngiliz kamışı 		Bambus <<
İngiltere 		England 🗸
İrlanda 		Irland 🗸
İrlandalı 		Ire 🗸
İsa 		Christus !!! << Yessiah <<
İslam 		Islam 🗸
İspanya 		Spanien 🗸
İspanyol 		Spanier 🗸
İsrail 		Israel 🗸
İsveç 		Schweden ~🗸 I'Swedch
İsveçli 		schwedisch ~🗸
İsviçre 		Schweiz dieSchweiz ~🗸 
İsviçreli 		schweizerisch 🗸~
İtalya 		Italien 🗸
İtalyan 		italienisch 🗸
İtalyanca 		italienisch 🗸
