𓈖 𓏏 𓅂 𓏥		Andere
𓆓 𓂧 𓇋	[re]cite
𓌞 𓅱 𓀀		follower
𓅱 𓍑 𓄿 𓏛 𓄣 𓏤	wisser
𓄂 𓂝 𓀀		Head[official]
𓊏 𓊪 𓂝		rowed
𓐍 𓂋 𓊪 𓍢 𓆱	[mallet]
𓎛 𓀝 𓀜		hit
𓏠 𓈖 𓇋 𓏏 𓊧 𓆱		mooring-post
𓄂 𓏏 𓏏 𓍢		~prow[robe]
𓂋 𓂝 𓏏		reached
𓎛 𓎡 𓈖 𓏌 𓍢 𓀁	Honuren
𓊹 𓇼 𓄿 𓀢 𓀁	*thanker
# 𓊹 𓇼 𓄿 𓀢	an'praise?
𓊃 𓀀 𓏤	Sir
𓎛 𓊪 𓏏 𓂘	~hug
𓌢 𓈖 𓏌 𓅱 𓀀 𓏻		Kinnern
𓇩 𓅱 𓏏 𓀀 𓏥		~Crews
𓏏 𓈖 𓏥		ton
𓎙 𓂧 𓏏 𓏛		width[safe]
𓈖 𓉔 𓅱 𓅪	nauen[drown𓈗]
𓀎 𓀀 𓏥	Warrier
𓄖 𓂻 𓈖		backen
𓄖 𓅱 𓏮		Backen
𓍯 𓍯 𓏏 𓈉	"Wawat"
𓊃 𓈖 𓏕 𓂻 𓈖		centeren[pass]
𓊃 𓈖 𓅐 𓏏 𓈉		Cinemot_"Bigga"
𓅓 𓊵 𓏏 𓊪 𓏛		im 太平 [peace]
𓆄 𓍢 𓅪		shun
𓇉 𓄿 𓅱 𓏛 𓏥		Fehlern
𓇋 𓂝 𓈗	vashe
𓇋 𓐝 𓅓 𓂝		ιʋer
𓂭 𓏥	ƥoin'er
𓇋 𓐍 𓏛		echt
𓅱 𓈙 𓃀 𓀁		ansʋer
𓅱 𓄞 𓂧 𓏏 𓀁	entscheide
𓇋 𓏏 𓇋 𓏏 𓀁	sttottor
𓈖 𓈟 𓅓 𓂝	nimm'
𓌃 𓂧 𓅱	mWorden
𓅷 𓄿 𓅓 𓋳	faim[leniency]
𓋴 𓅨		schwer
𓂋 𓂧 𓅪	reden
𓆓 𓂧 𓈖	chatten
𓋴 𓆓 𓂧	schwatze
𓐍 𓂋 𓏏 𓏛 𓏥		reckter
𓅓 𓂝		ƥro'
𓆓 𓊃 𓀀		selʋs
𓃀 𓇋 𓈞 𓄑 𓈉		Brynze
𓉔 𓄿 𓂻		hurrier
𓎔 𓂝		vol#
𓍢 𓎆 𓎆		120
𓄫 𓍢 𓋴		length
𓎆 𓎆 𓎆 𓎆	40
𓋴 𓐍 𓅱 𓎺 𓋴	skopes[width]
𓇆 𓅨 𓂋 𓈘		SchwerMeer
𓋴 𓐪 𓂧 𓀜 𓀀	sPorter[sailor]

𓅓 𓋴 𓏏 𓊪 𓅱 𓍉 𓏛	Master[best]
𓅓 𓍉 𓏛		Measure[best]
𓊪 𓅱 𓍉 𓏛 best
𓅓 𓂝 𓎡 𓄿 𓀜	mochan
𓄣 𓏤 𓋴 𓈖 𓏥		ḫat.zen
𓌴 𓁹 𓄿 𓅱 𓄛 𓏥	LeyonTier
𓈙 𓈖 𓏮 𓃫	Storm
𓈖 𓈙 𓈖 𓏮 𓃫	AnSturm
𓈖 𓈙 𓈖 𓏮 𓃩 𓀜	Nocean[storm]
𓆎 𓅓 𓏏 𓊖	Chomet
𓊃 𓂋 𓃱 𓀁		see'r
𓆓 𓂝 𓊡	ShuVent[gale]
𓌡 𓍢 𓂝 𓀀 𓏤		Uno
𓎟 𓅓 𓂝 𓎡 𓄿 𓀜 precare
𓈖 𓆱 𓐍 𓏏 𓀜		nmighty
𓈖 𓆱 𓐍 𓏏 𓀜		nmächty
𓅱 𓐍 𓆼 𓅪 𓀀		UnkTaur
𓁷 𓂋 𓄣	ob-midst
𓋴 𓈖 𓏥	them
𓂝 𓏤 𓃃 𓏛 reach
𓂝 𓏤 𓃃 𓏛	reacher
𓂝 𓏤 𓃅 𓏛	reacher
𓈖 𓏥	nous
𓆑 𓄿 𓏏 𓀋 𓂝	[lift?]
𓄙 𓅓 𓇋 𓇋 𓏏 𓀁	repeat*
# 𓈖 𓍇 𓏌 𓍢 𓇋 𓇋 𓏏 𓈗	Nazareth
𓈖 𓍇 𓏌 𓍢 𓇋 𓇋 𓏏 𓈗	measuren
𓐋		8
𓎛 𓎛 𓀝 𓀜 𓈖	kerkern?
𓊃 𓊪 𓊗 𓌡 𓍢 𓂝 𓀀 𓏤	zoi'uner[survive🗲21]
𓌡 𓍢 𓂝 𓀀 𓏤 Uner
𓉔 𓂋 𓅱 𓇳		Horen🕔
𓏻 𓏤		3
𓌡 𓍢 𓂝 𓏤 𓅪		unoer[alone]
𓌢 𓈖 𓏌 𓅱 𓀀 𓏤 𓏤	twinner[companion]
𓊃 𓇥 𓂋 𓁀	snoren
𓎡 𓄿 𓊪 𓎅 𓉐	cave
𓈖 𓆱 𓏏 𓏤	Nest
𓈖 𓍇 𓏌 𓅱 𓇋 𓇋 𓏏 𓈗	measurens
𓈖 𓆱 𓏏 𓏤	Mast
𓎛 𓎛 𓀝 𓂝	[broke]
𓐍 𓐍 𓐍		except
𓅾 𓀁	feør
𓈖 𓆓 𓊃 𓅪 𓀀 𓅓	anschisser
𓄿 𓏏 𓅱 𓀜	earthen[blanch]
𓊪 𓎛 𓄖 𓈖		back[reached]
𓈎 𓈖 𓇋 𓂘 𓂝 𓈖	Knicken
𓆄 𓍢 𓇋 𓇋 𓏏 𓇳		shåyde
𓂧 𓂾 𓂾 𓀀	jampod
# 𓂋 𓐍 𓏛 𓂝 𓏏 𓀀	recked
𓂧 𓄿 𓃀 𓇭 𓈒 𓏥	Trauben
𓇋 𓄿	hier
𓂋 𓂋 𓏏 𓁺 𓈒 𓏥		Roots𓇜
𓇋 𓄿 𓈎 𓏏 𓆰 𓏨	verdges🍆
𓀻 𓋴 𓏏 𓏛	sit(e)
𓎡 𓄿 𓅱 𓈒 𓏥	karün🍏
𓈖 𓈎 𓅱 𓏏 𓈒 𓏥	Neqtars[figs]
𓊏 𓊪 𓏏 𓈒 𓏥		Rote🍉
𓁹 𓏏 𓋴		møchet es.
𓂋 𓅓 𓍢 𓆟 𓏥	[fish🐟]
𓄿 𓊪 𓂧 𓅱 𓅬 𓏥	airpod🐦
𓋴 𓋴 𓐠 𓄿 𓀁	spucken[sated]
𓂋 𓂝 𓈖 𓀀	ra'n
𓈖 𓅨 𓂋 𓁷 𓏤	an ver ob [because of much on]
𓂝 𓏤 𓅱 𓏮	Arms
𓄞 𓂧 𓏏 𓂝		Scheit🌲🔥
𓍑 𓄿 𓏴 𓆱	ƭair🌲🔥
𓊄 𓅪 𓈖 𓏴 𓏏 𓊮	schwel 🔥 Nághtƭire
𓊹 𓏤 𓏥	Nature
𓊹 𓏤	Nature

𓐍 𓂋 𓊤 𓃭 𓅱 𓀁	cryoaw
𓈎 𓂋 𓇋 𓃫 𓀜	Quri[storm]
𓇋 𓃀 𓃙	 hyper
𓍯 𓄿 𓅱 𓈗		roaren[waves]
# 𓈖 𓆓 𓊃 𓅪 𓀀	anschisser
𓆓 𓊃 𓅪 𓀀	Sir
𓅠 𓅓 𓅠 𓅓 𓏴		[quake]
𓏠 𓈖 𓏠 𓈖 𓂻	[shake]
𓎡 𓆑 𓋳 𓈖 𓀀	[uncover]
𓆑 𓄿 𓅱 𓆚	Snake
𓊪 𓅱	whon
𓊪 𓍢	vhon
𓊪 𓈖	vhon
𓈖 𓄓	longue
𓇓 𓍢	su
𓎔 𓂝	vol#
𓐍 𓃀 𓊃 𓅱 𓏏 𓁸	chops[beard]
𓅨 𓂋 𓋴 𓂋	gvrößer
𓎔 𓂝  𓏻		full 2cubits
𓎛 𓂝 𓄹 𓏥	Körpern
𓊃 𓐍 𓂋 𓅱 𓌕 𓀜	[plated]
𓋞 𓈒 𓏥	Nobel[gold]
𓇋 𓆛 𓈖 𓂃 𓏮	EyenBrows
𓐍 𓋴 𓃀 𓂧 𓈒 𓏥	Ka🔵Spatit[lapis]
𓌴 𓐙 𓂝 𓆀 𓏛	mwahr-core
𓂝 𓂋 𓈎 𓍼 𓏛	ro'quz'?[bent]

𓄋 𓊪 𓏴 𓈖	open
𓈖 𓅓 𓂝	µWho
𓊗 𓏻	zweit[2mal]
𓇋 𓂋		ifr
𓅱 𓂧 𓆑 𓅬 𓂻	waitsen
𓊃 𓊃 𓊮		Asches
𓇋 𓍢 𓌃 𓂧		answord*
𓎡 𓐍 𓅓 𓂜 𓈖		igno:faint
𓐍 𓅓 𓂜 𓈖		igno:faint
# 𓎁 𓏏 𓀜		ziehn
𓎁 𓏏 𓀜		take
𓋴 𓇛 𓅓 𓀔	[residence]
rest S29 𓋴 M29 𓇛 G17 𓅓 A55 𓁀 
sit S29 𓋴 M29 𓇛 G17 𓅓 A55 𓀼 
resit S29 𓋴 M29 𓇛 G17 𓅓 A55 𓀔 
# 𓋴 𓇛 𓅓 𓀔	snatch?

# 𓍯 𓄿 𓎛 𓎝	royal
𓍯 𓄿 𓎛 𓎝	raiche
𓂧 𓏇 𓇋 𓏏 𓂝		dermis[touch]
𓂧 𓏇 𓇋	dermi[touch]
# 𓂧 𓏇 𓇋	thermi
𓅱 𓍑 𓄿 𓏛	unversehrt
𓎁 𓏏 𓏏 𓀜		taketh
𓐝 𓏤		part
𓈖 𓍇 𓏌 𓍢	Näzeren!
𓅱 𓈙 𓃀 𓏴 𓀁		answeren
𓄋 𓊪 𓅱 𓏏 𓂻		Caput[mission]


𓄤 𓆑 𓂋 𓏏 𓏛 𓏥	Goods
𓐇	4
𓈙 𓂉 𓀁 𓅱 𓏮	Schnuten
𓎆𓎆𓎆𓎆 𓎆𓎆𓎆 𓐈	75
𓆎 𓅓 𓏛 Σoumnt
𓋴 𓐍 𓆼 𓄿 𓀁		shkidtaur


𓄿 𓅓 𓊮 𓈖 𓏮		burned
𓌡 𓍢 𓂝 𓏏 𓏤	one[ce]
𓈎 𓈖 𓀜	kühn

# 𓊃 𓅭 𓄿 𓏏 𓅱 𓈇 𓏥 
𓊃 𓅭 Son
𓄿 𓏏 𓅱 𓈇 𓏥	Earth


𓅨 𓂋	gver
𓅨 𓂋	 𓈖 𓎡		gver an u
𓊪 𓆑	who∫

𓃛 𓅱 𓂧 𓂻		[separate]
𓏏 𓈖		ton


# 𓈖 𓎡 𓂸 𓃒 𓏤 𓏥	Necks
𓎡 𓂸 𓃒 𓏤 𓏥	Kuphallos𓃒
𓅱 𓈙 𓈖 𓅿 𓂝 𓈖 wrung necks
𓎛 𓂝 𓅱 𓊛 𓏤 𓏤 𓏤	hRow𓊛
𓄿 𓏏 𓊪 𓅱 𓀁 𓀜	[loaded]
𓀻 𓋴 𓋴 𓏛 𓏥	Specials
𓌸 𓂋 𓂋 𓀁		merry🎔
𓂓 𓏤	Kan
𓌨 𓂋		care
𓋴 𓐪 𓂧 𓅱 𓀜 𓀀 𓏥		Spartan
𓅓 𓏏 𓏱		muert
𓎡 𓅓 𓊖 𓏏 𓏤	Chomethy
𓆎 𓅓 𓏏 𓏛		Chomethy
𓊃 𓆷 𓄿 𓄃 𓏛		Szwarm[pray]
𓋴 𓆣 𓂋 𓈖 𓀀		s'happern
𓆣 𓂋 𓏏 𓏛 𓏥		Happert
𓆣 𓂋 𓏏	happert
𓆣 𓂋 𓈖		happern
𓆣 𓂋 happer
𓆣	happer

𓊃 𓂋 𓏏 𓃱 𓀁		gürrt
<> Tigern ;)

𓋷 𓀁 𓈖 𓀀		recognize
𓋴 𓏇 𓇋 𓏏 𓀁	su'mit
𓊗  𓏻		twice
𓆓 𓊃 𓅪 𓀀	selζir

𓌨 𓂋 𓏏 𓏛 𓏥 𓀀	courtesy
𓅓 𓂝 𓅓 𓂝 𓄛		AfroTair

𓌻 𓂋 𓂋 𓇋 𓇋 𓏏 𓏳 𓏥		Myrrhte
𓎛 𓇋 𓇋 𓏏 𓄑 𓏥		[Tusk]
𓍋 𓃀 𓅱 𓌟		el'Phanter
𓍿 𓊃 𓅓 𓍢 𓃡 𓏥	chien
𓎼 𓅱 𓆑 𓃸 𓏨	giƃƃon
𓎡 𓇋 𓇋 𓅱 𓃷 𓏨	(mon)keys
𓄿 𓏏 𓊪 𓀋 𓂝 𓈖	*top-loaden

𓂧 𓊪 𓏏 𓊛 𓏏 𓈖		Boat den
𓊛 𓏏 𓈖 Boat den
𓊹 𓇼 𓄿 𓀢 𓈖		~anpreisen
𓂋 𓈖 𓊪 𓇋 𓇋 𓆳		rejuvenate
𓂋 𓌸 𓂋 𓇋 𓇋 𓏏 𓈇 𓏤		A merita (shore)

# 𓈖 𓂝 𓏏 𓊛		Northen
𓈖 𓂝 𓏏 𓊛		nauth*

𓅓 𓂝 𓊄 𓂻 𓈖 𓀀	prøsentieren I



𓄿 𓊪 𓂧 𓅱 𓅬 𓏤 𓏤 𓏤	AirPoden𓏥
𓄟 𓋴 𓅱 𓀀 𓁐		Mnaissu'
# 𓏏 𓏏	that
# 𓏏 𓏏	tit
𓏏 𓏏	thit
𓏏 𓏏 𓅪 𓁐	Tochter?
𓅭 𓏏 𓁐	duckter
𓋴 𓃀 𓄿 𓇼 𓇳		Spheren
# 𓐍 𓏏 𓊮	Kessel🔥
𓐍 𓏏 𓊮	KHeat🔥
𓆞 𓄿 𓇋 𓇋 𓏏 𓐎	Bäyte[Corpses!]
𓉔 𓄿 𓍢 𓂻	hurrenn
𓉔 𓄿 𓍢 𓂻	höhrenn
𓋴 𓈖 𓂉 𓀁	Snauze
𓀔 𓀀 𓁐 𓏥	Chirds
𓐍 𓏏 𓏛 𓏥	Güter
𓈞 𓏏 𓁐		Brünnt
𓌢 𓈖 𓏌 𓅱 𓀀 𓁐	twinnern
𓎡 𓃹 𓈖	cousin
𓈎 𓄿 𓃀 𓄲	curʋe
𓎡 𓍢 curl
𓂧 𓌳 𓄿 𓍖 𓏛	smiter
# 𓊃 𓈙 𓄿	saisser
𓊃 𓈙 𓄿	conaisser
𓅢 𓏛 𓏥	Pwower
𓇋 𓃀 𓃙 𓇋 𓏊		δiψ:soif
𓂋 𓐍 𓏛		reckter
𓈖 𓆑 𓅪 𓅓 𓄣 𓏤	Unsinn
𓇑 𓇑	that
𓋴 𓃀 𓏏 𓄑 𓀁	sbaitze
𓋾 𓈎 𓄿		Herqher
𓅆		Hor
𓊪 𓃹 𓈖 𓏏 𓈉	Punt™
𓃀 𓅱		being
𓊃 𓊪 𓊗	Zoi'
𓈖 𓍇 𓏌 𓍢 𓇋 𓇋 𓈗	nwässeren
𓏏 𓃱 𓀁 𓈖	Tigern
𓏃 𓈖 𓏏	Front
𓇍 𓇋 𓏏 𓂻	commeth
# 𓇍 𓇋 𓏏 𓂻	fairet
𓈖 𓏏 𓅂 𓀀	Andere
# 𓆱 𓏏 𓏤 𓏥	Masta
𓆱 𓏏 𓏤 𓏥	Äste
𓆱 𓏏	Mast
𓈎 𓄿 𓀠	⍐quer
𓋷 𓀁
𓇓 𓍢	su
𓂋 𓐍 𓏛	reckter
𓏏 𓀁		tu
𓋴 𓏏		cet
𓈝 𓅓 𓂻	schmieren
𓋴 𓈖 𓃀 𓏏	SaneByeth
𓅓 𓂝 𓎡	Frog
𓅓 𓂝 𓎡	Moyk
𓅓 𓂝 𓎡	Look
𓇋 𓐝 𓅓 𓂝		impro
# 𓂋 𓈖		Reim[name]
𓊹 𓌢 𓈖 𓏏 𓂋 𓆵 𓈒	Incenser
𓂝 𓈖 𓅂 𓏋	Onanger[myrrh]
𓂝 𓈖 𓅂 𓏋	Honur[myrrh]
𓎛 𓎡 𓈖 𓏌 𓍢 HkenUren
𓎛 𓎡 𓈖 𓏌 𓍢		Honuren
𓇓 𓍢 su
𓇓 𓍢 𓎛 sucher
𓂻 𓅱 𓂧 𓈖 𓃀	IrenSänft
𓄡 𓊃 𓄿 𓇋 𓇋 𓏏 𓈒 𓏥		ScoSaft
𓌢 𓈖 𓏏 𓂋 𓆵 𓈒 𓏥	Incenser

𓊃 𓐟 𓄿 𓇋 𓇋 𓏏	Special
𓍘 𓀻 𓋴	TiShops
𓆷 𓄿 𓂝 𓊃 𓐍	Schwarz
𓄟 𓋴 𓂧 𓅓 𓏏	Messdoms
𓋴 𓂧 𓅱 𓄢	Stäuren
𓂝 𓎡 𓌨 𓂋 𓏏 𓏛 𓏥	Orkus
𓊖 𓏏 𓏤	Ort
𓊄 𓃀 𓏏 𓏛	Ship[ment]
# 𓊄 𓃀 𓏏 𓏛	Zepter
# 𓃀 𓅡 𓄿 𓎛 𓂺 𓏛	Fucker laut dict!
𓃀 𓅡 𓄿 𓎛 𓂺 𓏛	Pressence
𓄡 𓂋 𓂧 𓅱 𓀔 𓀀 𓁐		Chird
𓄡 𓂋 𓂧 𓀔 𓀀 𓁐		Chird
𓈎 𓈖 𓇋 𓂘	Knicks
𓆼 𓄿 𓅓	Kotau
𓂋 𓍿 𓀀 𓁐	Racker
𓂋 𓍿 𓀀 𓁐 𓏪	Racker
𓂋 𓍿 𓀀 𓁐 𓏥		Racker
𓇋 𓏏 𓈖 𓇳	AdonRay
𓇋 𓈎 𓂋 𓏛	akkurater
𓌸 𓂋 𓇋 𓇋 𓏏 𓈇 𓏤	aMerita
𓂧 𓊪 𓏏 𓊛	Boot
𓀎 𓀀 𓏥	warrier
𓈎 𓂋 𓋴 𓏏 𓊭	Cursa
𓈖 𓂋 𓂝 𓈖 𓀀	Nordener
𓎛 𓎡 𓈖 𓏌 𓍢 𓀁	Honouren
# 𓎛 𓎡 𓈖 𓏌 𓍢 𓀁	Kanuren
𓉔 𓄿 𓅱 𓏛 𓏥	huørren
𓇋 𓄿 𓈙 𓀁	hier-schrein
𓈀 𓈇 𓏤	Eiland
𓄚 𓈖 𓏌 𓍢 𓉐 𓈖 inneren
𓄚 𓈖 𓏌 𓍢 𓉐	Inneren
𓇾 𓈇 𓏤		Terra
𓂋 𓇥 𓂋	à-couer
𓇋 𓅓 𓋴	in es
# 𓇋 𓅓	im
𓇋 𓅓	ιber
𓏇 𓇋 𓏏 𓏏 𓏛		[alike]
𓇋 𓂋 𓏮		ir𓏮?
# 𓈖 𓏏 𓏮		Andere
𓈖 𓏏 𓏮		anty
𓈖 𓏏 𓅂 𓀀 𓏥 Andern
𓈖 𓏥	nous
𓐍 𓂧 𓊛	Kutter
𓄭 𓂋 𓂻		arriʋer
𓎡 𓅱 𓀀	ick
𓎡 𓍢 𓀀		ick
𓏌 𓎡 𓀀	ürck
𓐍 𓏏 𓆑 𓁷 𓏤	facing 
𓈎 𓈖 𓃀 𓏏 𓊋 𓀀		council
𓊃 𓆑 𓏏 𓌪 𓀜 𓀀		Schnitter
𓊄 𓂻 𓈖 𓀀	ziehen-I
𓊄 𓂻	ziehe
𓏎 𓏌 𓏥	Takern
𓇹 𓇼 𓂧 𓇳	Monđh
𓇹 𓂧 𓇳	Monđh
𓏎 𓈖	taken
𓐍 𓏏 𓆑	seeing
# 𓐍 𓏏 𓆑	[according]
# 𓐍 𓏏 𓆑	katzen
𓌞 𓍢 𓀀	follower
𓐠 𓏤	back
𓋴 𓐠 𓄿 𓎛 𓃃 𓏛	spähern
𓇼 𓄿 𓇳	'dawn
𓂻 𓅱	commen
𓅧 𓈎 𓂻	commen
𓅧 𓈎 𓂻	shaqern
𓆊 𓆊 𓅆	𓆎meSire
𓁶 𓀀 𓁐 𓏥	Top'ers
𓌴 𓁹 𓄿		µvoyer
𓌴 𓁹 𓄿 𓅱	µoyern
𓇾 𓈇 𓏤	Terra
𓂧 𓊪 𓏏 𓄓 𓀁	ŧåste
𓊢 𓂝 𓈖	then
𓂋 𓂝 𓏏	raicht

𓇋 𓈖 𓅓 𓂋 𓂝 𓏏	imortal / reicht

𓊃 𓆑 𓏏 𓌪		Schnitt
𓌪 𓂝	cut'

𓅠 𓅓 𓇋 𓇋 𓏏		find
𓅓 𓏞 𓏛 𓏞 𓀀	im writ' 'ωthor

𓂭 𓂭 𓂭	pointer

𓄂 𓏏 𓏤	ḫead
𓇋 𓇋 𓏏	it
𓋹 𓍑 𓋴	AnkCeterSan e.t.c.
𓉻 𓂝 𓄿 𓏛	Maxaar
𓉻 𓂝 𓄿 𓏛 𓀀	Maxaar
𓇋 𓏠 𓈖 𓇋 𓇋	Armeni
𓇋 𓏠 𓈖	Amen
# 𓇋 𓏠 𓈖 𓇋 𓇋 𓆇 𓇋 𓏠 𓈖	"Amen-ei-amen"











𓄿 𓊪 𓂧 𓅬	airƃød(bird)
𓇥 𓂋	car:weil
𓏞 𓏛	writer
𓆓 𓂧	chatr
𓄚 𓈖 𓏌 𓅱 𓉐	Inneren
𓇆 𓅨 𓂋 𓇋 𓈗 𓈘	Schver💚Meer💙𓈗
𓐍 𓈖 𓌰 𓅓 𓋴 𓀙 𓀀	cyn-mess?[friend]
𓂋 𓋴 𓋹 𓈖 𓐍 𓏏	re-sankht
𓏶 𓐝 𓌽 𓏪	Progress?
𓂋 𓂝 𓇳 𓏤	Ra'd
𓋹 𓍘 𓇋	Sankti
𓆶 𓍘 𓇋	Jupity
𓃹 𓈖 𓈖	(Da)Sėnnen
𓂧 𓆓 𓆑	chat-sayn
𓆓 𓂧 𓆑	chat-sayn
𓋴 𓋹 𓈖 𓐍		thank
𓉻 𓈙 𓆑 𓏏 𓏛	Maxshēster
𓏸𓅃 𓈌 𓈌 𓎛 𓂝 𓏻 𓐝 𓈌	Horachter Horizon
𓐝 𓂋 𓈖 𓆑 𓐝 𓆄 𓅱 𓈖 𓏏 𓏻 𓐝 𓇋 𓏏 𓈖 𓇳	Raj Meren-Sin-Shuntin Adon
𓆄 𓅱 𓈖 𓏏 𓏻	Shunty
𓈖 𓏏 𓏻	antë
𓊃 𓈖 𓏪	them
𓄔 𓅓	hear
𓄔	ear
𓇿 𓇿 𓇿 𓈅 𓈅 𓈅	Ländern
𓎛 𓂝 𓏻	Heroi
𓏸𓅃	Haro
𓇳 𓄤	Raichard
𓇳 𓆣 𓏪	Raikhaper
𓈌 𓈌	Harachty
𓂋 𓈖	Reiname
𓆄 𓅱 𓈖 	Sun
𓇋 𓏏 𓈖 𓇳		Adon-Ray
𓏏 𓈖 𓇳 𓇋		Athena
𓆓 𓏏 𓇿	steadta
𓎛 𓇳 𓎛	∞heroher∞	immher
𓉳	Seht-Fest
𓍲 𓈖 𓈖	scheinen
𓏏 𓍷 𓏤	total
𓎟 𓇿 𓇿 𓈅 𓈅	All-Taui
𓎟 𓇿	All-Terr
𓇿 𓇿 𓈅 𓈅	Terrain
𓇿 𓇿 𓈅 𓈅	Länder
𓉐 𓏤		Thor
𓉐 𓏤	porta
𓇓 𓏏 𓆤 𓏏	Shubiter
𓐝 𓐙 𓏏	Maath
𓈍 𓏼	Khronon
𓆣 𓇳	Copray
𓈍𓏼	Khronon
𓅜 𓐍 𓈖	Akhen
𓌡 𓈖	1(uan)
𓊢 𓂝 𓇳 𓏤		Aera
𓊢𓂝𓇳𓏤	Aera
𓂝 𓇳 𓏤	'Ray	Uray?
𓇓 𓈞 𓏏	gyneth?:queen
𓅨 𓏏	gvert
𓅨 𓂋 very
𓈘 𓏏	merryth♡
𓈘 𓏤		merry♡
𓄤 𓄤 𓄤 𓄤 𓄤	Beth	Beauth
𓇍 𓍘 𓁗	Comethia
𓇍 𓍘 𓁗	Arrythia
𓋴 𓈖 𓃀 𓍘		sanevty
𓂧 𓆓	chat
𓂧 𓆓	says
𓁹 𓂋	mayker
𓈍 𓂝 𓇋 𓇋 𓏜	Chrysan	chroiter
𓄤 𓆑 𓂋	schöner
𓈌 𓏏 𓉐	Achtor
𓊪 𓏏 𓇯	Photair
#𓅮 𓇋 𓏏	(archae)Ophteith
𓄿 𓆷 𓂝 𓏛	Erschaffer?	Erschöpfer?
𓏇 𓏏 𓏏 𓏛	mitter:similar
𓇋 𓅱 𓎡	you
𓊵 𓏏 𓊪	conto[nt]
//𓊵 𓏏 𓊪	Hotaipea[ce]
𓏏 𓀐	töt/tuer
𓊪 𓊃 𓎛 𓄑 𓏪	boißen
𓊃 𓈖 𓏪	them
𓂝 𓈖 𓁹 𓍘 𓇋	anmuitig
𓅱 𓈖 𓇳 𓃀 𓍘 𓇋	antreibst
𓋁 𓏏 𓈉	Eastland
𓎔 𓏛	füll*
𓇿 𓏤 𓈅	Länder
𓍘 𓎛 𓈖 𓋣 𓍿	tcherneth:strahlend
𓈎 𓀠 𓏜	quer:great
𓁷 𓏤 𓁶 𓏤	obhere
𓄝 𓏏 𓅱 𓇶	Shooten-Rays
𓄝 𓏏 𓅱 𓏏 𓇶	Shooten-Rays
𓄝 𓏏 𓏏 𓅱 𓇶	Shooten-Rays
𓇋 𓆛 𓈖 𓎛	umher
𓍢 𓈅	unter?
//𓂡	ern
𓁹 𓏏	maykt
𓂋 𓂝 𓇳	Ray
𓏎 𓈖	bringen
𓂋 𓂋 𓂝 𓏤	Rear
𓅱 𓂝	wo
𓅱 𓍢 𓂡	warren
𓍯 𓈐 𓂻 𓍘 𓇋	roady:far
𓋀 𓏏 𓈉	Westland
𓋀 𓏻 𓂢	Westtėll
𓈝 𓐝 𓂻 𓏏	Schreite
𓈝 𓐝 𓂻	schreite
𓃀 𓍇 𓏌 𓍢	berechnurn
𓎡 𓎡 𓇰	Dun.kell.air
𓎡 𓎡 𓇰	duk.air
𓋴 𓐍 𓂋 𓏛 𓈖	Charta'n
𓊃 𓇥 𓂋 𓁀 𓏪	snoren
𓊏 𓊪 𓉐	Room
𓁶 𓏤 𓏪	heads
𓎛 𓃀 𓊃 𓋳	herbst*
𓂜	non
𓊪 𓏏 𓂋	photer
𓆵 𓁺	jamoy?
𓁹 𓏏 𓏤 𓏮	(m)aueyes
𓏌 𓏏 𓋴	urnders
𓇋 𓅷 𓂷 𓂡	fetchi
𓏏 𓍢	ton
𓐍 𓏏 𓏛 𓏪	Ghuter
𓇋 𓅱 𓏪	iunter
𓂝 𓐝 𓄈 𓀁	o'merken
𓅁 𓇋 𓄛 𓏪	MauriTiere(Lion/Meuter)
𓉐 𓂋 𓂻	partiere
𓃭 𓏤 𓃭 𓏏 𓏮 𓉐	lHölhen?
𓆓 𓂧 𓆑 𓏏 𓄛 𓏪	Chat-sayn-Tiere
𓎛 𓇶 𓄿 𓅱 𓊮 𓉐	Herden🔥
𓋴 𓎼 𓂋 𓀁	Sweiger
𓅮 𓁹 𓂋 𓏪	,so[lang] Maker
𓌈 𓆓 𓇳	weiß𓇳rays [morning]
𓊪 𓊃 𓂧 𓄧 𓇳 𓍿	phozfourayst
𓉔 𓇳 𓏤	Houra
𓎱 𓃀	Festival
𓂋 𓅱 𓇋 𓂻	ruinier	eruier?
𓂞	dar[reich]
𓎛 𓇳	Hera
𓇶 𓏤 𓏪	Rays
𓍟	rise
𓁺 𓊢 𓂝 𓂻	Riesen-Heroer
𓁷 𓏤 𓂋 𓂧 𓏻 𓅱 ob-rechten
𓁷 𓏤 𓂋 𓂧 𓍢 𓏮	ob-rechten
𓁷 𓏤 𓂋 𓂧	ob-rechten
𓂾 𓂾 𓆑 𓏻	Podhes
𓂋 𓂧 𓍢 𓏮	rechten
𓂾 𓂾 𓍿	Ganges/Podes
𓂾 𓂾	Phodhes
𓊃 𓇋 𓇋	(an)zieh?
𓍞 𓈖	risen
𓃂 𓈗	pouren
𓎛 𓂝 𓄻 𓄻 𓄻	Körporn
𓊏 𓊪 𓂡 𓏪	Roben
𓐍 𓅱 𓍼 𓋳	g'anzieh*
𓈍 𓂝 𓏤 𓂝 𓏛	chromater
𓂝 𓏤 𓂝	Arme
𓋹𓈖𓐍	Sankh
𓋹 𓈖 𓐍	Sankh
𓀢 𓏪 𓈖	hailen
𓊃 𓈖 𓏪	them
𓂋 𓇥 𓂋	erkor/ärger/ergor/rege
𓂓 𓏏 𓀋	Kauda?[count/work?]
𓇋 𓄿 𓏏 𓄛	[H]erden
𓊃 𓄧 𓐝 𓆰 𓏪 	Zu-fressen
𓊃 𓄧 𓐝 𓆰 𓏼	Cypressen
𓍲 𓈖	Esschen
𓏌 𓅱 𓆭 𓆱 𓏪	Urwald
𓄿 𓐍 𓄿 𓐍 𓆰 𓏪	Aichen?
𓁷 𓏤 𓄿 𓐍 𓄿 𓐍 𓆰 𓏪		ob-fechern?
𓅬 𓏪	Goosen
𓅮 𓄿 𓅱 𓆃 𓏪	ophlairen
𓅹	Nestor
𓂧 𓈖 𓎛 𓆃 𓏪	Daunern
𓀢 𓏪 𓈖	hailen
𓂓 𓏤 𓎡	Kan-you
𓌙 𓃲 𓏏 𓏪	Ante(läuper)
𓁷 𓏤 𓍿 𓃀 𓉔 𓈖 𓂾 𓂻 𓏪	obsprhonge
𓂋 𓂧 𓏮 𓅱 𓂾 𓂾	rechten-Füßen
𓅮 𓇋 𓇋 𓆃 𓏪	ophten?
𓐍 𓈖 𓈖 𓅯 𓏏	khenneth?
𓅱 𓈖 𓇳 𓃀 𓈖	antreiben
𓊢 𓂝 𓅱 𓊛 𓏪	Bowen?
𓐍 𓂧 𓊛	Kutter
𓏃 𓈖 𓏏 𓏮	front
𓊛	[abwärts??]
𓏇 𓏏 𓏏 𓏛	mitter

𓈍 𓂝 𓏛	chrome
𓂋 𓐝 𓅱 𓆟 𓏪		Rinen??
𓇋 𓏏 𓂋 𓍢 𓈗 𓈘	Itren
𓏏 𓆑 𓏏 𓏴 𓂻 𓈖		schnellen
𓄚 𓈖 𓉐	inner
𓇆 𓅨 𓂋 𓇋 𓈗 𓈘 𓈅 𓏤	Richo Vermeer
𓅁 𓇋 𓇋 𓂺 𓏪	Maísen
𓈞 𓏏 𓀀 𓏪	Brüter
𓄡 𓏏 𓏤	Scrotum
𓈖 𓅐 𓏏	Muttee
𓋴 𓎼 𓂋 𓎛 𓂢 𓀁	schweiger	wiege
𓋴 𓎼 𓂋 𓎛	schweiger
𓇓 𓅱		su
𓏏 𓍃 𓐝 𓏛	Trainter
𓏏 𓍃	Train
𓏏 𓍃	Tommy
𓏏 𓂋 𓐝 𓇋 𓇋 𓁿 𓏪	Traine	
𓏠 𓈖 𓂝 𓏏 𓂑	Amme
𓇋 𓇋 𓍢 𓏪 𓊡 𓏪	Ian-Vianne ♀
𓉔 𓄿 𓏻 𓂻	hoerir
𓏏 𓊪 𓏏	Tuten
𓉔 𓂋 𓇳 𓏤	Hora
𓄟 𓋴 𓅱	Messun
𓄋 𓊪 𓏴 𓅱 𓀁	openen
𓂋 𓏤	Rachen
𓐪 𓂧 𓏛 𓏪	poster
𓐪 𓂧 𓏌 𓏛	poster
𓏏 𓏛 𓏪	Terrain
𓅷 𓏤	Chück
𓋴 𓅱 𓎛 𓏏 𓆇	Generteii
𓌃 𓂧 𓅱 𓀁	mWoden
𓇋 𓈖 𓂋 𓊌	Ei'er-Schal
𓊡 𓏪	vent
𓄚 𓈖 𓏌 𓉐	Innere
𓁹 𓈖	mayken
𓋬 𓇋 𓇋 𓏛	Maater
𓋬 𓂧 𓇋 𓇋 𓏜	Maather
𓋴 𓂧 𓈅 𓏴 𓂡	statren
𓌃 𓂧 𓏏 𓀁	mWorde
𓏏 𓇿 𓇿	taui-2-länder
𓇿 𓇿	taui-2-länder
#𓇿	län[der]
𓆈 𓏪 𓏻	Exaty
𓅱 𓋴	wes
𓈙 𓏏 𓍔 𓏴 𓏛 𓏪	[obscuren]
𓊹 𓀭	Pater
𓌡 𓂝 𓏤	un'or
𓂜 𓈖	non
𓇋 𓇋 𓁷 𓏤	'iob 
𓐍 𓏪	2ker
𓈎 𓌳 𓌙 𓏜	maqanz
𓈖 𓄣 𓏤	na' Hearte
𓍿 𓐝	com
𓏠 𓈖 𓏠 𓈖 𓃒 𓏪	Manymähn
𓌙 𓃲 𓏪	Antler
𓈝 𓅓 𓂻 𓅱 𓏪		schimmeren
𓂝 𓐍 𓀠	Orquer
𓈉 𓏏 𓏪	Länter
𓆼 𓃭 𓏤 𓌙 𓈉	TaurLeone
𓎡 𓈙 𓌙 𓈉	KuSchan
𓊃 𓈖	zum
𓆎 𓏏 𓊖	Khemet[𓆎Egypt𓆏]
𓊨 𓏏 𓉐	Staettor
𓌡 𓏤 𓂝 𓎟	uno-a-all
𓌨 𓂋 𓏏 𓏛 𓏪	Undertern
𓌨 𓂋 𓏻 𓂋	Undertier
𓐎 𓏛	planther
𓊢 𓂝 𓇳 𓏤		Aera
𓄓 𓏤 𓄺 𓏪	Tzongen
𓄋 𓊪 𓍢 𓏴 𓏛	open
𓌃 𓂧 𓏏 𓏪	mWordte
𓇋 𓆛 𓈖 𓌰	Feder/Taint/Anmaß?
𓇋 𓆛 𓈖 𓌰	Anmaß?
𓁸 𓏪		Haput-Haare
𓋴 𓏏 𓈖 𓏌 𓍢 𓅱 𓌙 𓅯 𓏜	'trennen-
𓋴 𓏏 𓈖 𓏮 𓌙 𓅯 𓏛	xten'en-ter
𓈉 𓏏 𓏪	Territory
𓌙 𓀀 𓁐 𓏪 𓈉	Anterre
𓎛 𓂝 𓊪 𓏮 𓈘 𓈗	Herophy[Nil]	vs EuPhrat?
𓇼 𓏏 𓉐	Duawn/SternTor	<>down,dawn,dauer,
𓐍 𓇋 𓇋 𓅛	Racker
𓄫 𓅱 𓏛 𓏪	rackern
𓂧 𓀉 𓅨 𓇋	dread? very?
𓅱 𓃀 𓈖 𓇳	ubendrai
𓅱 𓃀 𓈖 𓇳 𓈖	ubendrain
𓉔 𓂋 𓅱 𓇳 𓏤	Hora'
𓈉 𓏏 𓏤	Länter
𓌙 𓈉 𓏪	Anterre
𓄿 𓉔 𓇋 𓇋 𓂻	erhoeir
𓉔 𓈖 𓏌 𓍢	Honuren
𓈋 𓅱 𓅱 𓊌 𓏪	Wavens	Wallenstein
𓐍 𓃀 𓈗 𓂡	kėbpen
𓈗 𓂡 𓄿 𓎛 Wasser
#𓄿 𓎛	Wasser
𓎛 𓏏 𓈅 𓏪	EarTherr
𓏏 𓈅 𓏪	Terr
𓋴 𓏠 𓈖 𓐍 𓍊 𓏻	s'minka
𓅱 𓋴 𓏻	(w)üsti
𓋴 𓐍 𓂋 𓏛 𓏪	Charta's
𓎛 𓂝 𓊪 𓏻 𓈘 𓈗	Herophy[Nil]
𓎡 𓈖 𓈉 𓏏	con-Ter
𓈖 𓌙 𓃲 𓍢	Antleren
𓈝 𓐝 𓅱 𓂻 𓏪		(mar)Schienen
𓇍 𓇋 𓇋 𓂻	arri'er
𓈖 𓇿 𓌻 𓂋 𓇋 𓆵 𓊖	Anta.Maria𓊖
𓅱 𓃀 𓈖 𓇳 𓇋	ubenrai
-𓅱 𓃀 𓈖 𓇳	antreiben
𓂋 𓂧 𓌗 𓏛	rise
𓏏 𓂋 𓅱 𓆵 𓇳 𓏪	ThreeWeatherSuns(3seasons)
𓄝 𓏏 𓇶 𓏏 𓏪	Shootten
𓏠 𓈖 𓂝 𓂒	ammen
𓆷 𓈅 𓏤	Shooter
𓉐 𓂋 𓏏 𓇳	PartiveRa
𓂋 𓋴 𓈎 𓃀 𓏁	rescoop
𓉔 𓉔 𓊮	Hotter
𓂧 𓊪 𓆑 𓋴 𓏏 𓀁	touchesth 
𓏏 𓍢	ton
𓍯 𓏏 𓈐 𓍘 𓇋	(b)roady
𓌵	mvoir
𓆑	sin
𓈌	Achter
𓎟𓏏	Allath
𓎟 𓏏		Allath
# 𓎟 𓏏		alleth
𓌡 𓂝 𓏤 𓍘 𓇋	(1)uôn-tzig
𓆣 𓅱 𓀾 𓏪	Khörper
𓆣 𓂋 𓀾 𓏪	Khörper
𓊪 𓊃 𓂧 𓇶 𓍘 𓇋	phozxoraytzy
𓄚 𓈖 𓂻 𓍘 𓇋	innerty
𓌡 𓂝 𓏤 𓇋 𓇋	unory:1:allein
𓊖 𓏏 𓏤 𓏪	Urten
𓂧 𓏇 𓇋 𓅱 𓈅 𓏪		(Demie)Wender
𓅱 𓈅 𓏪		Wender
𓄿 𓎛 𓇋 𓇋 𓏏 𓏪	Äckerith
𓂝 𓏏 𓈖 𓏌 𓌙 𓅯 𓈐	Roaden
𓇋 𓏏 𓅱 𓂋 𓈗 𓈘	Vethwer
𓎡 𓁨 𓏤 𓏪	Huge
𓎛 𓁺	[see?]
𓏏 𓍢	ton
𓁹 𓏏 𓏤	Auge
𓂋 𓂝 𓈎 𓌙 𓌙 𓏜	occuran
𓉔 𓅱 𓂋 𓇳 𓏤	Horen
𓈝 𓈖	schien
𓃹 𓈖 𓈖	Sannen
𓈎 𓌳 𓌙 𓅯 𓏛	commander
𓈎 𓌳 𓌙 𓅯 𓏛	maqan[sic]
𓊃 𓏏 𓏪	that
𓏏 𓍃 𓐝 𓏛	Trainter
𓎛 𓂝 ####	Khörper
𓄣 𓏤	Hearte[soule] 
𓇋 𓇋 𓂋 𓐍 𓏛	iarxter:other
𓄋 𓊪 𓏴 𓏛	open
𓊃 𓈙 𓄄 𓏛	Zeichen?
𓋴 𓐍 𓏤 𓂋 𓏛 𓏪	Charter
𓄖 𓄖		Hoher?
𓂋 𓇿 𓏤 𓈅	~Erde
𓂝 𓏤		Orm
𓅱 𓏏 𓇋 𓐝	untim?
𓁹 𓁹 𓁹	3-Eyes
𓄤 𓏤 𓏪	Schönfairn
𓎝 𓎛 𓏛	arreter?	chreter
𓇓 𓏏 𓈖	Sultan
𓋴 𓂋 𓂧 𓈖	stärken
𓃹 𓈖 𓂻 𓀀	Rasen
𓂾 𓎟	B...all
𓍰	found	
𓅱 𓍿 𓊃	uncez?
𓍞	rise








𓇥 𓂋	car:weil
𓋴 𓏤	Es
𓈖 𓏏	ante
𓈐	Road[s]
60	
𓇼 𓀢	Anhail
𓇼 𓀢	Anpraise
𓅨		gver
𓂋 𓍘 𓇋	artig
𓂋 𓐝	rein
𓍘 𓇋	-ty
𓏏 𓅱	tu
𓁷 𓏤	ob
𓁶 𓏤 𓏪	heads
𓁶 𓏤	hat
# 𓁶 𓏤	at
# 𓁶 𓏤	top[before]
𓉿 𓈖	open
#𓌨 𓂋	under
𓁶 𓏪	Köppen
𓏇 𓇋	mwie
𓌻 𓂋	mørr
𓂋 𓂝	ro[ich]
𓃹 𓈖	san
𓉻 𓂝 𓏛	Maxo
𓎟	All
𓅮	Ohv
𓏶	im
𓇯	air
𓋹	sankh
#𓇳	Ray
𓄤	fair
𓏏 𓏻	-ty
𓏻	-ti
𓅭	son
𓉻 𓂝 𓏛
𓁹	mayk
𓈗	mWather
𓅠	fain(d)
𓅠 𓅓 𓈖	findµn
# 𓆇	Eidam[son]
𓆇	EI[son]
# 𓉻	Maxa
𓄖	back
# 𓅓	µ
𓅓	m
𓐝	im
# 𓂝	or
# 𓂝	o'
𓈖 	an
𓊃	es
𓋴	s.
𓐝		im
𓎟		all
𓎡		you
𓂋		à
# 𓀀	moi

# 𓇋 𓅱	ien
# 𓇋 𓍢 ien
𓇋 𓍢 ∃n
𓇋 𓅱	∃n
# 𓇋 𓅱	*BE


𓀀	µI
𓅱 𓀀		µI
𓊗	Zoi'
𓈖 𓄿	nar
𓎛 𓈖 𓂝		+con+
𓇋 𓋴	is'
𓈖 𓏏 𓏏	anteth