
Malayalam (/mʌləˈjɑːləm/;[5] മലയാളം, Malayāḷam ? [mɐləjaːɭəm]) is a Dravidian language 
Not to be confused with Malay language.
Native speakers 38 million
Ethnicity 	Malayalis,Keralites

Vater 
PIE
𐎱𐎡𐎫𐎠			PiTa	
पिता m (pitā)
പിതാവ് (pitāv) Malayalam
Armenian: հայր (hy) (hayr), պապա (hy) (papa informal) 
Assamese: পিতা (pita)
Asturian: padre (ast) m, pá (ast) m
Avestan: 𐬞𐬌𐬙𐬀𐬭 (pitar)

PIE: Ph.Tr
I18N PAPA BABA
SLAVIC: OTEC
SEM	 ABA
MALAY? RAMA
Turk ATA TATA DADA
Amerikan?  DADA  Cherokee: ᎡᏙᏓ (edoda), ᎠᏓᏙᏓ (adadoda)

PIE:
Saterland Frisian: Baabe
Scottish Gaelic: athair (gd) !!! VS Turk!
Walloon: pere (wa) m
North Frisian:
    Föhr-Amrum: aatj m WTF <> Coptic
    Hallig: baabe m
    Mooring: tääte m  WTF

FOREIGN:
Turkmen: kaka !
Nivkh: ытк (ytk), ытык (ytyk), ытка (ytka), ытыка (ytyka)
O'odham: o꞉g <?>
Northern Sami: áhčči
Old East Slavic: отьць m (otĭcĭ)
Pitjantjatjara: mama, punari
Polish: ojciec (pl) m pers, tata (pl) m pers (familiar; equivalent of "dad") <> PIE
Votic: isä
Võro: esä
Russian: 
1) оте́ц  m (otéc),   SLAV
2) тя́тя  m (tjátja) TURK
3) па́па  m (pápa) PIE
... , ба́тя  m (bátja) , ба́тюшка  m (bátjuška), ба́тька  m (bátʹka), папа́ша  m (papáša)
Rusyn: ня́ньо m (njánʹo)
Rwanda-Rundi: so (rw)
Saaroa: ama'a
Sabaean: 𐩱𐩨 ('b)
Saisiyat: yaba'
Welsh: tad (cy) m
ǃXóõ: a̰a
Yami: ama
Zulu: (my) ubaba, (your) uyihlo, (his/her) uyise
Malay: bapa, ayah (ms), bapak, ayahanda, rama, abah (ms)
West Frisian: heit (fy), (archaic or phrasal) faar !!!
Vietnamese: () ba (vi), cha (vi), tía (vi), thầy (vi), cậu (vi), (Northern) bố (vi), bác (vi), bọ (vi), áng (vi)
Talysh: Asalemi: دده (dada)
Tamil: அப்பா (ta) (appā), தந்தை (ta) (tantai), அத்தன் (ta) (attaṉ), அப்பன் (ta) (appaṉ)
Taos: tǫ̏ména
Taroko: tama
Tatar: ата (tt) (ata), әти (tt) (äti), атай (atay)
Telugu: నాన్న (te) (nānna), తండ్రి (te) (taṃḍri)
Tetum: aman
Thai: พ่อ (th) (pɔ̂ɔ), บิดา (th) (bì-daa)
Thao: ama
Tibetan: པ་ཕ (pa pha), ཕ་ལགས (pha lags) (honorific)
Tuvan: ача (ača), ада (ada)
Tày: 嗓, 嗚, 嗟
Udmurt: атай (ataj), бубы (buby), айы (ajy)
Upper Sorbian: nan m
Sudovian: tāvas m
Sundanese: rama
Svan: მუ (mu)
Slovene: oče (sl) m, očka m, (dialect) tata m, (dialect) ata m
Sinhalese: තාත්තා (si) (tāttā)
Skolt Sami: eʹčč
Slovak: (formal) otec (sk), (diminutive) tato, (diminutive) tatko, (diminutive) tatíčko, (pejorative) foter
Silesian: uojćec m
Moksha: аля (alja)
Mongolian: аав (mn) (aav), эцэг (mn) (etseg)
Muong: pổ
Mwani: baba, wawa
Nahuatl: tahtli (nah)
Nama: ǁgûb
Nataoran Amis: wama
Maori: matua taane, tāne
Mbabaram: nganjan
Minaean: 𐩱𐩨 ('b)
Mingrelian: მუმა (muma)
Miyako: アサ (asa)
Maltese: missier
Mansi: āсь
Manx: ayr m
Adyghe: ты (tə)
Ainu: アチャ (aca)
Amis: ama^
Amurdag: iraba
Arabic: أَب (ar) m (ʾab)  VS!!
Arabic: وَالِد (ar) m (wālid)
Arabic: مَوْلُود لَهُ m (mawlūd lahu)
Buryat: эсэгэ (esege)
Cherokee: ᎡᏙᏓ (edoda), ᎠᏓᏙᏓ (adadoda)
Cantonese: 父親, 父亲 (fu6 can1), 爸爸 (baa1-4 baa1) (colloquial), 老竇, 老窦, 老豆 (lou5 dau6)
Dungan: please add this translation if you can
Mandarin: 父親 (zh), 父亲 (zh) (fùqīn), 父 (zh) (fù), 爸爸 (zh) (bàba), 爹 (zh) (diē) (colloquial)
Min Nan: 爹親 (zh-min-nan), 爹亲 (tia-chhin), 娘爸/娘父 (niû-pē), 父親, 父亲 (hū-chhin) 

Chuukese: sam
Chuvash: атте (atte)
Comanche: apʉ
Coptic: Sahidic: ⲉⲓⲱⲧ m (eyōt), ⲡⲁⲧⲣⲟⲥ m (patros), ⲉⲓⲟⲧⲉ pl (eyote), !!!!!  *FIOTr
Coptic: Bohairic: ⲓⲱⲧ m (yōt), ⲡⲁⲧⲣⲟⲥ m (patros), ⲓⲟϯ pl (yoti),  << PJOTRE ???
<> Föhr-Amrum: aatj m WTF



QUESTIONABLE
Mandarin: 父親 父亲 (fùqīn), 父 (fù), 爸爸 (bàba) !!
Burmese: အဖေ (my) (a.hpe), အဖ (my) (a.hpa.), (formal) ဖခင် (my) (hpa.hkang)
Aromanian: tatã m
Aleut: adax
Egyptian Arabic: أب m (ʾab), بابا m (baba), والد m (wāled) 
Malayalam: അച്ഛന്‍ (acchan‍), പിതാവ് (ml) (pitāv)
Marathi: पिता m (pitā)
Mazanderani: پیه‌ر (pier)
Mirandese: pai
Nepali: बाबु (ne) m (bābu)
Occitan: paire (oc) m
Ojibwe: imbaabaa (my father)
Punjabi: ਪਿਓ m (pio), ਪਿਤਾ m (pitā), ਬਾਪ m (bāp)
Serbo-Croatian: Cyrillic: отац m Roman: otac (sh) m
Shona: baba
Sindhi: پيء (pīʾu), بابو (bābō)
Somali: aabo (so), aabbe (so)
South Picene: 𐌐𐌀𐌕𐌄𐌓𐌄𐌝𐌇 (patereíh)
Swahili: baba (sw), mzee (sw)
Tajik: падар (tg) (padar), бобо (tg) (bobo)
Urdu: پتا m (pitā), والد (ur) m (vālid), باپ m (bāp), پدر m (pidar)
Uyghur: دادا (ug) (dada), ئاتا (ug) (ata)
Waneci: پيار (piyār)
Baba Malay: bapak
Baluchi: پت (pit), پس (pis), ابا (abbá)
アサ (asa)  
Azeri: ata (az), (dialect) dədə
Bashkir: атай (atay)
Basque: aita (eu)
Bats: დად (dad)
𒀜 (abu)
بابا m (baba)	Egyptian Arabic!
Aleut: adax !
Lydian: 𐤠𐤯𐤠 (ata)
Lü: ᦗᦸᧈ (pɔ)
Pite Sami: áhttje
Plains Apache: t’aah (-t’á’)


Semitic
والد m (wāled) Egyptian Arabic
أب m (ʾab)
Hebrew: אבא m (’abā’)
Syriac: ܐܒܐ m (’abā’)
Amharic: እባት m (ʾəbat)
𐀞𐀳  𐤀𐤁 AB/Vat/PaTaur 
Aragonese: pai (an) m
Atayal: yaba

Foreign (dad)
Aromanian: tatã m
Avar: эмен (èmen)
Bulgarian: баща́ (bg) m (baštá), та́тко (bg) m (tátko), тати m (tati)
Romani: dad m
Romanian: tată (ro) m
Latvian: tēvs (lv) m, tētis m (dad), papucītis m (sexual, sarcastic)